country,date,tests_cumulative,tests_cumulative_corrected,new_tests_corrected,source,pcr_tests_cum,rapid_test_cum,pcr_test_new,rapid_test_new,percentage_rapid_daily,pcr_test_new_corrected,rapid_test_new_corrected,pcr_tests_cum_corrected,rapid_test_cum_corrected
Austria,2021-03-23,20846292,20846292,369807,https://www.sozialministerium.at/Informationen-zum-Coronavirus/Neuartiges-Coronavirus-(2019-nCov).html,6431566,14414726,49167,320640,0.8670468649863307,49167,320640,6431566,14414726
Austria,2021-03-24,21147134,21147134,300842,https://www.sozialministerium.at/Informationen-zum-Coronavirus/Neuartiges-Coronavirus-(2019-nCov).html,6493316,14653818,61750,239092,0.7947427553333644,61750,239092,6493316,14653818
Austria,2021-03-25,21565462,21565462,418328,https://www.sozialministerium.at/Informationen-zum-Coronavirus/Neuartiges-Coronavirus-(2019-nCov).html,6568554,14996908,75238,343090,0.8201459142108585,75238,343090,6568554,14996908
Austria,2021-03-26,22051094,22051094,485632,https://www.sozialministerium.at/Informationen-zum-Coronavirus/Neuartiges-Coronavirus-(2019-nCov).html,6556772,15494322,-11782,497414,0.8201459142108585,87343,398289,6655897,15395197
Austria,2021-03-27,22194436,22194436,143342,https://www.sozialministerium.at/Informationen-zum-Coronavirus/Neuartiges-Coronavirus-(2019-nCov).html,6333726,15860710,-223046,366388,0.8201459142108585,25781,117561,6681678,15512758
Austria,2021-03-28,22455472,22455472,261036,https://www.sozialministerium.at/Informationen-zum-Coronavirus/Neuartiges-Coronavirus-(2019-nCov).html,6383732,16071740,50006,211030,0.8084325533642869,50006,211030,6731684,15723788
Austria,2021-03-29,22610260,22610260,154788,https://www.sozialministerium.at/Informationen-zum-Coronavirus/Neuartiges-Coronavirus-(2019-nCov).html,6421765,16188495,38033,116755,0.7542897382226013,38033,116755,6769717,15840543
Austria,2021-03-30,23093306,23093306,483046,https://www.sozialministerium.at/Informationen-zum-Coronavirus/Neuartiges-Coronavirus-(2019-nCov).html,6474269,16619037,52504,430542,0.8913064180223002,52504,430542,6822221,16271085
Austria,2021-03-31,23451521,23451521,358215,https://www.sozialministerium.at/Informationen-zum-Coronavirus/Neuartiges-Coronavirus-(2019-nCov).html,6543059,16908462,68790,289425,0.8079644905992212,68790,289425,6891011,16560510
Austria,2021-04-01,23805240,23805240,353719,https://www.sozialministerium.at/Informationen-zum-Coronavirus/Neuartiges-Coronavirus-(2019-nCov).html,6616140,17189100,73081,280638,0.7933924951727218,73081,280638,6964092,16841148
Austria,2021-04-02,24086423,24086423,281183,https://www.sozialministerium.at/Informationen-zum-Coronavirus/Neuartiges-Coronavirus-(2019-nCov).html,6685800,17400623,69660,211523,0.7522609830608536,69660,211523,7033752,17052671
Austria,2021-04-03,24402915,24402915,316492,https://www.sozialministerium.at/Informationen-zum-Coronavirus/Neuartiges-Coronavirus-(2019-nCov).html,6745518,17657397,59718,256774,0.8113127661994616,59718,256774,7093470,17309445
Austria,2021-04-04,24647471,24647471,244556,https://www.sozialministerium.at/Informationen-zum-Coronavirus/Neuartiges-Coronavirus-(2019-nCov).html,6800940,17846531,55422,189134,0.7733770588331507,55422,189134,7148892,17498579
Austria,2021-04-05,24779805,24779805,132334,https://www.sozialministerium.at/Informationen-zum-Coronavirus/Neuartiges-Coronavirus-(2019-nCov).html,6840428,17939377,39488,92846,0.7016035183701845,39488,92846,7188380,17591425
Austria,2021-04-06,24999349,24999349,219544,https://www.sozialministerium.at/Informationen-zum-Coronavirus/Neuartiges-Coronavirus-(2019-nCov).html,6867638,18131711,27210,192334,0.8760612906752178,27210,192334,7215590,17783759
Austria,2021-04-07,25515997,25515997,516648,https://www.sozialministerium.at/Informationen-zum-Coronavirus/Neuartiges-Coronavirus-(2019-nCov).html,6936131,18579866,68493,448155,0.8674281135318437,68493,448155,7284083,18231914
Austria,2021-04-08,25868498,25868498,352501,https://www.sozialministerium.at/Informationen-zum-Coronavirus/Neuartiges-Coronavirus-(2019-nCov).html,7003627,18864871,67496,285005,0.808522529014102,67496,285005,7351579,18516919
Austria,2021-04-09,26161838,26161838,293340,https://www.sozialministerium.at/Informationen-zum-Coronavirus/Neuartiges-Coronavirus-(2019-nCov).html,7080109,19081729,76482,216858,0.7392718347310289,76482,216858,7428061,18733777
Austria,2021-04-10,26478234,26478234,316396,https://www.sozialministerium.at/Informationen-zum-Coronavirus/Neuartiges-Coronavirus-(2019-nCov).html,7151199,19327035,71090,245306,0.7753132150848936,71090,245306,7499151,18979083
Austria,2021-04-11,26679075,26679075,200841,https://www.sozialministerium.at/Informationen-zum-Coronavirus/Neuartiges-Coronavirus-(2019-nCov).html,7193982,19485093,42783,158058,0.7869807459632246,42783,158058,7541934,19137141
Austria,2021-04-12,26848583,26848583,169508,https://www.sozialministerium.at/Informationen-zum-Coronavirus/Neuartiges-Coronavirus-(2019-nCov).html,7232009,19616574,38027,131481,0.7756625056044553,38027,131481,7579961,19268622
Austria,2021-04-13,27197861,27197861,349278,https://www.sozialministerium.at/Informationen-zum-Coronavirus/Neuartiges-Coronavirus-(2019-nCov).html,7300539,19897322,68530,280748,0.8037952576457721,68530,280748,7648491,19549370
Austria,2021-04-14,27703138,27703138,505277,https://www.sozialministerium.at/Informationen-zum-Coronavirus/Neuartiges-Coronavirus-(2019-nCov).html,7374937,20328201,74398,430879,0.85275799215084,74398,430879,7722889,19980249
Austria,2021-04-15,28012081,28012081,308943,https://www.sozialministerium.at/Informationen-zum-Coronavirus/Neuartiges-Coronavirus-(2019-nCov).html,7446224,20565857,71287,237656,0.7692551700475492,71287,237656,7794176,20217905
Austria,2021-04-16,28298620,28298620,286539,https://www.sozialministerium.at/Informationen-zum-Coronavirus/Neuartiges-Coronavirus-(2019-nCov).html,7530102,20768518,83878,202661,0.7072719594889352,83878,202661,7878054,20420566
Austria,2021-04-17,28298620,28298620,0,https://www.sozialministerium.at/Informationen-zum-Coronavirus/Neuartiges-Coronavirus-(2019-nCov).html,7530102,20768518,0,0,0.7072719594889352,0,0,7878054,20420566
Austria,2021-04-18,28615969,28615969,317349,https://www.sozialministerium.at/Informationen-zum-Coronavirus/Neuartiges-Coronavirus-(2019-nCov).html,7650883,21173014,120781,404496,0.770062271906061,72971,244378,7951025,20664944
Austria,2021-04-19,29014550,29014550,398581,https://www.sozialministerium.at/Informationen-zum-Coronavirus/Neuartiges-Coronavirus-(2019-nCov).html,7687817,21326733,36934,153719,0.8062763240022449,77215,321366,8028240,20986310
Austria,2021-04-20,29335166,29335166,320616,https://www.sozialministerium.at/Informationen-zum-Coronavirus/Neuartiges-Coronavirus-(2019-nCov).html,7748621,21586545,60804,259812,0.8103525713002471,60804,259812,8089044,21246122
Austria,2021-04-21,29597609,29597609,262443,https://www.sozialministerium.at/Informationen-zum-Coronavirus/Neuartiges-Coronavirus-(2019-nCov).html,7832919,21764690,84298,178145,0.6787950145364898,84298,178145,8173342,21424267
Austria,2021-04-22,29905570,29905570,307961,https://www.sozialministerium.at/Informationen-zum-Coronavirus/Neuartiges-Coronavirus-(2019-nCov).html,7905428,22000142,72509,235452,0.7645513555287845,72509,235452,8245851,21659719
Austria,2021-04-23,30186461,30186461,280891,https://www.sozialministerium.at/Informationen-zum-Coronavirus/Neuartiges-Coronavirus-(2019-nCov).html,7988411,22198050,82983,197908,0.7045722362055032,82983,197908,8328834,21857627
Austria,2021-04-24,30489054,30489054,302593,https://www.sozialministerium.at/Informationen-zum-Coronavirus/Neuartiges-Coronavirus-(2019-nCov).html,8055172,22433882,66761,235832,0.7793703092933412,66761,235832,8395595,22093459
Austria,2021-04-25,30688612,30688612,199558,https://www.sozialministerium.at/Informationen-zum-Coronavirus/Neuartiges-Coronavirus-(2019-nCov).html,8117301,22517311,62129,83429,0.5731667101773863,85178,114380,8480773,22207839
Austria,2021-04-26,30836351,30836351,147739,https://www.sozialministerium.at/Informationen-zum-Coronavirus/Neuartiges-Coronavirus-(2019-nCov).html,8151042,22685309,33741,167998,0.8327492453120121,24709,123030,8505482,22330869
Austria,2021-04-27,31263052,31263052,426701,https://www.sozialministerium.at/Informationen-zum-Coronavirus/Neuartiges-Coronavirus-(2019-nCov).html,8216127,23046925,65085,361616,0.8474693052043468,65085,361616,8570567,22692485
Austria,2021-04-28,31317709,31317709,54657,https://www.sozialministerium.at/Informationen-zum-Coronavirus/Neuartiges-Coronavirus-(2019-nCov).html,8306460,23011249,90333,-35676,0.8474693052043468,8337,46320,8578904,22738805
Austria,2021-04-29,31589724,31589724,272015,https://www.sozialministerium.at/Informationen-zum-Coronavirus/Neuartiges-Coronavirus-(2019-nCov).html,8361368,23228356,54908,217107,0.7981434847342977,54908,217107,8633812,22955912
Austria,2021-04-30,31892904,31892904,303180,https://www.sozialministerium.at/Informationen-zum-Coronavirus/Neuartiges-Coronavirus-(2019-nCov).html,8470217,23422687,108849,194331,0.6409756580249357,108849,194331,8742661,23150243
Austria,2021-05-01,32228406,32228406,335502,https://www.sozialministerium.at/Informationen-zum-Coronavirus/Neuartiges-Coronavirus-(2019-nCov).html,8537299,23691107,67082,268420,0.8000548431902045,67082,268420,8809743,23418663
Austria,2021-05-02,32383974,32383974,155568,https://www.sozialministerium.at/Informationen-zum-Coronavirus/Neuartiges-Coronavirus-(2019-nCov).html,8577920,23806054,40621,114947,0.7388858891288697,40621,114947,8850364,23533610
Austria,2021-05-03,32495877,32495877,111903,https://www.sozialministerium.at/Informationen-zum-Coronavirus/Neuartiges-Coronavirus-(2019-nCov).html,8595272,23900605,17352,94551,0.8449371330527332,17352,94551,8867716,23628161
Austria,2021-05-04,32895293,32895293,399416,https://www.sozialministerium.at/Informationen-zum-Coronavirus/Neuartiges-Coronavirus-(2019-nCov).html,8680800,24214493,85528,313888,0.7858673663548781,85528,313888,8953244,23942049
Austria,2021-05-05,33241683,33241683,346390,https://www.sozialministerium.at/Informationen-zum-Coronavirus/Neuartiges-Coronavirus-(2019-nCov).html,8777488,24464195,96688,249702,0.7208695401137446,96688,249702,9049932,24191751
Austria,2021-05-06,33702259,33702259,460576,https://www.sozialministerium.at/Informationen-zum-Coronavirus/Neuartiges-Coronavirus-(2019-nCov).html,8863055,24839204,85567,375009,0.8142174147154867,85567,375009,9135499,24566760
Austria,2021-05-07,33990188,33990188,287929,https://www.sozialministerium.at/Informationen-zum-Coronavirus/Neuartiges-Coronavirus-(2019-nCov).html,8948640,25041548,85585,202344,0.7027565823518993,85585,202344,9221084,24769104
Austria,2021-05-08,34299962,34299962,309774,https://www.sozialministerium.at/Informationen-zum-Coronavirus/Neuartiges-Coronavirus-(2019-nCov).html,9018757,25281205,70117,239657,0.773651113392344,70117,239657,9291201,25008761
Austria,2021-05-09,34504177,34504177,204215,https://www.sozialministerium.at/Informationen-zum-Coronavirus/Neuartiges-Coronavirus-(2019-nCov).html,9078393,25425784,59636,144579,0.7079744387043068,59636,144579,9350837,25153340
Austria,2021-05-10,34639633,34639633,135456,https://www.sozialministerium.at/Informationen-zum-Coronavirus/Neuartiges-Coronavirus-(2019-nCov).html,9105572,25534061,27179,108277,0.7993518190408694,27179,108277,9378016,25261617
Austria,2021-05-11,34639633,34639633,0,https://www.sozialministerium.at/Informationen-zum-Coronavirus/Neuartiges-Coronavirus-(2019-nCov).html,9105572,25534061,0,0,0.7993518190408694,0,0,9378016,25261617
Austria,2021-05-12,34639633,34639633,0,https://www.sozialministerium.at/Informationen-zum-Coronavirus/Neuartiges-Coronavirus-(2019-nCov).html,9105572,25534061,0,0,0.7993518190408694,0,0,9378016,25261617
Austria,2021-05-13,34639633,34639633,0,https://www.sozialministerium.at/Informationen-zum-Coronavirus/Neuartiges-Coronavirus-(2019-nCov).html,9105572,25534061,0,0,0.7993518190408694,0,0,9378016,25261617
Austria,2021-05-14,34639633,34639633,0,https://www.sozialministerium.at/Informationen-zum-Coronavirus/Neuartiges-Coronavirus-(2019-nCov).html,9105572,25534061,0,0,0.7993518190408694,0,0,9378016,25261617
Austria,2021-05-15,34639633,34639633,0,https://www.sozialministerium.at/Informationen-zum-Coronavirus/Neuartiges-Coronavirus-(2019-nCov).html,9105572,25534061,0,0,0.7993518190408694,0,0,9378016,25261617
Austria,2021-05-16,36217595,36217595,1577962,https://www.sozialministerium.at/Informationen-zum-Coronavirus/Neuartiges-Coronavirus-(2019-nCov).html,9105572,25534061,0,0,0.7993518190408694,316615,1261347,9694631,26522964
Austria,2021-05-17,36217595,36217595,0,https://www.sozialministerium.at/Informationen-zum-Coronavirus/Neuartiges-Coronavirus-(2019-nCov).html,9105572,25534061,0,0,0.7993518190408694,0,0,9694631,26522964
Austria,2021-05-18,36531447,36531447,313852,https://www.sozialministerium.at/Informationen-zum-Coronavirus/Neuartiges-Coronavirus-(2019-nCov).html,9105572,25534061,0,0,0.7993518190408694,62974,250878,9757605,26773842
Austria,2021-05-19,36531447,36531447,0,https://www.sozialministerium.at/Informationen-zum-Coronavirus/Neuartiges-Coronavirus-(2019-nCov).html,9105572,25534061,0,0,0.7993518190408694,0,0,9757605,26773842
Austria,2021-05-20,37237382,37237382,705935,https://www.sozialministerium.at/Informationen-zum-Coronavirus/Neuartiges-Coronavirus-(2019-nCov).html,9105572,25534061,0,0,0.7993518190408694,141645,564290,9899250,27338132
Austria,2021-05-21,37237382,37237382,0,https://www.sozialministerium.at/Informationen-zum-Coronavirus/Neuartiges-Coronavirus-(2019-nCov).html,9105572,25534061,0,0,0.7993518190408694,0,0,9899250,27338132
Austria,2021-05-22,37237382,37237382,0,https://www.sozialministerium.at/Informationen-zum-Coronavirus/Neuartiges-Coronavirus-(2019-nCov).html,9105572,25534061,0,0,0.7993518190408694,0,0,9899250,27338132
Austria,2021-05-23,37237382,37237382,0,https://www.sozialministerium.at/Informationen-zum-Coronavirus/Neuartiges-Coronavirus-(2019-nCov).html,9105572,25534061,0,0,0.7993518190408694,0,0,9899250,27338132
Austria,2021-05-24,38877709,38877709,1640327,https://www.sozialministerium.at/Informationen-zum-Coronavirus/Neuartiges-Coronavirus-(2019-nCov).html,9105572,25534061,0,0,0.7993518190408694,329129,1311198,10228379,28649330
Austria,2021-05-25,38877709,38877709,0,https://www.sozialministerium.at/Informationen-zum-Coronavirus/Neuartiges-Coronavirus-(2019-nCov).html,9105572,25534061,0,0,0.7993518190408694,0,0,10228379,28649330
Austria,2021-05-26,39471518,39471518,593809,https://www.sozialministerium.at/Informationen-zum-Coronavirus/Neuartiges-Coronavirus-(2019-nCov).html,9105572,25534061,0,0,0.7993518190408694,119147,474662,10347526,29123992
Austria,2021-05-27,39471518,39471518,0,https://www.sozialministerium.at/Informationen-zum-Coronavirus/Neuartiges-Coronavirus-(2019-nCov).html,9105572,25534061,0,0,0.7993518190408694,0,0,10347526,29123992
Austria,2021-05-28,39471518,39471518,0,https://www.sozialministerium.at/Informationen-zum-Coronavirus/Neuartiges-Coronavirus-(2019-nCov).html,9105572,25534061,0,0,0.7993518190408694,0,0,10347526,29123992
Austria,2021-05-29,39471518,39471518,0,https://www.sozialministerium.at/Informationen-zum-Coronavirus/Neuartiges-Coronavirus-(2019-nCov).html,9105572,25534061,0,0,0.7993518190408694,0,0,10347526,29123992
Austria,2021-05-30,41224239,41224239,1752721,https://www.sozialministerium.at/Informationen-zum-Coronavirus/Neuartiges-Coronavirus-(2019-nCov).html,9105572,25534061,0,0,0.7993518190408694,351680,1401041,10699206,30525033
Austria,2021-05-31,41224239,41224239,0,https://www.sozialministerium.at/Informationen-zum-Coronavirus/Neuartiges-Coronavirus-(2019-nCov).html,9105572,25534061,0,0,0.7993518190408694,0,0,10699206,30525033
Austria,2021-06-01,41776209,41776209,551970,https://www.sozialministerium.at/Informationen-zum-Coronavirus/Neuartiges-Coronavirus-(2019-nCov).html,9105572,25534061,0,0,0.7993518190408694,110752,441218,10809958,30966251
Austria,2021-06-02,43048076,43048076,1271867,https://www.sozialministerium.at/Informationen-zum-Coronavirus/Neuartiges-Coronavirus-(2019-nCov).html,10855201,32192875,1749629,6658814,0.7919199785263454,264650,1007217,11074608,31973468
Austria,2021-06-03,43729103,43729103,681027,https://www.sozialministerium.at/Informationen-zum-Coronavirus/Neuartiges-Coronavirus-(2019-nCov).html,10954992,32774111,99791,581236,0.8534698330609506,99791,581236,11174399,32554704
Austria,2021-06-04,44110345,44110345,381242,https://www.sozialministerium.at/Informationen-zum-Coronavirus/Neuartiges-Coronavirus-(2019-nCov).html,11013261,33097084,58269,322973,0.8471600715555998,58269,322973,11232668,32877677
Austria,2021-06-05,44858994,44858994,748649,https://www.sozialministerium.at/Informationen-zum-Coronavirus/Neuartiges-Coronavirus-(2019-nCov).html,11092325,33766669,79064,669585,0.8943910964951532,79064,669585,11311732,33547262
Austria,2021-06-06,45278379,45278379,419385,https://www.sozialministerium.at/Informationen-zum-Coronavirus/Neuartiges-Coronavirus-(2019-nCov).html,11157892,34120487,65567,353818,0.8436591675906386,65567,353818,11377299,33901080
Austria,2021-06-07,45570994,45570994,292615,https://www.sozialministerium.at/Informationen-zum-Coronavirus/Neuartiges-Coronavirus-(2019-nCov).html,11184673,34386321,26781,265834,0.9084770090391812,26781,265834,11404080,34166914
Austria,2021-06-08,45983005,45983005,412011,https://www.sozialministerium.at/Informationen-zum-Coronavirus/Neuartiges-Coronavirus-(2019-nCov).html,11275295,34707710,90622,321389,0.7800495617835446,90622,321389,11494702,34488303
Austria,2021-06-09,46426166,46426166,443161,https://www.sozialministerium.at/Informationen-zum-Coronavirus/Neuartiges-Coronavirus-(2019-nCov).html,11365285,35060881,89990,353171,0.7969361022292124,89990,353171,11584692,34841474
Austria,2021-06-10,46942669,46942669,516503,https://www.sozialministerium.at/Informationen-zum-Coronavirus/Neuartiges-Coronavirus-(2019-nCov).html,11446506,35496163,81221,435282,0.8427482512202252,81221,435282,11665913,35276756
Austria,2021-06-11,47268180,47268180,325511,https://www.sozialministerium.at/Informationen-zum-Coronavirus/Neuartiges-Coronavirus-(2019-nCov).html,11532421,35735759,85915,239596,0.7360611469351266,85915,239596,11751828,35516352
Austria,2021-06-12,47725434,47725434,457254,https://www.sozialministerium.at/Informationen-zum-Coronavirus/Neuartiges-Coronavirus-(2019-nCov).html,11567937,36157497,35516,421738,0.9223276340939609,35516,421738,11787344,35938090
Austria,2021-06-13,48145979,48145979,420545,https://www.sozialministerium.at/Informationen-zum-Coronavirus/Neuartiges-Coronavirus-(2019-nCov).html,11623324,36522655,55387,365158,0.868297090679951,55387,365158,11842731,36303248
Austria,2021-06-14,48458730,48458730,312751,https://www.sozialministerium.at/Informationen-zum-Coronavirus/Neuartiges-Coronavirus-(2019-nCov).html,11649354,36809376,26030,286721,0.9167708496535583,26030,286721,11868761,36589969
Austria,2021-06-15,48813163,48813163,354433,https://www.sozialministerium.at/Informationen-zum-Coronavirus/Neuartiges-Coronavirus-(2019-nCov).html,11730381,37082782,81027,273406,0.7713897972254277,81027,273406,11949788,36863375
Austria,2021-06-16,49167859,49167859,354696,https://www.sozialministerium.at/Informationen-zum-Coronavirus/Neuartiges-Coronavirus-(2019-nCov).html,11808138,37359721,77757,276939,0.7807784694498952,77757,276939,12027545,37140314
Austria,2021-06-17,49693906,49693906,526047,https://www.sozialministerium.at/Informationen-zum-Coronavirus/Neuartiges-Coronavirus-(2019-nCov).html,11892572,37801334,84434,441613,0.8394934292943406,84434,441613,12111979,37581927
Austria,2021-06-18,50183597,50183597,489691,https://www.sozialministerium.at/Informationen-zum-Coronavirus/Neuartiges-Coronavirus-(2019-nCov).html,11970036,38213561,77464,412227,0.8418104478130086,77464,412227,12189443,37994154
Austria,2021-06-19,50663929,50663929,480332,https://www.sozialministerium.at/Informationen-zum-Coronavirus/Neuartiges-Coronavirus-(2019-nCov).html,12052003,38611926,81967,398365,0.8293534471990207,81967,398365,12271410,38392519
Austria,2021-06-20,51082866,51082866,418937,https://www.sozialministerium.at/Informationen-zum-Coronavirus/Neuartiges-Coronavirus-(2019-nCov).html,12101448,38981418,49445,369492,0.8819750941072285,49445,369492,12320855,38762011
Austria,2021-06-21,51457883,51457883,375017,https://www.sozialministerium.at/Informationen-zum-Coronavirus/Neuartiges-Coronavirus-(2019-nCov).html,12133217,39324666,31769,343248,0.9152865070116821,31769,343248,12352624,39105259
Austria,2021-06-22,52163509,52163509,705626,https://www.sozialministerium.at/Informationen-zum-Coronavirus/Neuartiges-Coronavirus-(2019-nCov).html,12171425,39992084,38208,667418,0.9458523353731296,38208,667418,12390832,39772677
Austria,2021-06-23,52553372,52553372,389863,https://www.sozialministerium.at/Informationen-zum-Coronavirus/Neuartiges-Coronavirus-(2019-nCov).html,12279104,40274268,107679,282184,0.7238029769431826,107679,282184,12498511,40054861
Austria,2021-06-24,52844278,52844278,290906,https://www.sozialministerium.at/Informationen-zum-Coronavirus/Neuartiges-Coronavirus-(2019-nCov).html,12347540,40496738,68436,222470,0.7647487504554736,68436,222470,12566947,40277331
Austria,2021-06-25,53295938,53295938,451660,https://www.sozialministerium.at/Informationen-zum-Coronavirus/Neuartiges-Coronavirus-(2019-nCov).html,12418059,40877879,70519,381141,0.8438670681486073,70519,381141,12637466,40658472
Austria,2021-06-26,53713546,53713546,417608,https://www.sozialministerium.at/Informationen-zum-Coronavirus/Neuartiges-Coronavirus-(2019-nCov).html,12484859,41228687,66800,350808,0.8400413785176529,66800,350808,12704266,41009280
Austria,2021-06-27,54026448,54026448,312902,https://www.sozialministerium.at/Informationen-zum-Coronavirus/Neuartiges-Coronavirus-(2019-nCov).html,12489110,41537338,4251,308651,0.9864142766744859,4251,308651,12708517,41317931
Austria,2021-06-28,54026448,54026448,0,https://www.sozialministerium.at/Informationen-zum-Coronavirus/Neuartiges-Coronavirus-(2019-nCov).html,12489110,41537338,0,0,0.9864142766744859,0,0,12708517,41317931
Austria,2021-06-29,54805030,54805030,778582,https://www.sozialministerium.at/Informationen-zum-Coronavirus/Neuartiges-Coronavirus-(2019-nCov).html,12489110,41537338,0,0,0.9864142766744859,10578,768004,12719095,42085935
Austria,2021-06-30,55096277,55096277,291247,https://www.sozialministerium.at/Informationen-zum-Coronavirus/Neuartiges-Coronavirus-(2019-nCov).html,12489110,41537338,0,0,0.9864142766744859,3957,287290,12723052,42373225
Austria,2021-07-01,55096277,55096277,0,https://www.sozialministerium.at/Informationen-zum-Coronavirus/Neuartiges-Coronavirus-(2019-nCov).html,12757593,42741807,268483,1204469,0.8177245422797212,0,0,12723052,42373225
Austria,2021-07-02,55710614,55710614,614337,https://www.sozialministerium.at/Informationen-zum-Coronavirus/Neuartiges-Coronavirus-(2019-nCov).html,12833709,42972473,76116,230666,0.7518889634985103,152424,461913,12875476,42835138
Austria,2021-07-03,56054549,56054549,343935,https://www.sozialministerium.at/Informationen-zum-Coronavirus/Neuartiges-Coronavirus-(2019-nCov).html,12916172,43308711,82463,336238,0.8030503867915291,67738,276197,12943214,43111335
Austria,2021-07-04,56615814,56615814,561265,https://www.sozialministerium.at/Informationen-zum-Coronavirus/Neuartiges-Coronavirus-(2019-nCov).html,12968125,43647689,51953,338978,0.8671044250775712,74590,486675,13017804,43598010
Austria,2021-07-05,56937916,56937916,322102,https://www.sozialministerium.at/Informationen-zum-Coronavirus/Neuartiges-Coronavirus-(2019-nCov).html,13008771,43929145,40646,281456,0.8738101595146879,40646,281456,13058450,43879466
Austria,2021-07-06,57285297,57285297,347381,https://www.sozialministerium.at/Informationen-zum-Coronavirus/Neuartiges-Coronavirus-(2019-nCov).html,13071600,44213697,62829,284552,0.8191351858622089,62829,284552,13121279,44164018
Austria,2021-07-07,57621285,57621285,335988,https://www.sozialministerium.at/Informationen-zum-Coronavirus/Neuartiges-Coronavirus-(2019-nCov).html,13137707,44483578,66107,269881,0.8032459492600926,66107,269881,13187386,44433899
Austria,2021-07-08,58003807,58003807,382522,https://www.sozialministerium.at/Informationen-zum-Coronavirus/Neuartiges-Coronavirus-(2019-nCov).html,13204419,44799388,66712,315810,0.8255995733578723,66712,315810,13254098,44749709
Austria,2021-07-09,58318037,58318037,314230,https://www.sozialministerium.at/Informationen-zum-Coronavirus/Neuartiges-Coronavirus-(2019-nCov).html,13267341,45050696,62922,251308,0.7997581389428126,62922,251308,13317020,45001017
Austria,2021-07-10,58731933,58731933,413896,https://www.sozialministerium.at/Informationen-zum-Coronavirus/Neuartiges-Coronavirus-(2019-nCov).html,13337318,45394615,69977,343919,0.8309309585016526,69977,343919,13386997,45344936
Austria,2021-07-11,59103861,59103861,371928,https://www.sozialministerium.at/Informationen-zum-Coronavirus/Neuartiges-Coronavirus-(2019-nCov).html,13363128,45740733,25810,346118,0.930604848250199,25810,346118,13412807,45691054
Austria,2021-07-12,59420021,59420021,316160,https://www.sozialministerium.at/Informationen-zum-Coronavirus/Neuartiges-Coronavirus-(2019-nCov).html,13416557,46003464,53429,262731,0.8310064524291498,53429,262731,13466236,45953785
Austria,2021-07-13,59766496,59766496,346475,https://www.sozialministerium.at/Informationen-zum-Coronavirus/Neuartiges-Coronavirus-(2019-nCov).html,13477766,46288730,61209,285266,0.8233379031676167,61209,285266,13527445,46239051
Austria,2021-07-14,60048276,60048276,281780,https://www.sozialministerium.at/Informationen-zum-Coronavirus/Neuartiges-Coronavirus-(2019-nCov).html,13549847,46498429,72081,209699,0.744194052097381,72081,209699,13599526,46448750
Austria,2021-07-15,60777719,60777719,729443,https://www.sozialministerium.at/Informationen-zum-Coronavirus/Neuartiges-Coronavirus-(2019-nCov).html,13575492,47202227,25645,703798,0.9648430377699149,25645,703798,13625171,47152548
Austria,2021-07-16,61120263,61120263,342544,https://www.sozialministerium.at/Informationen-zum-Coronavirus/Neuartiges-Coronavirus-(2019-nCov).html,13670403,47449860,94911,247633,0.7229231865103461,94911,247633,13720082,47400181
Austria,2021-07-17,61529534,61529534,409271,https://www.sozialministerium.at/Informationen-zum-Coronavirus/Neuartiges-Coronavirus-(2019-nCov).html,13737493,47792041,67090,342181,0.8360743859203316,67090,342181,13787172,47742362
Austria,2021-07-18,61897934,61897934,368400,https://www.sozialministerium.at/Informationen-zum-Coronavirus/Neuartiges-Coronavirus-(2019-nCov).html,13780722,48117212,43229,325171,0.882657437567861,43229,325171,13830401,48067533
Austria,2021-07-19,62160444,62160444,262510,https://www.sozialministerium.at/Informationen-zum-Coronavirus/Neuartiges-Coronavirus-(2019-nCov).html,13816195,48344249,35473,227037,0.864869909717725,35473,227037,13865874,48294570
Austria,2021-07-20,62606905,62606905,446461,https://www.sozialministerium.at/Informationen-zum-Coronavirus/Neuartiges-Coronavirus-(2019-nCov).html,13883890,48723015,67695,378766,0.848374214097088,67695,378766,13933569,48673336
Austria,2021-07-21,62918128,62918128,311223,https://www.sozialministerium.at/Informationen-zum-Coronavirus/Neuartiges-Coronavirus-(2019-nCov).html,13949517,48968611,65627,245596,0.7891319086314315,65627,245596,13999196,48918932
Austria,2021-07-22,63257889,63257889,339761,https://www.sozialministerium.at/Informationen-zum-Coronavirus/Neuartiges-Coronavirus-(2019-nCov).html,14013373,49244516,63856,275905,0.8120561218032676,63856,275905,14063052,49194837
Austria,2021-07-23,63571450,63571450,313561,https://www.sozialministerium.at/Informationen-zum-Coronavirus/Neuartiges-Coronavirus-(2019-nCov).html,14087916,49483534,74543,239018,0.7622695424494755,74543,239018,14137595,49433855
Austria,2021-07-24,63971146,63971146,399696,https://www.sozialministerium.at/Informationen-zum-Coronavirus/Neuartiges-Coronavirus-(2019-nCov).html,14163895,49807251,75979,323717,0.8099080301028782,75979,323717,14213574,49757572
Austria,2021-07-25,64337233,64337233,366087,https://www.sozialministerium.at/Informationen-zum-Coronavirus/Neuartiges-Coronavirus-(2019-nCov).html,14214348,50122885,50453,315634,0.8621830329948892,50453,315634,14264027,50073206
Austria,2021-07-26,64601940,64601940,264707,https://www.sozialministerium.at/Informationen-zum-Coronavirus/Neuartiges-Coronavirus-(2019-nCov).html,14254929,50347011,40581,224126,0.846694647289267,40581,224126,14304608,50297332
Austria,2021-07-27,64955816,64955816,353876,https://www.sozialministerium.at/Informationen-zum-Coronavirus/Neuartiges-Coronavirus-(2019-nCov).html,14320079,50635737,65150,288726,0.8158959635578564,65150,288726,14369758,50586058
Austria,2021-07-28,65381760,65381760,425944,https://www.sozialministerium.at/Informationen-zum-Coronavirus/Neuartiges-Coronavirus-(2019-nCov).html,14385725,50996035,65646,360298,0.8458811486956032,65646,360298,14435404,50946356
Austria,2021-07-29,65725061,65725061,343301,https://www.sozialministerium.at/Informationen-zum-Coronavirus/Neuartiges-Coronavirus-(2019-nCov).html,14448488,51276573,62763,280538,0.81717792840685,62763,280538,14498167,51226894
Austria,2021-07-30,66199742,66199742,474681,https://www.sozialministerium.at/Informationen-zum-Coronavirus/Neuartiges-Coronavirus-(2019-nCov).html,14525382,51674360,76894,397787,0.8380091050621364,76894,397787,14575061,51624681
Austria,2021-07-31,66567305,66567305,367563,https://www.sozialministerium.at/Informationen-zum-Coronavirus/Neuartiges-Coronavirus-(2019-nCov).html,14590133,51977172,64751,302812,0.8238370020921584,64751,302812,14639812,51927493
Austria,2021-08-01,66916743,66916743,349438,https://www.sozialministerium.at/Informationen-zum-Coronavirus/Neuartiges-Coronavirus-(2019-nCov).html,14647503,52269240,57370,292068,0.8358220914725931,57370,292068,14697182,52219561
Austria,2021-08-02,67201912,67201912,285169,https://www.sozialministerium.at/Informationen-zum-Coronavirus/Neuartiges-Coronavirus-(2019-nCov).html,14687153,52514759,39650,245519,0.8609596414757564,39650,245519,14736832,52465080
Austria,2021-08-03,67488430,67488430,286518,https://www.sozialministerium.at/Informationen-zum-Coronavirus/Neuartiges-Coronavirus-(2019-nCov).html,14716332,52772098,29179,257339,0.898159975987547,29179,257339,14766011,52722419
Austria,2021-08-04,67771558,67771558,283128,https://www.sozialministerium.at/Informationen-zum-Coronavirus/Neuartiges-Coronavirus-(2019-nCov).html,14776016,52995542,59684,223444,0.7891978186544601,59684,223444,14825695,52945863
Austria,2021-08-05,68236738,68236738,465180,https://www.sozialministerium.at/Informationen-zum-Coronavirus/Neuartiges-Coronavirus-(2019-nCov).html,14852433,53384305,76417,388763,0.8357259555440905,76417,388763,14902112,53334626
Austria,2021-08-06,68525533,68525533,288795,https://www.sozialministerium.at/Informationen-zum-Coronavirus/Neuartiges-Coronavirus-(2019-nCov).html,14926436,53599097,74003,214792,0.7437524887896259,74003,214792,14976115,53549418
Austria,2021-08-07,68936690,68936690,411157,https://www.sozialministerium.at/Informationen-zum-Coronavirus/Neuartiges-Coronavirus-(2019-nCov).html,15026910,53909780,100474,310683,0.755631060641069,100474,310683,15076589,53860101
Austria,2021-08-08,69283203,69283203,346513,https://www.sozialministerium.at/Informationen-zum-Coronavirus/Neuartiges-Coronavirus-(2019-nCov).html,15073220,54209983,46310,300203,0.8663542204765766,46310,300203,15122899,54160304
Austria,2021-08-09,69537945,69537945,254742,https://www.sozialministerium.at/Informationen-zum-Coronavirus/Neuartiges-Coronavirus-(2019-nCov).html,15107730,54430215,34510,220232,0.8645296024997841,34510,220232,15157409,54380536
Austria,2021-08-10,69537945,69537945,0,https://www.sozialministerium.at/Informationen-zum-Coronavirus/Neuartiges-Coronavirus-(2019-nCov).html,15107730,54430215,0,0,0.8645296024997841,0,0,15157409,54380536
Austria,2021-08-11,70108599,70108599,570654,https://www.sozialministerium.at/Informationen-zum-Coronavirus/Neuartiges-Coronavirus-(2019-nCov).html,15246879,54861720,139149,431505,0.7561587231492288,139149,431505,15296558,54812041
Austria,2021-08-12,70556406,70556406,447807,https://www.sozialministerium.at/Informationen-zum-Coronavirus/Neuartiges-Coronavirus-(2019-nCov).html,15307033,55249373,60154,387653,0.8656698086452422,60154,387653,15356712,55199694
Austria,2021-08-13,70836953,70836953,280547,https://www.sozialministerium.at/Informationen-zum-Coronavirus/Neuartiges-Coronavirus-(2019-nCov).html,15368986,55467967,61953,218594,0.7791706915418807,61953,218594,15418665,55418288
Austria,2021-08-14,71181744,71181744,344791,https://www.sozialministerium.at/Informationen-zum-Coronavirus/Neuartiges-Coronavirus-(2019-nCov).html,15432741,55749003,63755,281036,0.8150908811424892,63755,281036,15482420,55699324
Austria,2021-08-15,71577449,71577449,395705,https://www.sozialministerium.at/Informationen-zum-Coronavirus/Neuartiges-Coronavirus-(2019-nCov).html,15486311,56091138,53570,342135,0.864621371981653,53570,342135,15535990,56041459
Austria,2021-08-16,71867850,71867850,290401,https://www.sozialministerium.at/Informationen-zum-Coronavirus/Neuartiges-Coronavirus-(2019-nCov).html,15524123,56343727,37812,252589,0.8697938367980826,37812,252589,15573802,56294048
Austria,2021-08-17,72155255,72155255,287405,https://www.sozialministerium.at/Informationen-zum-Coronavirus/Neuartiges-Coronavirus-(2019-nCov).html,15591581,56563674,67458,219947,0.7652859205650563,67458,219947,15641260,56513995
Austria,2021-08-18,72424887,72424887,269632,https://www.sozialministerium.at/Informationen-zum-Coronavirus/Neuartiges-Coronavirus-(2019-nCov).html,15660384,56764503,68803,200829,0.7448262817469736,68803,200829,15710063,56714824
Austria,2021-08-19,72867745,72867745,442858,https://www.sozialministerium.at/Informationen-zum-Coronavirus/Neuartiges-Coronavirus-(2019-nCov).html,15724844,57142901,64460,378398,0.85444544300882,64460,378398,15774523,57093222
Austria,2021-08-20,73136356,73136356,268611,https://www.sozialministerium.at/Informationen-zum-Coronavirus/Neuartiges-Coronavirus-(2019-nCov).html,15779387,57356969,54543,214068,0.7969442800183164,54543,214068,15829066,57307290
Austria,2021-08-21,73502548,73502548,366192,https://www.sozialministerium.at/Informationen-zum-Coronavirus/Neuartiges-Coronavirus-(2019-nCov).html,15871248,57631300,91861,274331,0.7491452571328702,91861,274331,15920927,57581621
Austria,2021-08-22,73832634,73832634,330086,https://www.sozialministerium.at/Informationen-zum-Coronavirus/Neuartiges-Coronavirus-(2019-nCov).html,15905270,57927364,34022,296064,0.8969298909981035,34022,296064,15954949,57877685
Austria,2021-08-23,74116688,74116688,284054,https://www.sozialministerium.at/Informationen-zum-Coronavirus/Neuartiges-Coronavirus-(2019-nCov).html,15973147,58143541,67877,216177,0.7610419145655404,67877,216177,16022826,58093862
Austria,2021-08-24,74394675,74394675,277987,https://www.sozialministerium.at/Informationen-zum-Coronavirus/Neuartiges-Coronavirus-(2019-nCov).html,16035471,58359204,62324,215663,0.775802465582923,62324,215663,16085150,58309525
Austria,2021-08-25,74676120,74676120,281445,https://www.sozialministerium.at/Informationen-zum-Coronavirus/Neuartiges-Coronavirus-(2019-nCov).html,16110122,58565998,74651,206794,0.7347581232567642,74651,206794,16159801,58516319
Austria,2021-08-26,75098854,75098854,422734,https://www.sozialministerium.at/Informationen-zum-Coronavirus/Neuartiges-Coronavirus-(2019-nCov).html,16180961,58917893,70839,351895,0.8324265377282168,70839,351895,16230640,58868214
Austria,2021-08-27,75354301,75354301,255447,https://www.sozialministerium.at/Informationen-zum-Coronavirus/Neuartiges-Coronavirus-(2019-nCov).html,16248104,59106197,67143,188304,0.7371548696989982,67143,188304,16297783,59056518
Austria,2021-08-28,75680725,75680725,326424,https://www.sozialministerium.at/Informationen-zum-Coronavirus/Neuartiges-Coronavirus-(2019-nCov).html,16330437,59350288,82333,244091,0.7477728353307355,82333,244091,16380116,59300609
Austria,2021-08-29,76013008,76013008,332283,https://www.sozialministerium.at/Informationen-zum-Coronavirus/Neuartiges-Coronavirus-(2019-nCov).html,16384437,59628571,54000,278283,0.8374879244499418,54000,278283,16434116,59578892
Austria,2021-08-30,76244732,76244732,231724,https://www.sozialministerium.at/Informationen-zum-Coronavirus/Neuartiges-Coronavirus-(2019-nCov).html,16421663,59823069,37226,194498,0.8393519877095165,37226,194498,16471342,59773390
Austria,2021-08-31,76575848,76575848,331116,https://www.sozialministerium.at/Informationen-zum-Coronavirus/Neuartiges-Coronavirus-(2019-nCov).html,16543772,60032076,122109,209007,0.6312198746058783,122109,209007,16593451,59982397
Austria,2021-09-01,76859312,76859312,283464,https://www.sozialministerium.at/Informationen-zum-Coronavirus/Neuartiges-Coronavirus-(2019-nCov).html,16626834,60232478,83062,200402,0.7069751361724945,83062,200402,16676513,60182799
Austria,2021-09-02,77272254,77272254,412942,https://www.sozialministerium.at/Informationen-zum-Coronavirus/Neuartiges-Coronavirus-(2019-nCov).html,16707130,60565124,80296,332646,0.8055513849402579,80296,332646,16756809,60515445
Austria,2021-09-03,77537962,77537962,265708,https://www.sozialministerium.at/Informationen-zum-Coronavirus/Neuartiges-Coronavirus-(2019-nCov).html,16780703,60757259,73573,192135,0.723105815406386,73573,192135,16830382,60707580
Austria,2021-09-04,77883338,77883338,345376,https://www.sozialministerium.at/Informationen-zum-Coronavirus/Neuartiges-Coronavirus-(2019-nCov).html,16878840,61004498,98137,247239,0.7158546048364681,98137,247239,16928519,60954819
Austria,2021-09-05,78261780,78261780,378442,https://www.sozialministerium.at/Informationen-zum-Coronavirus/Neuartiges-Coronavirus-(2019-nCov).html,16980094,61281686,101254,277188,0.7324451302973771,101254,277188,17029773,61232007
Austria,2021-09-06,78531851,78531851,270071,https://www.sozialministerium.at/Informationen-zum-Coronavirus/Neuartiges-Coronavirus-(2019-nCov).html,17002948,61528903,22854,247217,0.915377808057881,22854,247217,17052627,61479224
Austria,2021-09-07,78870408,78870408,338557,https://www.sozialministerium.at/Informationen-zum-Coronavirus/Neuartiges-Coronavirus-(2019-nCov).html,17110566,61759842,107618,230939,0.6821273817998151,107618,230939,17160245,61710163
Austria,2021-09-08,79310183,79310183,439775,https://www.sozialministerium.at/Informationen-zum-Coronavirus/Neuartiges-Coronavirus-(2019-nCov).html,17234098,62076085,123532,316243,0.7191018134273208,123532,316243,17283777,62026406
Austria,2021-09-09,79658152,79658152,347969,https://www.sozialministerium.at/Informationen-zum-Coronavirus/Neuartiges-Coronavirus-(2019-nCov).html,17376838,62281314,142740,205229,0.5897910446045481,142740,205229,17426517,62231635
Austria,2021-09-10,79979782,79979782,321630,https://www.sozialministerium.at/Informationen-zum-Coronavirus/Neuartiges-Coronavirus-(2019-nCov).html,17502267,62477515,125429,196201,0.6100208313901067,125429,196201,17551946,62427836
Austria,2021-09-11,80337893,80337893,358111,https://www.sozialministerium.at/Informationen-zum-Coronavirus/Neuartiges-Coronavirus-(2019-nCov).html,17610176,62727717,107909,250202,0.6986716409158055,107909,250202,17659855,62678038
Austria,2021-09-12,80337893,80337893,0,https://www.sozialministerium.at/Informationen-zum-Coronavirus/Neuartiges-Coronavirus-(2019-nCov).html,17610176,62727717,0,0,0.6986716409158055,0,0,17659855,62678038
Austria,2021-09-13,81012773,81012773,674880,https://www.sozialministerium.at/Informationen-zum-Coronavirus/Neuartiges-Coronavirus-(2019-nCov).html,17768391,63244382,158215,516665,0.7655657302038881,158215,516665,17818070,63194703
Austria,2021-09-14,81383866,81383866,371093,https://www.sozialministerium.at/Informationen-zum-Coronavirus/Neuartiges-Coronavirus-(2019-nCov).html,17919307,63464559,150916,220177,0.5933202728157093,150916,220177,17968986,63414880
Austria,2021-09-15,81737713,81737713,353847,https://www.sozialministerium.at/Informationen-zum-Coronavirus/Neuartiges-Coronavirus-(2019-nCov).html,18068628,63669085,149321,204526,0.5780068786792032,149321,204526,18118307,63619406
Austria,2021-09-16,82216463,82216463,478750,https://www.sozialministerium.at/Informationen-zum-Coronavirus/Neuartiges-Coronavirus-(2019-nCov).html,18234253,63982210,165625,313125,0.6540469973890339,165625,313125,18283932,63932531
Austria,2021-09-17,82500720,82500720,284257,https://www.sozialministerium.at/Informationen-zum-Coronavirus/Neuartiges-Coronavirus-(2019-nCov).html,18375591,64125129,141338,142919,0.5027809341546559,141338,142919,18425270,64075450
Austria,2021-09-18,82868432,82868432,367712,https://www.sozialministerium.at/Informationen-zum-Coronavirus/Neuartiges-Coronavirus-(2019-nCov).html,18524635,64343797,149044,218668,0.5946719171525542,149044,218668,18574314,64294118
Austria,2021-09-19,83242754,83242754,374322,https://www.sozialministerium.at/Informationen-zum-Coronavirus/Neuartiges-Coronavirus-(2019-nCov).html,18627104,64615650,102469,271853,0.7262544012908673,102469,271853,18676783,64565971
Austria,2021-09-20,83242754,83242754,0,https://www.sozialministerium.at/Informationen-zum-Coronavirus/Neuartiges-Coronavirus-(2019-nCov).html,18627104,64615650,0,0,0.7262544012908673,0,0,18676783,64565971
Austria,2021-09-21,83784581,83784581,541827,https://www.sozialministerium.at/Informationen-zum-Coronavirus/Neuartiges-Coronavirus-(2019-nCov).html,18780413,65004168,153309,388518,0.7170517526812064,153309,388518,18830092,64954489
Austria,2021-09-22,84232566,84232566,447985,https://www.sozialministerium.at/Informationen-zum-Coronavirus/Neuartiges-Coronavirus-(2019-nCov).html,19037811,65194755,257398,190587,0.425431655077737,257398,190587,19087490,65145076
Austria,2021-09-23,84729922,84729922,497356,https://www.sozialministerium.at/Informationen-zum-Coronavirus/Neuartiges-Coronavirus-(2019-nCov).html,19219531,65510391,181720,315636,0.6346279124007753,181720,315636,19269210,65460712
Austria,2021-09-24,85034047,85034047,304125,https://www.sozialministerium.at/Informationen-zum-Coronavirus/Neuartiges-Coronavirus-(2019-nCov).html,19360535,65673512,141004,163121,0.5363616933826552,141004,163121,19410214,65623833
Austria,2021-09-25,85386960,85386960,352913,https://www.sozialministerium.at/Informationen-zum-Coronavirus/Neuartiges-Coronavirus-(2019-nCov).html,19498963,65887997,138428,214485,0.6077560191888652,138428,214485,19548642,65838318
Austria,2021-09-26,85737129,85737129,350169,https://www.sozialministerium.at/Informationen-zum-Coronavirus/Neuartiges-Coronavirus-(2019-nCov).html,19598306,66138823,99343,250826,0.716299843789713,99343,250826,19647985,66089144
Austria,2021-09-27,86033575,86033575,296446,https://www.sozialministerium.at/Informationen-zum-Coronavirus/Neuartiges-Coronavirus-(2019-nCov).html,19676386,66357189,78080,218366,0.7366130762432281,78080,218366,19726065,66307510
Austria,2021-09-28,86391854,86391854,358279,https://www.sozialministerium.at/Informationen-zum-Coronavirus/Neuartiges-Coronavirus-(2019-nCov).html,19861284,66530570,184898,173381,0.48392733037660596,184898,173381,19910963,66480891
Austria,2021-09-29,86750951,86750951,359097,https://www.sozialministerium.at/Informationen-zum-Coronavirus/Neuartiges-Coronavirus-(2019-nCov).html,20013038,66737913,151754,207343,0.577401092184006,151754,207343,20062717,66688234
Austria,2021-09-30,87184819,87184819,433868,https://www.sozialministerium.at/Informationen-zum-Coronavirus/Neuartiges-Coronavirus-(2019-nCov).html,20170649,67014170,157611,276257,0.6367305263351988,157611,276257,20220328,66964491
Austria,2021-10-01,87475074,87475074,290255,https://www.sozialministerium.at/Informationen-zum-Coronavirus/Neuartiges-Coronavirus-(2019-nCov).html,20310712,67164362,140063,150192,0.5174484505004221,140063,150192,20360391,67114683
Austria,2021-10-02,87701064,87701064,225990,https://www.sozialministerium.at/Informationen-zum-Coronavirus/Neuartiges-Coronavirus-(2019-nCov).html,20344707,67356357,33995,191995,0.8495729899553077,33995,191995,20394386,67306678
Austria,2021-10-03,88109788,88109788,408724,https://www.sozialministerium.at/Informationen-zum-Coronavirus/Neuartiges-Coronavirus-(2019-nCov).html,20520420,67589368,175713,233011,0.5700937551991074,175713,233011,20570099,67539689
Austria,2021-10-04,88396908,88396908,287120,https://www.sozialministerium.at/Informationen-zum-Coronavirus/Neuartiges-Coronavirus-(2019-nCov).html,20605610,67791298,85190,201930,0.7032947896349958,85190,201930,20655289,67741619
Austria,2021-10-05,88762304,88762304,365396,https://www.sozialministerium.at/Informationen-zum-Coronavirus/Neuartiges-Coronavirus-(2019-nCov).html,20792459,67969845,186849,178547,0.48863972238338677,186849,178547,20842138,67920166
Austria,2021-10-06,89088903,89088903,326599,https://www.sozialministerium.at/Informationen-zum-Coronavirus/Neuartiges-Coronavirus-(2019-nCov).html,20951927,68136976,159468,167131,0.5117315117315118,159468,167131,21001606,68087297
Austria,2021-10-07,89521958,89521958,433055,https://www.sozialministerium.at/Informationen-zum-Coronavirus/Neuartiges-Coronavirus-(2019-nCov).html,21133061,68388897,181134,251921,0.5817298033737054,181134,251921,21182740,68339218
Austria,2021-10-08,89792069,89792069,270111,https://www.sozialministerium.at/Informationen-zum-Coronavirus/Neuartiges-Coronavirus-(2019-nCov).html,21270451,68521618,137390,132721,0.49135725683145076,137390,132721,21320130,68471939
Austria,2021-10-09,90079511,90079511,287442,https://www.sozialministerium.at/Informationen-zum-Coronavirus/Neuartiges-Coronavirus-(2019-nCov).html,21385815,68693696,115364,172078,0.5986529456377286,115364,172078,21435494,68644017
Austria,2021-10-10,90377770,90377770,298259,https://www.sozialministerium.at/Informationen-zum-Coronavirus/Neuartiges-Coronavirus-(2019-nCov).html,21483424,68894346,97609,200650,0.6727374530190203,97609,200650,21533103,68844667
Austria,2021-10-11,90613959,90613959,236189,https://www.sozialministerium.at/Informationen-zum-Coronavirus/Neuartiges-Coronavirus-(2019-nCov).html,21555013,69058946,71589,164600,0.6968995169123032,71589,164600,21604692,69009267
Austria,2021-10-12,90965763,90965763,351804,https://www.sozialministerium.at/Informationen-zum-Coronavirus/Neuartiges-Coronavirus-(2019-nCov).html,21749250,69216513,194237,157567,0.44788291207604236,194237,157567,21798929,69166834
Austria,2021-10-13,91294829,91294829,329066,https://www.sozialministerium.at/Informationen-zum-Coronavirus/Neuartiges-Coronavirus-(2019-nCov).html,21894404,69400425,145154,183912,0.5588909215780421,145154,183912,21944083,69350746
Austria,2021-10-14,91722270,91722270,427441,https://www.sozialministerium.at/Informationen-zum-Coronavirus/Neuartiges-Coronavirus-(2019-nCov).html,22081370,69640900,186966,240475,0.5625922641955264,186966,240475,22131049,69591221
Austria,2021-10-15,92003120,92003120,280850,https://www.sozialministerium.at/Informationen-zum-Coronavirus/Neuartiges-Coronavirus-(2019-nCov).html,22224468,69778652,143098,137752,0.4904824639487271,143098,137752,22274147,69728973
Austria,2021-10-16,92324938,92324938,321818,https://www.sozialministerium.at/Informationen-zum-Coronavirus/Neuartiges-Coronavirus-(2019-nCov).html,22371631,69953307,147163,174655,0.542713583454002,147163,174655,22421310,69903628
Austria,2021-10-17,92623066,92623066,298128,https://www.sozialministerium.at/Informationen-zum-Coronavirus/Neuartiges-Coronavirus-(2019-nCov).html,22481169,70141897,109538,188590,0.6325806365051253,109538,188590,22530848,70092218
Austria,2021-10-18,92871473,92871473,248407,https://www.sozialministerium.at/Informationen-zum-Coronavirus/Neuartiges-Coronavirus-(2019-nCov).html,22570416,70301057,89247,159160,0.6407226849484918,89247,159160,22620095,70251378
Austria,2021-10-19,93236363,93236363,364890,https://www.sozialministerium.at/Informationen-zum-Coronavirus/Neuartiges-Coronavirus-(2019-nCov).html,22785677,70450686,215261,149629,0.4100660473019266,215261,149629,22835356,70401007
Austria,2021-10-20,93571738,93571738,335375,https://www.sozialministerium.at/Informationen-zum-Coronavirus/Neuartiges-Coronavirus-(2019-nCov).html,22946490,70625248,160813,174562,0.5204979500559076,160813,174562,22996169,70575569
Austria,2021-10-21,94026903,94026903,455165,https://www.sozialministerium.at/Informationen-zum-Coronavirus/Neuartiges-Coronavirus-(2019-nCov).html,23135283,70891620,188793,266372,0.5852207441257566,188793,266372,23184962,70841941
Austria,2021-10-22,94311747,94311747,284844,https://www.sozialministerium.at/Informationen-zum-Coronavirus/Neuartiges-Coronavirus-(2019-nCov).html,23285657,71026090,150374,134470,0.4720829647105082,150374,134470,23335336,70976411
Austria,2021-10-23,94627736,94627736,315989,https://www.sozialministerium.at/Informationen-zum-Coronavirus/Neuartiges-Coronavirus-(2019-nCov).html,23429833,71197903,144176,171813,0.5437309526597445,144176,171813,23479512,71148224
Austria,2021-10-24,94941975,94941975,314239,https://www.sozialministerium.at/Informationen-zum-Coronavirus/Neuartiges-Coronavirus-(2019-nCov).html,23548245,71393730,118412,195827,0.6231785360824086,118412,195827,23597924,71344051
Austria,2021-10-25,95187771,95187771,245796,https://www.sozialministerium.at/Informationen-zum-Coronavirus/Neuartiges-Coronavirus-(2019-nCov).html,23632055,71555716,83810,161986,0.6590261843154486,83810,161986,23681734,71506037
Austria,2021-10-26,95541800,95541800,354029,https://www.sozialministerium.at/Informationen-zum-Coronavirus/Neuartiges-Coronavirus-(2019-nCov).html,23757849,71783951,125794,228235,0.6446788257459135,125794,228235,23807528,71734272
Austria,2021-10-27,95810399,95810399,268599,https://www.sozialministerium.at/Informationen-zum-Coronavirus/Neuartiges-Coronavirus-(2019-nCov).html,23853969,71956430,96120,172479,0.6421431204137023,96120,172479,23903648,71906751
Austria,2021-10-28,96262394,96262394,451995,https://www.sozialministerium.at/Informationen-zum-Coronavirus/Neuartiges-Coronavirus-(2019-nCov).html,24012013,72250381,158044,293951,0.6503412648370004,158044,293951,24061692,72200702
Austria,2021-10-29,96575321,96575321,312927,https://www.sozialministerium.at/Informationen-zum-Coronavirus/Neuartiges-Coronavirus-(2019-nCov).html,24161663,72413658,149650,163277,0.5217734487596148,149650,163277,24211342,72363979
Austria,2021-10-30,96913741,96913741,338420,https://www.sozialministerium.at/Informationen-zum-Coronavirus/Neuartiges-Coronavirus-(2019-nCov).html,24293773,72619968,132110,206310,0.6096270905974824,132110,206310,24343452,72570289
Austria,2021-10-31,97254602,97254602,340861,https://www.sozialministerium.at/Informationen-zum-Coronavirus/Neuartiges-Coronavirus-(2019-nCov).html,24437209,72817393,143436,197425,0.5791950384467569,143436,197425,24486888,72767714
Austria,2021-11-01,97531102,97531102,276500,https://www.sozialministerium.at/Informationen-zum-Coronavirus/Neuartiges-Coronavirus-(2019-nCov).html,24530486,73000616,93277,183223,0.6626509945750452,93277,183223,24580165,72950937
Austria,2021-11-02,97837484,97837484,306382,https://www.sozialministerium.at/Informationen-zum-Coronavirus/Neuartiges-Coronavirus-(2019-nCov).html,24634244,73203240,103758,202624,0.6613443348499586,103758,202624,24683923,73153561
Austria,2021-11-03,98418811,98418811,581327,https://www.sozialministerium.at/Informationen-zum-Coronavirus/Neuartiges-Coronavirus-(2019-nCov).html,24880213,73538598,245969,335358,0.5768835784334806,245969,335358,24929892,73488919
Austria,2021-11-04,98968990,98968990,550179,https://www.sozialministerium.at/Informationen-zum-Coronavirus/Neuartiges-Coronavirus-(2019-nCov).html,25167228,73801762,287015,263164,0.4783243271735199,287015,263164,25216907,73752083
Austria,2021-11-05,99442292,99442292,473302,https://www.sozialministerium.at/Informationen-zum-Coronavirus/Neuartiges-Coronavirus-(2019-nCov).html,25407430,74034862,240202,233100,0.4924973906723403,240202,233100,25457109,73985183
Austria,2021-11-06,99857207,99857207,414915,https://www.sozialministerium.at/Informationen-zum-Coronavirus/Neuartiges-Coronavirus-(2019-nCov).html,25593452,74263755,186022,228893,0.5516623886820192,186022,228893,25643131,74214076
Austria,2021-11-07,100254475,100254475,397268,https://www.sozialministerium.at/Informationen-zum-Coronavirus/Neuartiges-Coronavirus-(2019-nCov).html,25768640,74485835,175188,222080,0.5590180935791456,175188,222080,25818319,74436156
Austria,2021-11-08,100635445,100635445,380970,https://www.sozialministerium.at/Informationen-zum-Coronavirus/Neuartiges-Coronavirus-(2019-nCov).html,25969727,74665718,201087,179883,0.4721710370895346,201087,179883,26019406,74616039
Austria,2021-11-09,101090403,101090403,454958,https://www.sozialministerium.at/Informationen-zum-Coronavirus/Neuartiges-Coronavirus-(2019-nCov).html,26288086,74802317,318359,136599,0.30024529736810873,318359,136599,26337765,74752638
Austria,2021-11-10,101437402,101437402,346999,https://www.sozialministerium.at/Informationen-zum-Coronavirus/Neuartiges-Coronavirus-(2019-nCov).html,26563826,74906873,275740,104556,0.27493320992069337,251597,95402,26589362,74848040
Austria,2021-11-11,102163356,102163356,725954,https://www.sozialministerium.at/Informationen-zum-Coronavirus/Neuartiges-Coronavirus-(2019-nCov).html,26908209,75255147,344383,348274,0.502808749496504,360938,365016,26950300,75213056
Austria,2021-11-12,102608572,102608572,445216,https://www.sozialministerium.at/Informationen-zum-Coronavirus/Neuartiges-Coronavirus-(2019-nCov).html,27282494,75326078,374285,70931,0.15931817365054265,374285,70931,27324585,75283987
Austria,2021-11-13,102990106,102990106,381534,https://www.sozialministerium.at/Informationen-zum-Coronavirus/Neuartiges-Coronavirus-(2019-nCov).html,27597114,75392992,314620,66914,0.17538148631576742,314620,66914,27639205,75350901
Austria,2021-11-14,103313519,103313519,323413,https://www.sozialministerium.at/Informationen-zum-Coronavirus/Neuartiges-Coronavirus-(2019-nCov).html,27875091,75438428,277977,45436,0.14048909598562828,277977,45436,27917182,75396337
Austria,2021-11-15,103713317,103713317,399798,https://www.sozialministerium.at/Informationen-zum-Coronavirus/Neuartiges-Coronavirus-(2019-nCov).html,28226906,75486411,351815,47983,0.12001810914511829,351815,47983,28268997,75444320
Austria,2021-11-16,104177857,104177857,464540,https://www.sozialministerium.at/Informationen-zum-Coronavirus/Neuartiges-Coronavirus-(2019-nCov).html,28569475,75608382,342569,121971,0.26256296551427216,342569,121971,28611566,75566291
Austria,2021-11-17,104771291,104771291,593434,https://www.sozialministerium.at/Informationen-zum-Coronavirus/Neuartiges-Coronavirus-(2019-nCov).html,29038285,75733006,468810,124624,0.21000481940704444,468810,124624,29080376,75690915
Austria,2021-11-18,105325185,105325185,553894,https://www.sozialministerium.at/Informationen-zum-Coronavirus/Neuartiges-Coronavirus-(2019-nCov).html,29478390,75846795,440105,113789,0.2054346138430819,440105,113789,29520481,75804704
Austria,2021-11-19,105325185,105325185,0,https://www.sozialministerium.at/Informationen-zum-Coronavirus/Neuartiges-Coronavirus-(2019-nCov).html,29478390,75846795,0,0,0.2054346138430819,0,0,29520481,75804704
Austria,2021-11-20,105325185,105325185,0,https://www.sozialministerium.at/Informationen-zum-Coronavirus/Neuartiges-Coronavirus-(2019-nCov).html,30319444,75988557,841054,141762,0.14424063100315826,0,0,29520481,75804704
Austria,2021-11-21,106832204,106832204,1507019,https://www.sozialministerium.at/Informationen-zum-Coronavirus/Neuartiges-Coronavirus-(2019-nCov).html,30786950,76045254,467506,56697,0.10815848058862693,1344022,162997,30864503,75967701
Austria,2021-11-22,107187151,107187151,354947,https://www.sozialministerium.at/Informationen-zum-Coronavirus/Neuartiges-Coronavirus-(2019-nCov).html,31088788,76098363,301838,53109,0.1496251553048765,301838,53109,31166341,76020810
Austria,2021-11-23,107616106,107616106,428955,https://www.sozialministerium.at/Informationen-zum-Coronavirus/Neuartiges-Coronavirus-(2019-nCov).html,31431573,76184533,342785,86170,0.2008835425627397,342785,86170,31509126,76106980
Austria,2021-11-24,107984174,107984174,368068,https://www.sozialministerium.at/Informationen-zum-Coronavirus/Neuartiges-Coronavirus-(2019-nCov).html,31669407,76314767,237834,130234,0.35383135724920395,237834,130234,31746960,76237214
Austria,2021-11-25,108603828,108603828,619654,https://www.sozialministerium.at/Informationen-zum-Coronavirus/Neuartiges-Coronavirus-(2019-nCov).html,32162781,76441047,493374,126280,0.20379114796321818,493374,126280,32240334,76363494
Austria,2021-11-26,109210004,109210004,606176,https://www.sozialministerium.at/Informationen-zum-Coronavirus/Neuartiges-Coronavirus-(2019-nCov).html,32705015,76504989,542234,63942,0.10548421580531067,542234,63942,32782568,76427436
Austria,2021-11-27,109556932,109556932,346928,https://www.sozialministerium.at/Informationen-zum-Coronavirus/Neuartiges-Coronavirus-(2019-nCov).html,32995836,76561096,290821,56107,0.16172519946501868,290821,56107,33073389,76483543
Austria,2021-11-28,109825145,109825145,268213,https://www.sozialministerium.at/Informationen-zum-Coronavirus/Neuartiges-Coronavirus-(2019-nCov).html,33233851,76591294,238015,30198,0.1125896209355997,238015,30198,33311404,76513741
Austria,2021-11-29,109825145,109825145,0,https://www.sozialministerium.at/Informationen-zum-Coronavirus/Neuartiges-Coronavirus-(2019-nCov).html,33233851,76591294,0,0,0.1125896209355997,0,0,33311404,76513741
Austria,2021-11-30,110579782,110579782,754637,https://www.sozialministerium.at/Informationen-zum-Coronavirus/Neuartiges-Coronavirus-(2019-nCov).html,33869938,76709844,636087,118550,0.15709539818482263,636087,118550,33947491,76632291
Austria,2021-12-01,111071336,111071336,491554,https://www.sozialministerium.at/Informationen-zum-Coronavirus/Neuartiges-Coronavirus-(2019-nCov).html,34257724,76813612,387786,103768,0.21110193386687934,387786,103768,34335277,76736059
Austria,2021-12-02,111537645,111537645,466309,https://www.sozialministerium.at/Informationen-zum-Coronavirus/Neuartiges-Coronavirus-(2019-nCov).html,34643950,76893695,386226,80083,0.1717380535224497,386226,80083,34721503,76816142
Austria,2021-12-03,111937966,111937966,400321,https://www.sozialministerium.at/Informationen-zum-Coronavirus/Neuartiges-Coronavirus-(2019-nCov).html,34972626,76965340,328676,71645,0.17896887747582566,328676,71645,35050179,76887787
Austria,2021-12-04,112234412,112234412,296446,https://www.sozialministerium.at/Informationen-zum-Coronavirus/Neuartiges-Coronavirus-(2019-nCov).html,35225348,77009064,252722,43724,0.14749397866727837,252722,43724,35302901,76931511
Austria,2021-12-05,112526834,112526834,292422,https://www.sozialministerium.at/Informationen-zum-Coronavirus/Neuartiges-Coronavirus-(2019-nCov).html,35491592,77035242,266244,26178,0.08952130824630158,266244,26178,35569145,76957689
Austria,2021-12-06,112907381,112907381,380547,https://www.sozialministerium.at/Informationen-zum-Coronavirus/Neuartiges-Coronavirus-(2019-nCov).html,35758920,77148461,267328,113219,0.2975164697133337,267328,113219,35836473,77070908
Austria,2021-12-07,113295295,113295295,387914,https://www.sozialministerium.at/Informationen-zum-Coronavirus/Neuartiges-Coronavirus-(2019-nCov).html,36117620,77177675,358700,29214,0.0753105069680393,358700,29214,36195173,77100122
Austria,2021-12-08,113690976,113690976,395681,https://www.sozialministerium.at/Informationen-zum-Coronavirus/Neuartiges-Coronavirus-(2019-nCov).html,36423535,77267441,305915,89766,0.22686457019669887,305915,89766,36501088,77189888
Austria,2021-12-09,113992857,113992857,301881,https://www.sozialministerium.at/Informationen-zum-Coronavirus/Neuartiges-Coronavirus-(2019-nCov).html,36668963,77323894,245428,56453,0.18700415064214046,245428,56453,36746516,77246341
Austria,2021-12-10,114403886,114403886,411029,https://www.sozialministerium.at/Informationen-zum-Coronavirus/Neuartiges-Coronavirus-(2019-nCov).html,37042419,77361467,373456,37573,0.09141204148612385,373456,37573,37119972,77283914
Austria,2021-12-11,114668040,114668040,264154,https://www.sozialministerium.at/Informationen-zum-Coronavirus/Neuartiges-Coronavirus-(2019-nCov).html,37275407,77392633,232988,31166,0.11798420618275703,232988,31166,37352960,77315080
Austria,2021-12-12,114668040,114668040,0,https://www.sozialministerium.at/Informationen-zum-Coronavirus/Neuartiges-Coronavirus-(2019-nCov).html,37275407,77392633,0,0,0.11798420618275703,0,0,37352960,77315080
Austria,2021-12-13,115218023,115218023,549983,https://www.sozialministerium.at/Informationen-zum-Coronavirus/Neuartiges-Coronavirus-(2019-nCov).html,37759861,77458162,484454,65529,0.11914731909895397,484454,65529,37837414,77380609
Austria,2021-12-14,115678700,115678700,460677,https://www.sozialministerium.at/Informationen-zum-Coronavirus/Neuartiges-Coronavirus-(2019-nCov).html,38148627,77530073,388766,71911,0.15609852456276307,388766,71911,38226180,77452520
Austria,2021-12-15,116145233,116145233,466533,https://www.sozialministerium.at/Informationen-zum-Coronavirus/Neuartiges-Coronavirus-(2019-nCov).html,38511210,77634023,362583,103950,0.2228138202442271,362583,103950,38588763,77556470
Austria,2021-12-16,116555934,116555934,410701,https://www.sozialministerium.at/Informationen-zum-Coronavirus/Neuartiges-Coronavirus-(2019-nCov).html,38865972,77689962,354762,55939,0.1362037102417574,354762,55939,38943525,77612409
Austria,2021-12-17,116984758,116984758,428824,https://www.sozialministerium.at/Informationen-zum-Coronavirus/Neuartiges-Coronavirus-(2019-nCov).html,39250794,77733964,384822,44002,0.10261086133238811,384822,44002,39328347,77656411
Austria,2021-12-18,117317627,117317627,332869,https://www.sozialministerium.at/Informationen-zum-Coronavirus/Neuartiges-Coronavirus-(2019-nCov).html,39544038,77773589,293244,39625,0.11904082386764764,293244,39625,39621591,77696036
Austria,2021-12-19,117580481,117580481,262854,https://www.sozialministerium.at/Informationen-zum-Coronavirus/Neuartiges-Coronavirus-(2019-nCov).html,39778285,77802196,234247,28607,0.10883227951638552,234247,28607,39855838,77724643
Austria,2021-12-20,117832609,117832609,252128,https://www.sozialministerium.at/Informationen-zum-Coronavirus/Neuartiges-Coronavirus-(2019-nCov).html,39995455,77837154,217170,34958,0.13865179591318696,217170,34958,40073008,77759601
Austria,2021-12-21,118149583,118149583,316974,https://www.sozialministerium.at/Informationen-zum-Coronavirus/Neuartiges-Coronavirus-(2019-nCov).html,40243130,77906453,247675,69299,0.2186267643402929,247675,69299,40320683,77828900
Austria,2021-12-22,118688041,118688041,538458,https://www.sozialministerium.at/Informationen-zum-Coronavirus/Neuartiges-Coronavirus-(2019-nCov).html,40676214,78011827,433084,105374,0.19569585742992027,433084,105374,40753767,77934274
Austria,2021-12-23,119026243,119026243,338202,https://www.sozialministerium.at/Informationen-zum-Coronavirus/Neuartiges-Coronavirus-(2019-nCov).html,40955701,78070542,279487,58715,0.1736092631031159,279487,58715,41033254,77992989
Austria,2021-12-24,119534266,119534266,508023,https://www.sozialministerium.at/Informationen-zum-Coronavirus/Neuartiges-Coronavirus-(2019-nCov).html,41417390,78116876,461689,46334,0.09120453207827205,461689,46334,41494943,78039323
Austria,2021-12-25,119923778,119923778,389512,https://www.sozialministerium.at/Informationen-zum-Coronavirus/Neuartiges-Coronavirus-(2019-nCov).html,41767181,78156597,349791,39721,0.10197631908644664,349791,39721,41844734,78079044
Austria,2021-12-26,120214287,120214287,290509,https://www.sozialministerium.at/Informationen-zum-Coronavirus/Neuartiges-Coronavirus-(2019-nCov).html,42029290,78184997,262109,28400,0.09775944979329385,262109,28400,42106843,78107444
Austria,2021-12-27,120407619,120407619,193332,https://www.sozialministerium.at/Informationen-zum-Coronavirus/Neuartiges-Coronavirus-(2019-nCov).html,42196310,78211309,167020,26312,0.1360974903275195,167020,26312,42273863,78133756
Austria,2021-12-28,122603900,122603900,2196281,https://www.sozialministerium.at/Informationen-zum-Coronavirus/Neuartiges-Coronavirus-(2019-nCov).html,44034148,78569752,1837838,358443,0.16320452619678447,1837838,358443,44111701,78492199
Austria,2021-12-29,122921131,122921131,317231,https://www.sozialministerium.at/Informationen-zum-Coronavirus/Neuartiges-Coronavirus-(2019-nCov).html,44269499,78651632,235351,81880,0.25810844463498206,235351,81880,44347052,78574079
Austria,2021-12-30,123226848,123226848,305717,https://www.sozialministerium.at/Informationen-zum-Coronavirus/Neuartiges-Coronavirus-(2019-nCov).html,44516099,78710749,246600,59117,0.19337164763490416,246600,59117,44593652,78633196
Austria,2021-12-31,123579209,123579209,352361,https://www.sozialministerium.at/Informationen-zum-Coronavirus/Neuartiges-Coronavirus-(2019-nCov).html,44828594,78750615,312495,39866,0.11313964939366161,312495,39866,44906147,78673062
Austria,2022-01-01,123907877,123907877,328668,https://www.sozialministerium.at/Informationen-zum-Coronavirus/Neuartiges-Coronavirus-(2019-nCov).html,45120645,78787232,292051,36617,0.11141029853834264,292051,36617,45198198,78709679
Austria,2022-01-02,124106426,124106426,198549,https://www.sozialministerium.at/Informationen-zum-Coronavirus/Neuartiges-Coronavirus-(2019-nCov).html,45298027,78808399,177382,21167,0.106608444263129,177382,21167,45375580,78730846
Austria,2022-01-03,124304551,124304551,198125,https://www.sozialministerium.at/Informationen-zum-Coronavirus/Neuartiges-Coronavirus-(2019-nCov).html,45465114,78839437,167087,31038,0.15665867507886436,167087,31038,45542667,78761884
Austria,2022-01-04,124636283,124636283,331732,https://www.sozialministerium.at/Informationen-zum-Coronavirus/Neuartiges-Coronavirus-(2019-nCov).html,45700203,78936080,235089,96643,0.29132854231729227,235089,96643,45777756,78858527
Austria,2022-01-05,125206869,125206869,570586,https://www.sozialministerium.at/Informationen-zum-Coronavirus/Neuartiges-Coronavirus-(2019-nCov).html,46182917,79023952,482714,87872,0.15400307753782952,482714,87872,46260470,78946399
Austria,2022-01-06,125526389,125526389,319520,https://www.sozialministerium.at/Informationen-zum-Coronavirus/Neuartiges-Coronavirus-(2019-nCov).html,46455663,79070726,272746,46774,0.14638833249874814,272746,46774,46533216,78993173
Austria,2022-01-07,125857538,125857538,331149,https://www.sozialministerium.at/Informationen-zum-Coronavirus/Neuartiges-Coronavirus-(2019-nCov).html,46747037,79110501,291374,39775,0.120112094555623,291374,39775,46824590,79032948
Austria,2022-01-08,126329247,126329247,471709,https://www.sozialministerium.at/Informationen-zum-Coronavirus/Neuartiges-Coronavirus-(2019-nCov).html,47165979,79163268,418942,52767,0.11186345819138495,418942,52767,47243532,79085715
Austria,2022-01-09,126775946,126775946,446699,https://www.sozialministerium.at/Informationen-zum-Coronavirus/Neuartiges-Coronavirus-(2019-nCov).html,47556081,79219865,390102,56597,0.12670052988701563,390102,56597,47633634,79142312
Austria,2022-01-10,127304318,127304318,528372,https://www.sozialministerium.at/Informationen-zum-Coronavirus/Neuartiges-Coronavirus-(2019-nCov).html,48033555,79270763,477474,50898,0.09632985850877791,477474,50898,48111108,79193210
Austria,2022-01-11,127820079,127820079,515761,https://www.sozialministerium.at/Informationen-zum-Coronavirus/Neuartiges-Coronavirus-(2019-nCov).html,48465359,79354720,431804,83957,0.16278276178307394,431804,83957,48542912,79277167
Austria,2022-01-12,129290067,129290067,1469988,https://www.sozialministerium.at/Informationen-zum-Coronavirus/Neuartiges-Coronavirus-(2019-nCov).html,49369943,79920124,904584,565404,0.38463171127927576,904584,565404,49447496,79842571
Austria,2022-01-13,129772258,129772258,482191,https://www.sozialministerium.at/Informationen-zum-Coronavirus/Neuartiges-Coronavirus-(2019-nCov).html,49776491,79995767,406548,75643,0.15687352107359948,406548,75643,49854044,79918214
Austria,2022-01-14,130508707,130508707,736449,https://www.sozialministerium.at/Informationen-zum-Coronavirus/Neuartiges-Coronavirus-(2019-nCov).html,50405905,80102802,629414,107035,0.14533932424376977,629414,107035,50483458,80025249
Austria,2022-01-15,131008822,131008822,500115,https://www.sozialministerium.at/Informationen-zum-Coronavirus/Neuartiges-Coronavirus-(2019-nCov).html,50843574,80165248,437669,62446,0.1248632814452676,437669,62446,50921127,80087695
Austria,2022-01-16,131737166,131737166,728344,https://www.sozialministerium.at/Informationen-zum-Coronavirus/Neuartiges-Coronavirus-(2019-nCov).html,51231797,80505369,388223,340121,0.46697851564645276,388223,340121,51309350,80427816
Austria,2022-01-17,132190174,132190174,453008,https://www.sozialministerium.at/Informationen-zum-Coronavirus/Neuartiges-Coronavirus-(2019-nCov).html,51616998,80573176,385201,67807,0.14968168332568077,385201,67807,51694551,80495623
Austria,2022-01-18,132722605,132722605,532431,https://www.sozialministerium.at/Informationen-zum-Coronavirus/Neuartiges-Coronavirus-(2019-nCov).html,52062214,80660391,445216,87215,0.16380526302938783,445216,87215,52139767,80582838
Austria,2022-01-19,133564965,133564965,842360,https://www.sozialministerium.at/Informationen-zum-Coronavirus/Neuartiges-Coronavirus-(2019-nCov).html,52704463,80860502,642249,200111,0.23755995061493898,642249,200111,52782016,80782949
Austria,2022-01-20,133564965,133564965,0,https://www.sozialministerium.at/Informationen-zum-Coronavirus/Neuartiges-Coronavirus-(2019-nCov).html,52704463,80860502,0,0,0.23755995061493898,0,0,52782016,80782949
Austria,2022-01-21,133564965,133564965,0,https://www.sozialministerium.at/Informationen-zum-Coronavirus/Neuartiges-Coronavirus-(2019-nCov).html,52704463,80860502,0,0,0.23755995061493898,0,0,52782016,80782949
Austria,2022-01-22,133564965,133564965,0,https://www.sozialministerium.at/Informationen-zum-Coronavirus/Neuartiges-Coronavirus-(2019-nCov).html,52704463,80860502,0,0,0.23755995061493898,0,0,52782016,80782949
Austria,2022-01-23,136574442,136574442,3009477,https://www.sozialministerium.at/Informationen-zum-Coronavirus/Neuartiges-Coronavirus-(2019-nCov).html,54805779,81768663,2101316,908161,0.301767051218534,2101316,908161,54883332,81691110
Austria,2022-01-24,137032063,137032063,457621,https://www.sozialministerium.at/Informationen-zum-Coronavirus/Neuartiges-Coronavirus-(2019-nCov).html,55196421,81835642,390642,66979,0.146363475452394,390642,66979,55273974,81758089
Austria,2022-01-25,137566059,137566059,533996,https://www.sozialministerium.at/Informationen-zum-Coronavirus/Neuartiges-Coronavirus-(2019-nCov).html,55635532,81930527,439111,94885,0.17768859691832897,439111,94885,55713085,81852974
Austria,2022-01-26,138357196,138357196,791137,https://www.sozialministerium.at/Informationen-zum-Coronavirus/Neuartiges-Coronavirus-(2019-nCov).html,56291927,82065269,656395,134742,0.17031437033029678,656395,134742,56369480,81987716
Austria,2022-01-27,140092739,140092739,1735543,https://www.sozialministerium.at/Informationen-zum-Coronavirus/Neuartiges-Coronavirus-(2019-nCov).html,57155892,82936847,863965,871578,0.5021932617054143,863965,871578,57233445,82859294
Austria,2022-01-28,140794358,140794358,701619,https://www.sozialministerium.at/Informationen-zum-Coronavirus/Neuartiges-Coronavirus-(2019-nCov).html,57762681,83031677,606789,94830,0.13515882551641276,606789,94830,57840234,82954124
Austria,2022-01-29,141362492,141362492,568134,https://www.sozialministerium.at/Informationen-zum-Coronavirus/Neuartiges-Coronavirus-(2019-nCov).html,58256462,83106030,493781,74353,0.13087229421228092,493781,74353,58334015,83028477
Austria,2022-01-30,141788278,141788278,425786,https://www.sozialministerium.at/Informationen-zum-Coronavirus/Neuartiges-Coronavirus-(2019-nCov).html,58646309,83141969,389847,35939,0.08440625102751147,389847,35939,58723862,83064416
Austria,2022-01-31,142080341,142080341,292063,https://www.sozialministerium.at/Informationen-zum-Coronavirus/Neuartiges-Coronavirus-(2019-nCov).html,58893431,83186910,247122,44941,0.15387433533176062,247122,44941,58970984,83109357
Austria,2022-02-01,142789153,142789153,708812,https://www.sozialministerium.at/Informationen-zum-Coronavirus/Neuartiges-Coronavirus-(2019-nCov).html,59518654,83270499,625223,83589,0.11792830821148625,625223,83589,59596207,83192946
Austria,2022-02-02,142789153,142789153,0,https://www.sozialministerium.at/Informationen-zum-Coronavirus/Neuartiges-Coronavirus-(2019-nCov).html,59518654,83270499,0,0,0.11792830821148625,0,0,59596207,83192946
Austria,2022-02-03,142789153,142789153,0,https://www.sozialministerium.at/Informationen-zum-Coronavirus/Neuartiges-Coronavirus-(2019-nCov).html,59518654,83270499,0,0,0.11792830821148625,0,0,59596207,83192946
Austria,2022-02-04,142789153,142789153,0,https://www.sozialministerium.at/Informationen-zum-Coronavirus/Neuartiges-Coronavirus-(2019-nCov).html,59518654,83270499,0,0,0.11792830821148625,0,0,59596207,83192946
Austria,2022-02-05,142789153,142789153,0,https://www.sozialministerium.at/Informationen-zum-Coronavirus/Neuartiges-Coronavirus-(2019-nCov).html,59518654,83270499,0,0,0.11792830821148625,0,0,59596207,83192946
Austria,2022-02-06,142789153,142789153,0,https://www.sozialministerium.at/Informationen-zum-Coronavirus/Neuartiges-Coronavirus-(2019-nCov).html,59518654,83270499,0,0,0.11792830821148625,0,0,59596207,83192946
Austria,2022-02-07,142789153,142789153,0,https://www.sozialministerium.at/Informationen-zum-Coronavirus/Neuartiges-Coronavirus-(2019-nCov).html,59518654,83270499,0,0,0.11792830821148625,0,0,59596207,83192946
Austria,2022-02-08,142789153,142789153,0,https://www.sozialministerium.at/Informationen-zum-Coronavirus/Neuartiges-Coronavirus-(2019-nCov).html,59518654,83270499,0,0,0.11792830821148625,0,0,59596207,83192946
Austria,2022-02-09,142789153,142789153,0,https://www.sozialministerium.at/Informationen-zum-Coronavirus/Neuartiges-Coronavirus-(2019-nCov).html,59518654,83270499,0,0,0.11792830821148625,0,0,59596207,83192946
Austria,2022-02-10,142789153,142789153,0,https://www.sozialministerium.at/Informationen-zum-Coronavirus/Neuartiges-Coronavirus-(2019-nCov).html,59518654,83270499,0,0,0.11792830821148625,0,0,59596207,83192946
Austria,2022-02-11,142789153,142789153,0,https://www.sozialministerium.at/Informationen-zum-Coronavirus/Neuartiges-Coronavirus-(2019-nCov).html,59518654,83270499,0,0,0.11792830821148625,0,0,59596207,83192946
Austria,2022-02-12,142789153,142789153,0,https://www.sozialministerium.at/Informationen-zum-Coronavirus/Neuartiges-Coronavirus-(2019-nCov).html,59518654,83270499,0,0,0.11792830821148625,0,0,59596207,83192946
Austria,2022-02-13,142789153,142789153,0,https://www.sozialministerium.at/Informationen-zum-Coronavirus/Neuartiges-Coronavirus-(2019-nCov).html,59518654,83270499,0,0,0.11792830821148625,0,0,59596207,83192946
Austria,2022-02-14,142789153,142789153,0,https://www.sozialministerium.at/Informationen-zum-Coronavirus/Neuartiges-Coronavirus-(2019-nCov).html,59518654,83270499,0,0,0.11792830821148625,0,0,59596207,83192946
Austria,2022-02-15,142789153,142789153,0,https://www.sozialministerium.at/Informationen-zum-Coronavirus/Neuartiges-Coronavirus-(2019-nCov).html,59518654,83270499,0,0,0.11792830821148625,0,0,59596207,83192946
Austria,2022-02-16,142789153,142789153,0,https://www.sozialministerium.at/Informationen-zum-Coronavirus/Neuartiges-Coronavirus-(2019-nCov).html,59518654,83270499,0,0,0.11792830821148625,0,0,59596207,83192946
Austria,2022-02-17,154061824,154061824,11272671,https://www.sozialministerium.at/Informationen-zum-Coronavirus/Neuartiges-Coronavirus-(2019-nCov).html,59518654,83270499,0,0,0.11792830821148625,9943304,1329367,69539511,84522313
Austria,2022-02-18,154061824,154061824,0,https://www.sozialministerium.at/Informationen-zum-Coronavirus/Neuartiges-Coronavirus-(2019-nCov).html,59518654,83270499,0,0,0.11792830821148625,0,0,69539511,84522313
Austria,2022-02-19,154061824,154061824,0,https://www.sozialministerium.at/Informationen-zum-Coronavirus/Neuartiges-Coronavirus-(2019-nCov).html,59518654,83270499,0,0,0.11792830821148625,0,0,69539511,84522313
Austria,2022-02-20,155336402,155336402,1274578,https://www.sozialministerium.at/Informationen-zum-Coronavirus/Neuartiges-Coronavirus-(2019-nCov).html,59518654,83270499,0,0,0.11792830821148625,1124269,150309,70663780,84672622
Austria,2022-02-21,155838597,155838597,502195,https://www.sozialministerium.at/Informationen-zum-Coronavirus/Neuartiges-Coronavirus-(2019-nCov).html,59518654,83270499,0,0,0.11792830821148625,442972,59223,71106752,84731845
Austria,2022-02-22,156468799,156468799,630202,https://www.sozialministerium.at/Informationen-zum-Coronavirus/Neuartiges-Coronavirus-(2019-nCov).html,59518654,83270499,0,0,0.11792830821148625,555883,74319,71662635,84806164
Austria,2022-02-23,157315892,157315892,847093,https://www.sozialministerium.at/Informationen-zum-Coronavirus/Neuartiges-Coronavirus-(2019-nCov).html,59518654,83270499,0,0,0.11792830821148625,747197,99896,72409832,84906060
Austria,2022-02-24,157807151,157807151,491259,https://www.sozialministerium.at/Informationen-zum-Coronavirus/Neuartiges-Coronavirus-(2019-nCov).html,59518654,83270499,0,0,0.11792830821148625,433326,57933,72843158,84963993
Austria,2022-02-25,157807151,157807151,0,https://www.sozialministerium.at/Informationen-zum-Coronavirus/Neuartiges-Coronavirus-(2019-nCov).html,59518654,83270499,0,0,0.11792830821148625,0,0,72843158,84963993
Austria,2022-02-26,157807151,157807151,0,https://www.sozialministerium.at/Informationen-zum-Coronavirus/Neuartiges-Coronavirus-(2019-nCov).html,59518654,83270499,0,0,0.11792830821148625,0,0,72843158,84963993
Austria,2022-02-27,158973339,158973339,1166188,https://www.sozialministerium.at/Informationen-zum-Coronavirus/Neuartiges-Coronavirus-(2019-nCov).html,59518654,83270499,0,0,0.11792830821148625,1028661,137527,73871819,85101520
Austria,2022-02-28,159656629,159656629,683290,https://www.sozialministerium.at/Informationen-zum-Coronavirus/Neuartiges-Coronavirus-(2019-nCov).html,59518654,83270499,0,0,0.11792830821148625,602711,80579,74474530,85182099
Austria,2022-03-01,160503829,160503829,847200,https://www.sozialministerium.at/Informationen-zum-Coronavirus/Neuartiges-Coronavirus-(2019-nCov).html,59518654,83270499,0,0,0.11792830821148625,747291,99909,75221821,85282008
Austria,2022-03-02,161305125,161305125,801296,https://www.sozialministerium.at/Informationen-zum-Coronavirus/Neuartiges-Coronavirus-(2019-nCov).html,59518654,83270499,0,0,0.11792830821148625,706801,94495,75928622,85376503
Austria,2022-03-03,161522349,161522349,217224,https://www.sozialministerium.at/Informationen-zum-Coronavirus/Neuartiges-Coronavirus-(2019-nCov).html,59518654,83270499,0,0,0.11792830821148625,191607,25617,76120229,85402120
Austria,2022-03-04,161522349,161522349,0,https://www.sozialministerium.at/Informationen-zum-Coronavirus/Neuartiges-Coronavirus-(2019-nCov).html,59518654,83270499,0,0,0.11792830821148625,0,0,76120229,85402120
Austria,2022-03-05,161522349,161522349,0,https://www.sozialministerium.at/Informationen-zum-Coronavirus/Neuartiges-Coronavirus-(2019-nCov).html,59518654,83270499,0,0,0.11792830821148625,0,0,76120229,85402120
Austria,2022-03-06,162347984,162347984,825635,https://www.sozialministerium.at/Informationen-zum-Coronavirus/Neuartiges-Coronavirus-(2019-nCov).html,74136194,88211790,14617540,4941291,0.2526373380904002,617049,208586,76737278,85610706
Austria,2022-03-07,162837175,162837175,489191,https://www.sozialministerium.at/Informationen-zum-Coronavirus/Neuartiges-Coronavirus-(2019-nCov).html,74564540,88272635,428346,60845,0.12437882136016402,428346,60845,77165624,85671551
Austria,2022-03-08,163464616,163464616,627441,https://www.sozialministerium.at/Informationen-zum-Coronavirus/Neuartiges-Coronavirus-(2019-nCov).html,75100323,88364293,535783,91658,0.14608226112096595,535783,91658,77701407,85763209
Austria,2022-03-09,164073801,164073801,609185,https://www.sozialministerium.at/Informationen-zum-Coronavirus/Neuartiges-Coronavirus-(2019-nCov).html,75570645,88503156,470322,138863,0.22794881686187282,470322,138863,78171729,85902072
Austria,2022-03-10,164876915,164876915,803114,https://www.sozialministerium.at/Informationen-zum-Coronavirus/Neuartiges-Coronavirus-(2019-nCov).html,76031941,88844974,461296,341818,0.4256157905353412,461296,341818,78633025,86243890
Austria,2022-03-11,165347447,165347447,470532,https://www.sozialministerium.at/Informationen-zum-Coronavirus/Neuartiges-Coronavirus-(2019-nCov).html,76467024,88880423,435083,35449,0.0753381279062848,435083,35449,79068108,86279339
Austria,2022-03-12,166011635,166011635,664188,https://www.sozialministerium.at/Informationen-zum-Coronavirus/Neuartiges-Coronavirus-(2019-nCov).html,77082536,88929099,615512,48676,0.07328647912940311,615512,48676,79683620,86328015
Austria,2022-03-13,166378307,166378307,366672,https://www.sozialministerium.at/Informationen-zum-Coronavirus/Neuartiges-Coronavirus-(2019-nCov).html,77426575,88951732,344039,22633,0.06172546581140638,344039,22633,80027659,86350648
Austria,2022-03-14,166723590,166723590,345283,https://www.sozialministerium.at/Informationen-zum-Coronavirus/Neuartiges-Coronavirus-(2019-nCov).html,77743325,88980265,316750,28533,0.0826365618927083,316750,28533,80344409,86379181
Austria,2022-03-15,167268269,167268269,544679,https://www.sozialministerium.at/Informationen-zum-Coronavirus/Neuartiges-Coronavirus-(2019-nCov).html,78174855,89093414,431530,113149,0.2077351981625875,431530,113149,80775939,86492330
Austria,2022-03-16,168325419,168325419,1057150,https://www.sozialministerium.at/Informationen-zum-Coronavirus/Neuartiges-Coronavirus-(2019-nCov).html,78897256,89428163,722401,334749,0.3166523199167573,722401,334749,81498340,86827079
Austria,2022-03-17,169094014,169094014,768595,https://www.sozialministerium.at/Informationen-zum-Coronavirus/Neuartiges-Coronavirus-(2019-nCov).html,79363955,89730059,466699,301896,0.39278944047255054,466699,301896,81965039,87128975
Austria,2022-03-18,169566273,169566273,472259,https://www.sozialministerium.at/Informationen-zum-Coronavirus/Neuartiges-Coronavirus-(2019-nCov).html,79779435,89786838,415480,56779,0.12022851867301629,415480,56779,82380519,87185754
Austria,2022-03-19,170281200,170281200,714927,https://www.sozialministerium.at/Informationen-zum-Coronavirus/Neuartiges-Coronavirus-(2019-nCov).html,80449659,89831541,670224,44703,0.06252806230566198,670224,44703,83050743,87230457
Austria,2022-03-20,170633229,170633229,352029,https://www.sozialministerium.at/Informationen-zum-Coronavirus/Neuartiges-Coronavirus-(2019-nCov).html,80783364,89849865,333705,18324,0.05205252976317292,333705,18324,83384448,87248781
Austria,2022-03-21,170965802,170965802,332573,https://www.sozialministerium.at/Informationen-zum-Coronavirus/Neuartiges-Coronavirus-(2019-nCov).html,81097288,89868514,313924,18649,0.05607490686255349,313924,18649,83698372,87267430
Austria,2022-03-22,171415925,171415925,450123,https://www.sozialministerium.at/Informationen-zum-Coronavirus/Neuartiges-Coronavirus-(2019-nCov).html,81486066,89929859,388778,61345,0.1362849709968164,388778,61345,84087150,87328775
Austria,2022-03-23,171894244,171894244,478319,https://www.sozialministerium.at/Informationen-zum-Coronavirus/Neuartiges-Coronavirus-(2019-nCov).html,81887089,90007155,401023,77296,0.16159926743449454,401023,77296,84488173,87406071
Austria,2022-03-24,172558127,172558127,663883,https://www.sozialministerium.at/Informationen-zum-Coronavirus/Neuartiges-Coronavirus-(2019-nCov).html,82246603,90311524,359514,304369,0.45846783243432954,359514,304369,84847687,87710440
Austria,2022-03-25,172904852,172904852,346725,https://www.sozialministerium.at/Informationen-zum-Coronavirus/Neuartiges-Coronavirus-(2019-nCov).html,82563601,90341251,316998,29727,0.08573653471771576,316998,29727,85164685,87740167
Austria,2022-03-26,173506959,173506959,602107,https://www.sozialministerium.at/Informationen-zum-Coronavirus/Neuartiges-Coronavirus-(2019-nCov).html,83020541,90486418,456940,145167,0.24109834298554908,456940,145167,85621625,87885334
Austria,2022-03-27,173506959,173506959,0,https://www.sozialministerium.at/Informationen-zum-Coronavirus/Neuartiges-Coronavirus-(2019-nCov).html,83020541,90486418,0,0,0.24109834298554908,0,0,85621625,87885334
Austria,2022-03-28,173915134,173915134,408175,https://www.sozialministerium.at/Informationen-zum-Coronavirus/Neuartiges-Coronavirus-(2019-nCov).html,83393964,90521170,373423,34752,0.0851399522263735,373423,34752,85995048,87920086
Austria,2022-03-29,174441569,174441569,526435,https://www.sozialministerium.at/Informationen-zum-Coronavirus/Neuartiges-Coronavirus-(2019-nCov).html,83756232,90685337,362268,164167,0.3118466667299857,362268,164167,86357316,88084253
Austria,2022-03-30,175247380,175247380,805811,https://www.sozialministerium.at/Informationen-zum-Coronavirus/Neuartiges-Coronavirus-(2019-nCov).html,84367192,90880188,610960,194851,0.24180732206435504,610960,194851,86968276,88279104
Austria,2022-03-31,175617287,175617287,369907,https://www.sozialministerium.at/Informationen-zum-Coronavirus/Neuartiges-Coronavirus-(2019-nCov).html,84683692,90933595,316500,53407,0.1443795332340291,316500,53407,87284776,88332511
Austria,2022-04-01,176169662,176169662,552375,https://www.sozialministerium.at/Informationen-zum-Coronavirus/Neuartiges-Coronavirus-(2019-nCov).html,84979117,91190545,295425,256950,0.46517311608961304,295425,256950,87580201,88589461
Austria,2022-04-02,176630000,176630000,460338,https://www.sozialministerium.at/Informationen-zum-Coronavirus/Neuartiges-Coronavirus-(2019-nCov).html,85420429,91209571,441312,19026,0.041330500632144204,441312,19026,88021513,88608487
Austria,2022-04-03,176843630,176843630,213630,https://www.sozialministerium.at/Informationen-zum-Coronavirus/Neuartiges-Coronavirus-(2019-nCov).html,85611308,91232322,190879,22751,0.10649721481065394,190879,22751,88212392,88631238
Austria,2022-04-04,177031676,177031676,188046,https://www.sozialministerium.at/Informationen-zum-Coronavirus/Neuartiges-Coronavirus-(2019-nCov).html,85783267,91248409,171959,16087,0.08554821692564585,171959,16087,88384351,88647325
Austria,2022-04-05,177405999,177405999,374323,https://www.sozialministerium.at/Informationen-zum-Coronavirus/Neuartiges-Coronavirus-(2019-nCov).html,86114461,91291538,331194,43129,0.11521867478087107,331194,43129,88715545,88690454
Austria,2022-04-06,177765409,177765409,359410,https://www.sozialministerium.at/Informationen-zum-Coronavirus/Neuartiges-Coronavirus-(2019-nCov).html,86374715,91390694,260254,99156,0.27588547897943855,260254,99156,88975799,88789610
Austria,2022-04-07,178486429,178486429,721020,https://www.sozialministerium.at/Informationen-zum-Coronavirus/Neuartiges-Coronavirus-(2019-nCov).html,86748016,91738413,373301,347719,0.4822598540955868,373301,347719,89349100,89137329
Austria,2022-04-08,178678948,178678948,192519,https://www.sozialministerium.at/Informationen-zum-Coronavirus/Neuartiges-Coronavirus-(2019-nCov).html,86927582,91751366,179566,12953,0.06728167090001506,179566,12953,89528666,89150282
Austria,2022-04-09,179195293,179195293,516345,https://www.sozialministerium.at/Informationen-zum-Coronavirus/Neuartiges-Coronavirus-(2019-nCov).html,87310553,91884740,382971,133374,0.2583040409028847,382971,133374,89911637,89283656
Austria,2022-04-10,179365755,179365755,170462,https://www.sozialministerium.at/Informationen-zum-Coronavirus/Neuartiges-Coronavirus-(2019-nCov).html,87467041,91898714,156488,13974,0.08197721486313665,156488,13974,90068125,89297630
Austria,2022-04-11,179465832,179465832,100077,https://www.sozialministerium.at/Informationen-zum-Coronavirus/Neuartiges-Coronavirus-(2019-nCov).html,87558667,91907165,91626,8451,0.08444497736742708,91626,8451,90159751,89306081
Austria,2022-04-12,179667360,179667360,201528,https://www.sozialministerium.at/Informationen-zum-Coronavirus/Neuartiges-Coronavirus-(2019-nCov).html,87681347,91986013,122680,78848,0.391250843555238,122680,78848,90282431,89384929
Austria,2022-04-13,179853312,179853312,185952,https://www.sozialministerium.at/Informationen-zum-Coronavirus/Neuartiges-Coronavirus-(2019-nCov).html,87830937,92022375,149590,36362,0.19554508690414732,149590,36362,90432021,89421291
Austria,2022-04-14,180115697,180115697,262385,https://www.sozialministerium.at/Informationen-zum-Coronavirus/Neuartiges-Coronavirus-(2019-nCov).html,87960208,92155489,129271,133114,0.5073232082626674,129271,133114,90561292,89554405
Austria,2022-04-15,180245342,180245342,129645,https://www.sozialministerium.at/Informationen-zum-Coronavirus/Neuartiges-Coronavirus-(2019-nCov).html,88079801,92165541,119593,10052,0.07753480658721894,119593,10052,90680885,89564457
Austria,2022-04-16,180471945,180471945,226603,https://www.sozialministerium.at/Informationen-zum-Coronavirus/Neuartiges-Coronavirus-(2019-nCov).html,88245739,92226206,165938,60665,0.26771490227402106,165938,60665,90846823,89625122
Austria,2022-04-17,180471945,180471945,0,https://www.sozialministerium.at/Informationen-zum-Coronavirus/Neuartiges-Coronavirus-(2019-nCov).html,88245739,92226206,0,0,0.26771490227402106,0,0,90846823,89625122
Austria,2022-04-18,180471945,180471945,0,https://www.sozialministerium.at/Informationen-zum-Coronavirus/Neuartiges-Coronavirus-(2019-nCov).html,88420604,92237330,174865,11124,0.059809988762776295,0,0,90846823,89625122
Austria,2022-04-19,180759844,180759844,287899,https://www.sozialministerium.at/Informationen-zum-Coronavirus/Neuartiges-Coronavirus-(2019-nCov).html,88514633,92245211,94029,7881,0.07733294083014425,265635,22264,91112458,89647386
Austria,2022-04-20,181007797,181007797,247953,https://www.sozialministerium.at/Informationen-zum-Coronavirus/Neuartiges-Coronavirus-(2019-nCov).html,88727691,92280106,213058,34895,0.14073231620508725,213058,34895,91325516,89682281
Austria,2022-04-21,181611092,181611092,603295,https://www.sozialministerium.at/Informationen-zum-Coronavirus/Neuartiges-Coronavirus-(2019-nCov).html,88727691,92280106,0,0,0.14073231620508725,518392,84903,91843908,89767184
Austria,2022-04-22,181611092,181611092,0,https://www.sozialministerium.at/Informationen-zum-Coronavirus/Neuartiges-Coronavirus-(2019-nCov).html,89230326,92380766,502635,100660,0.1668503799965191,0,0,91843908,89767184
Austria,2022-04-23,181724310,181724310,113218,https://www.sozialministerium.at/Informationen-zum-Coronavirus/Neuartiges-Coronavirus-(2019-nCov).html,89333668,92390642,103342,9876,0.08722994576834073,103342,9876,91947250,89777060
Austria,2022-04-24,181825734,181825734,101424,https://www.sozialministerium.at/Informationen-zum-Coronavirus/Neuartiges-Coronavirus-(2019-nCov).html,89430689,92395045,97021,4403,0.043411815743808174,97021,4403,92044271,89781463
Austria,2022-04-25,181910461,181910461,84727,https://www.sozialministerium.at/Informationen-zum-Coronavirus/Neuartiges-Coronavirus-(2019-nCov).html,89511117,92399344,80428,4299,0.05073943371062353,80428,4299,92124699,89785762
Austria,2022-04-26,182179543,182179543,269082,https://www.sozialministerium.at/Informationen-zum-Coronavirus/Neuartiges-Coronavirus-(2019-nCov).html,89679241,92500302,168124,100958,0.37519417872618754,168124,100958,92292823,89886720
Austria,2022-04-27,182416398,182416398,236855,https://www.sozialministerium.at/Informationen-zum-Coronavirus/Neuartiges-Coronavirus-(2019-nCov).html,89883332,92533066,204091,32764,0.1383293576238627,204091,32764,92496914,89919484
Austria,2022-04-28,182596243,182596243,179845,https://www.sozialministerium.at/Informationen-zum-Coronavirus/Neuartiges-Coronavirus-(2019-nCov).html,90035432,92560811,152100,27745,0.15427173399316077,152100,27745,92649014,89947229
Austria,2022-04-29,182842386,182842386,246143,https://www.sozialministerium.at/Informationen-zum-Coronavirus/Neuartiges-Coronavirus-(2019-nCov).html,90274951,92567435,239519,6624,0.026911185774123172,239519,6624,92888533,89953853
Austria,2022-04-30,183002443,183002443,160057,https://www.sozialministerium.at/Informationen-zum-Coronavirus/Neuartiges-Coronavirus-(2019-nCov).html,90425521,92576922,150570,9487,0.05927263412409329,150570,9487,93039103,89963340
Austria,2022-05-01,183086157,183086157,83714,https://www.sozialministerium.at/Informationen-zum-Coronavirus/Neuartiges-Coronavirus-(2019-nCov).html,90504511,92581646,78990,4724,0.05643022672432329,78990,4724,93118093,89968064
Austria,2022-05-02,183157777,183157777,71620,https://www.sozialministerium.at/Informationen-zum-Coronavirus/Neuartiges-Coronavirus-(2019-nCov).html,90571378,92586399,66867,4753,0.06636414409382854,66867,4753,93184960,89972817
Austria,2022-05-03,183321889,183321889,164112,https://www.sozialministerium.at/Informationen-zum-Coronavirus/Neuartiges-Coronavirus-(2019-nCov).html,90717942,92603947,146564,17548,0.10692697669883981,146564,17548,93331524,89990365
Austria,2022-05-04,183522680,183522680,200791,https://www.sozialministerium.at/Informationen-zum-Coronavirus/Neuartiges-Coronavirus-(2019-nCov).html,90888047,92634633,170105,30686,0.15282557485146248,170105,30686,93501629,90021051
Austria,2022-05-05,183682889,183682889,160209,https://www.sozialministerium.at/Informationen-zum-Coronavirus/Neuartiges-Coronavirus-(2019-nCov).html,91021987,92660902,133940,26269,0.16396706801740227,133940,26269,93635569,90047320
Austria,2022-05-06,183969298,183969298,286409,https://www.sozialministerium.at/Informationen-zum-Coronavirus/Neuartiges-Coronavirus-(2019-nCov).html,91296663,92672635,274676,11733,0.04096589143497586,274676,11733,93910245,90059053
Austria,2022-05-07,184069396,184069396,100098,https://www.sozialministerium.at/Informationen-zum-Coronavirus/Neuartiges-Coronavirus-(2019-nCov).html,91385937,92683459,89274,10824,0.10813402865192112,89274,10824,93999519,90069877
Austria,2022-05-08,184147092,184147092,77696,https://www.sozialministerium.at/Informationen-zum-Coronavirus/Neuartiges-Coronavirus-(2019-nCov).html,91458407,92688685,72470,5226,0.06726214991762768,72470,5226,94071989,90075103
Austria,2022-05-09,184215396,184215396,68304,https://www.sozialministerium.at/Informationen-zum-Coronavirus/Neuartiges-Coronavirus-(2019-nCov).html,91522036,92693360,63629,4675,0.06844401499180136,63629,4675,94135618,90079778
Austria,2022-05-10,184388182,184388182,172786,https://www.sozialministerium.at/Informationen-zum-Coronavirus/Neuartiges-Coronavirus-(2019-nCov).html,91682823,92705359,160787,11999,0.06944428368039077,160787,11999,94296405,90091777
Austria,2022-05-11,184617102,184617102,228920,https://www.sozialministerium.at/Informationen-zum-Coronavirus/Neuartiges-Coronavirus-(2019-nCov).html,91846601,92770501,163778,65142,0.2845622925039315,163778,65142,94460183,90156919
Austria,2022-05-12,184765500,184765500,148398,https://www.sozialministerium.at/Informationen-zum-Coronavirus/Neuartiges-Coronavirus-(2019-nCov).html,91966680,92798820,120079,28319,0.19083141282227523,120079,28319,94580262,90185238
Austria,2022-05-13,184874698,184874698,109198,https://www.sozialministerium.at/Informationen-zum-Coronavirus/Neuartiges-Coronavirus-(2019-nCov).html,92066600,92808098,99920,9278,0.08496492609754758,99920,9278,94680182,90194516
Austria,2022-05-14,184964595,184964595,89897,https://www.sozialministerium.at/Informationen-zum-Coronavirus/Neuartiges-Coronavirus-(2019-nCov).html,92149436,92815159,82836,7061,0.07854544645538783,82836,7061,94763018,90201577
Austria,2022-05-15,185034905,185034905,70310,https://www.sozialministerium.at/Informationen-zum-Coronavirus/Neuartiges-Coronavirus-(2019-nCov).html,92216245,92818660,66809,3501,0.04979377044517139,66809,3501,94829827,90205078
Austria,2022-05-16,185470038,185470038,435133,https://www.sozialministerium.at/Informationen-zum-Coronavirus/Neuartiges-Coronavirus-(2019-nCov).html,92431784,93038254,215539,219594,0.5046594949130496,215539,219594,95045366,90424672
Austria,2022-05-17,185625927,185625927,155889,https://www.sozialministerium.at/Informationen-zum-Coronavirus/Neuartiges-Coronavirus-(2019-nCov).html,92571934,93053993,140150,15739,0.10096286460237733,140150,15739,95185516,90440411
Austria,2022-05-18,185851263,185851263,225336,https://www.sozialministerium.at/Informationen-zum-Coronavirus/Neuartiges-Coronavirus-(2019-nCov).html,92770831,93080432,198897,26439,0.11733145169879647,198897,26439,95384413,90466850
Austria,2022-05-19,185987121,185987121,135858,https://www.sozialministerium.at/Informationen-zum-Coronavirus/Neuartiges-Coronavirus-(2019-nCov).html,92884279,93102842,113448,22410,0.164951640683655,113448,22410,95497861,90489260
Austria,2022-05-20,186214893,186214893,227772,https://www.sozialministerium.at/Informationen-zum-Coronavirus/Neuartiges-Coronavirus-(2019-nCov).html,93105468,93109425,221189,6583,0.02890170872627013,221189,6583,95719050,90495843
Austria,2022-05-21,186327528,186327528,112635,https://www.sozialministerium.at/Informationen-zum-Coronavirus/Neuartiges-Coronavirus-(2019-nCov).html,93179768,93147760,74300,38335,0.34034713898876906,74300,38335,95793350,90534178
Austria,2022-05-22,186381345,186381345,53817,https://www.sozialministerium.at/Informationen-zum-Coronavirus/Neuartiges-Coronavirus-(2019-nCov).html,93230442,93150903,50674,3143,0.05840162030585131,50674,3143,95844024,90537321
Austria,2022-05-23,186421071,186421071,39726,https://www.sozialministerium.at/Informationen-zum-Coronavirus/Neuartiges-Coronavirus-(2019-nCov).html,93266786,93154285,36344,3382,0.0851331621608015,36344,3382,95880368,90540703
Austria,2022-05-24,186711414,186711414,290343,https://www.sozialministerium.at/Informationen-zum-Coronavirus/Neuartiges-Coronavirus-(2019-nCov).html,93415716,93295698,148930,141413,0.4870549660229453,148930,141413,96029298,90682116
Austria,2022-05-25,186968312,186968312,256898,https://www.sozialministerium.at/Informationen-zum-Coronavirus/Neuartiges-Coronavirus-(2019-nCov).html,93647406,93320906,231690,25208,0.09812454748577257,231690,25208,96260988,90707324
Austria,2022-05-26,187227485,187227485,259173,https://www.sozialministerium.at/Informationen-zum-Coronavirus/Neuartiges-Coronavirus-(2019-nCov).html,93876126,93351359,228720,30453,0.11750066557859036,228720,30453,96489708,90737777
Austria,2022-05-27,187285043,187285043,57558,https://www.sozialministerium.at/Informationen-zum-Coronavirus/Neuartiges-Coronavirus-(2019-nCov).html,93928578,93356465,52452,5106,0.08871051808610445,52452,5106,96542160,90742883
Austria,2022-05-28,187285043,187285043,0,https://www.sozialministerium.at/Informationen-zum-Coronavirus/Neuartiges-Coronavirus-(2019-nCov).html,93928578,93356465,0,0,0.08871051808610445,0,0,96542160,90742883
Austria,2022-05-29,187437282,187437282,152239,https://www.sozialministerium.at/Informationen-zum-Coronavirus/Neuartiges-Coronavirus-(2019-nCov).html,94026192,93365805,97614,9340,0.08732726218748246,138944,13295,96681104,90756178
Austria,2022-05-30,187437282,187437282,0,https://www.sozialministerium.at/Informationen-zum-Coronavirus/Neuartiges-Coronavirus-(2019-nCov).html,94067147,93370135,40955,4330,0.09561665010489125,0,0,96681104,90756178
Austria,2022-05-31,187497861,187497861,60579,https://www.sozialministerium.at/Informationen-zum-Coronavirus/Neuartiges-Coronavirus-(2019-nCov).html,94116589,93381272,49442,11137,0.18384258571452153,49442,11137,96730546,90767315
Austria,2022-06-01,187746906,187746906,249045,https://www.sozialministerium.at/Informationen-zum-Coronavirus/Neuartiges-Coronavirus-(2019-nCov).html,94340842,93406064,224253,24792,0.09954827440823948,224253,24792,96954799,90792107
Austria,2022-06-02,187900569,187900569,153663,https://www.sozialministerium.at/Informationen-zum-Coronavirus/Neuartiges-Coronavirus-(2019-nCov).html,94470367,93430202,129525,24138,0.1570840085121337,129525,24138,97084324,90816245
Austria,2022-06-03,187900569,187900569,0,https://www.sozialministerium.at/Informationen-zum-Coronavirus/Neuartiges-Coronavirus-(2019-nCov).html,94470367,93430202,0,0,0.1570840085121337,0,0,97084324,90816245
Austria,2022-06-04,187900569,187900569,0,https://www.sozialministerium.at/Informationen-zum-Coronavirus/Neuartiges-Coronavirus-(2019-nCov).html,94648327,93458874,177960,28672,0.1387587595338573,0,0,97084324,90816245
Austria,2022-06-05,188148905,188148905,248336,https://www.sozialministerium.at/Informationen-zum-Coronavirus/Neuartiges-Coronavirus-(2019-nCov).html,94687474,93461431,39147,2557,0.061313063495108386,233110,15226,97317434,90831471
Austria,2022-06-06,188169727,188169727,20822,https://www.sozialministerium.at/Informationen-zum-Coronavirus/Neuartiges-Coronavirus-(2019-nCov).html,94706141,93463586,18667,2155,0.10349630198828162,18667,2155,97336101,90833626
Austria,2022-06-07,188169727,188169727,0,https://www.sozialministerium.at/Informationen-zum-Coronavirus/Neuartiges-Coronavirus-(2019-nCov).html,94706141,93463586,0,0,0.10349630198828162,0,0,97336101,90833626
Austria,2022-06-08,188169727,188169727,0,https://www.sozialministerium.at/Informationen-zum-Coronavirus/Neuartiges-Coronavirus-(2019-nCov).html,94801943,93513253,95802,49667,0.3414266957221126,0,0,97336101,90833626
Austria,2022-06-09,188552166,188552166,382439,https://www.sozialministerium.at/Informationen-zum-Coronavirus/Neuartiges-Coronavirus-(2019-nCov).html,94901577,93650589,99634,137336,0.579550154027936,160796,221643,97496897,91055269
Austria,2022-06-10,188552166,188552166,0,https://www.sozialministerium.at/Informationen-zum-Coronavirus/Neuartiges-Coronavirus-(2019-nCov).html,94901577,93650589,0,0,0.579550154027936,0,0,97496897,91055269
Austria,2022-06-11,188552166,188552166,0,https://www.sozialministerium.at/Informationen-zum-Coronavirus/Neuartiges-Coronavirus-(2019-nCov).html,95020114,93672840,118537,22251,0.15804614029604797,0,0,97496897,91055269
Austria,2022-06-12,188725160,188725160,172994,https://www.sozialministerium.at/Informationen-zum-Coronavirus/Neuartiges-Coronavirus-(2019-nCov).html,95048828,93676332,28714,3492,0.10842700117990436,154237,18757,97651134,91074026
Austria,2022-06-13,188792612,188792612,67452,https://www.sozialministerium.at/Informationen-zum-Coronavirus/Neuartiges-Coronavirus-(2019-nCov).html,95112978,93679634,64150,3302,0.048953329775247585,64150,3302,97715284,91077328
Austria,2022-06-14,188904254,188904254,111642,https://www.sozialministerium.at/Informationen-zum-Coronavirus/Neuartiges-Coronavirus-(2019-nCov).html,95189910,93714344,76932,34710,0.3109044983070887,76932,34710,97792216,91112038
Austria,2022-06-15,189099067,189099067,194813,https://www.sozialministerium.at/Informationen-zum-Coronavirus/Neuartiges-Coronavirus-(2019-nCov).html,95297062,93802005,107152,87661,0.44997510433081983,107152,87661,97899368,91199699
Austria,2022-06-16,189188265,189188265,89198,https://www.sozialministerium.at/Informationen-zum-Coronavirus/Neuartiges-Coronavirus-(2019-nCov).html,95369460,93818805,72398,16800,0.18834503015762685,72398,16800,97971766,91216499
Austria,2022-06-17,189188265,189188265,0,https://www.sozialministerium.at/Informationen-zum-Coronavirus/Neuartiges-Coronavirus-(2019-nCov).html,95369460,93818805,0,0,0.18834503015762685,0,0,97971766,91216499
Austria,2022-06-18,189308093,189308093,119828,https://www.sozialministerium.at/Informationen-zum-Coronavirus/Neuartiges-Coronavirus-(2019-nCov).html,95469652,93838441,100192,19636,0.16386821110258037,100192,19636,98071958,91236135
Austria,2022-06-19,189359230,189359230,51137,https://www.sozialministerium.at/Informationen-zum-Coronavirus/Neuartiges-Coronavirus-(2019-nCov).html,95518938,93840292,49286,1851,0.03619688288323523,49286,1851,98121244,91237986
Austria,2022-06-20,189413082,189413082,53852,https://www.sozialministerium.at/Informationen-zum-Coronavirus/Neuartiges-Coronavirus-(2019-nCov).html,95570430,93842652,51492,2360,0.04382381341454356,51492,2360,98172736,91240346
Austria,2022-06-21,189588069,189588069,174987,https://www.sozialministerium.at/Informationen-zum-Coronavirus/Neuartiges-Coronavirus-(2019-nCov).html,95654732,93933337,84302,90685,0.5182384977169733,84302,90685,98257038,91331031
Austria,2022-06-22,189694060,189694060,105991,https://www.sozialministerium.at/Informationen-zum-Coronavirus/Neuartiges-Coronavirus-(2019-nCov).html,95752501,93941559,97769,8222,0.07757262409072468,97769,8222,98354807,91339253
Austria,2022-06-23,189894351,189894351,200291,https://www.sozialministerium.at/Informationen-zum-Coronavirus/Neuartiges-Coronavirus-(2019-nCov).html,95752501,93941559,0,0,0.07757262409072468,184754,15537,98539561,91354790
Austria,2022-06-24,189894351,189894351,0,https://www.sozialministerium.at/Informationen-zum-Coronavirus/Neuartiges-Coronavirus-(2019-nCov).html,95752501,93941559,0,0,0.07757262409072468,0,0,98539561,91354790
Austria,2022-06-25,189894351,189894351,0,https://www.sozialministerium.at/Informationen-zum-Coronavirus/Neuartiges-Coronavirus-(2019-nCov).html,95752501,93941559,0,0,0.07757262409072468,0,0,98539561,91354790
Austria,2022-06-26,190108723,190108723,214372,https://www.sozialministerium.at/Informationen-zum-Coronavirus/Neuartiges-Coronavirus-(2019-nCov).html,95752501,93941559,0,0,0.07757262409072468,197743,16629,98737304,91371419
Austria,2022-06-27,190225970,190225970,117247,https://www.sozialministerium.at/Informationen-zum-Coronavirus/Neuartiges-Coronavirus-(2019-nCov).html,95752501,93941559,0,0,0.07757262409072468,108152,9095,98845456,91380514
Austria,2022-06-28,190225970,190225970,0,https://www.sozialministerium.at/Informationen-zum-Coronavirus/Neuartiges-Coronavirus-(2019-nCov).html,95752501,93941559,0,0,0.07757262409072468,0,0,98845456,91380514
Austria,2022-06-29,190517002,190517002,291032,https://www.sozialministerium.at/Informationen-zum-Coronavirus/Neuartiges-Coronavirus-(2019-nCov).html,95752501,93941559,0,0,0.07757262409072468,268456,22576,99113912,91403090
Austria,2022-06-30,190610200,190610200,93198,https://www.sozialministerium.at/Informationen-zum-Coronavirus/Neuartiges-Coronavirus-(2019-nCov).html,95752501,93941559,0,0,0.07757262409072468,85968,7230,99199880,91410320
Austria,2022-07-01,190610200,190610200,0,https://www.sozialministerium.at/Informationen-zum-Coronavirus/Neuartiges-Coronavirus-(2019-nCov).html,95752501,93941559,0,0,0.07757262409072468,0,0,99199880,91410320
Austria,2022-07-02,190610200,190610200,0,https://www.sozialministerium.at/Informationen-zum-Coronavirus/Neuartiges-Coronavirus-(2019-nCov).html,95752501,93941559,0,0,0.07757262409072468,0,0,99199880,91410320
Austria,2022-07-03,190833342,190833342,223142,https://www.sozialministerium.at/Informationen-zum-Coronavirus/Neuartiges-Coronavirus-(2019-nCov).html,95752501,93941559,0,0,0.07757262409072468,205832,17310,99405712,91427630
Austria,2022-07-04,190970223,190970223,136881,https://www.sozialministerium.at/Informationen-zum-Coronavirus/Neuartiges-Coronavirus-(2019-nCov).html,95752501,93941559,0,0,0.07757262409072468,126263,10618,99531975,91438248
Austria,2022-07-05,191082248,191082248,112025,https://www.sozialministerium.at/Informationen-zum-Coronavirus/Neuartiges-Coronavirus-(2019-nCov).html,95752501,93941559,0,0,0.07757262409072468,103335,8690,99635310,91446938
Austria,2022-07-06,191164442,191164442,82194,https://www.sozialministerium.at/Informationen-zum-Coronavirus/Neuartiges-Coronavirus-(2019-nCov).html,95752501,93941559,0,0,0.07757262409072468,75818,6376,99711128,91453314
Austria,2022-07-07,191268761,191268761,104319,https://www.sozialministerium.at/Informationen-zum-Coronavirus/Neuartiges-Coronavirus-(2019-nCov).html,95752501,93941559,0,0,0.07757262409072468,96227,8092,99807355,91461406
Austria,2022-07-08,191268761,191268761,0,https://www.sozialministerium.at/Informationen-zum-Coronavirus/Neuartiges-Coronavirus-(2019-nCov).html,97098494,94170267,1345993,228708,0.14523900092779518,0,0,99807355,91461406
Austria,2022-07-09,191372091,191372091,103330,https://www.sozialministerium.at/Informationen-zum-Coronavirus/Neuartiges-Coronavirus-(2019-nCov).html,97194491,94177600,95997,7333,0.07096680538081873,95997,7333,99903352,91468739
Austria,2022-07-10,191428491,191428491,56400,https://www.sozialministerium.at/Informationen-zum-Coronavirus/Neuartiges-Coronavirus-(2019-nCov).html,97248558,94179933,54067,2333,0.041365248226950355,54067,2333,99957419,91471072
Austria,2022-07-11,191492992,191492992,64501,https://www.sozialministerium.at/Informationen-zum-Coronavirus/Neuartiges-Coronavirus-(2019-nCov).html,97309991,94183001,61433,3068,0.04756515402861971,61433,3068,100018852,91474140
Austria,2022-07-12,191602402,191602402,109410,https://www.sozialministerium.at/Informationen-zum-Coronavirus/Neuartiges-Coronavirus-(2019-nCov).html,97399050,94203352,89059,20351,0.18600676354994974,89059,20351,100107911,91494491
Austria,2022-07-13,191723708,191723708,121306,https://www.sozialministerium.at/Informationen-zum-Coronavirus/Neuartiges-Coronavirus-(2019-nCov).html,97495309,94228399,96259,25047,0.20647783291840469,96259,25047,100204170,91519538
Austria,2022-07-14,191905533,191905533,181825,https://www.sozialministerium.at/Informationen-zum-Coronavirus/Neuartiges-Coronavirus-(2019-nCov).html,97605034,94300499,109725,72100,0.3965351299326275,109725,72100,100313895,91591638
Austria,2022-07-15,192060116,192060116,154583,https://www.sozialministerium.at/Informationen-zum-Coronavirus/Neuartiges-Coronavirus-(2019-nCov).html,97698861,94361255,93827,60756,0.3930315752702432,93827,60756,100407722,91652394
Austria,2022-07-16,192175175,192175175,115059,https://www.sozialministerium.at/Informationen-zum-Coronavirus/Neuartiges-Coronavirus-(2019-nCov).html,97770582,94404593,71721,43338,0.3766589315047063,71721,43338,100479443,91695732
Austria,2022-07-17,192241115,192241115,65940,https://www.sozialministerium.at/Informationen-zum-Coronavirus/Neuartiges-Coronavirus-(2019-nCov).html,97834121,94406994,63539,2401,0.03641188959660297,63539,2401,100542982,91698133
Austria,2022-07-18,192298733,192298733,57618,https://www.sozialministerium.at/Informationen-zum-Coronavirus/Neuartiges-Coronavirus-(2019-nCov).html,97888932,94409801,54811,2807,0.04871741469679614,54811,2807,100597793,91700940
Austria,2022-07-19,192418803,192418803,120070,https://www.sozialministerium.at/Informationen-zum-Coronavirus/Neuartiges-Coronavirus-(2019-nCov).html,97979008,94439795,90076,29994,0.2498042808361789,90076,29994,100687869,91730934
Austria,2022-07-20,192533166,192533166,114363,https://www.sozialministerium.at/Informationen-zum-Coronavirus/Neuartiges-Coronavirus-(2019-nCov).html,98067523,94465643,88515,25848,0.22601715589832375,88515,25848,100776384,91756782
Austria,2022-07-21,192634445,192634445,101279,https://www.sozialministerium.at/Informationen-zum-Coronavirus/Neuartiges-Coronavirus-(2019-nCov).html,98151158,94483287,83635,17644,0.17421183068553203,83635,17644,100860019,91774426
Austria,2022-07-22,192753239,192753239,118794,https://www.sozialministerium.at/Informationen-zum-Coronavirus/Neuartiges-Coronavirus-(2019-nCov).html,98263589,94489650,112431,6363,0.05356331127834739,112431,6363,100972450,91780789
Austria,2022-07-23,192833093,192833093,79854,https://www.sozialministerium.at/Informationen-zum-Coronavirus/Neuartiges-Coronavirus-(2019-nCov).html,98335748,94497345,72159,7695,0.09636336313772635,72159,7695,101044609,91788484
Austria,2022-07-24,192833977,192833977,884,https://www.sozialministerium.at/Informationen-zum-Coronavirus/Neuartiges-Coronavirus-(2019-nCov).html,98395564,94499647,59816,2302,0.03705850156154416,851,33,101045460,91788517
Austria,2022-07-25,192947042,192947042,113065,https://www.sozialministerium.at/Informationen-zum-Coronavirus/Neuartiges-Coronavirus-(2019-nCov).html,98444446,94502596,48882,2949,0.056896451930311974,106632,6433,101152092,91794950
Austria,2022-07-26,193050411,193050411,103369,https://www.sozialministerium.at/Informationen-zum-Coronavirus/Neuartiges-Coronavirus-(2019-nCov).html,98526899,94523512,82453,20916,0.20234306223335816,82453,20916,101234545,91815866
Austria,2022-07-27,193162944,193162944,112533,https://www.sozialministerium.at/Informationen-zum-Coronavirus/Neuartiges-Coronavirus-(2019-nCov).html,98610495,94552449,83596,28937,0.2571423493553002,83596,28937,101318141,91844803
Austria,2022-07-28,193245569,193245569,82625,https://www.sozialministerium.at/Informationen-zum-Coronavirus/Neuartiges-Coronavirus-(2019-nCov).html,98677547,94568022,67052,15573,0.18847806354009078,67052,15573,101385193,91860376
Austria,2022-07-29,193327370,193327370,81801,https://www.sozialministerium.at/Informationen-zum-Coronavirus/Neuartiges-Coronavirus-(2019-nCov).html,98748594,94578776,71047,10754,0.1314653855087346,71047,10754,101456240,91871130
Austria,2022-07-30,193394168,193394168,66798,https://www.sozialministerium.at/Informationen-zum-Coronavirus/Neuartiges-Coronavirus-(2019-nCov).html,98810186,94583982,61592,5206,0.07793646516362765,61592,5206,101517832,91876336
Austria,2022-07-31,193444031,193444031,49863,https://www.sozialministerium.at/Informationen-zum-Coronavirus/Neuartiges-Coronavirus-(2019-nCov).html,98858091,94585940,47905,1958,0.03926759320538275,47905,1958,101565737,91878294
Austria,2022-08-01,193495696,193495696,51665,https://www.sozialministerium.at/Informationen-zum-Coronavirus/Neuartiges-Coronavirus-(2019-nCov).html,98906689,94589007,48598,3067,0.059363205264685956,48598,3067,101614335,91881361
Austria,2022-08-02,193598026,193598026,102330,https://www.sozialministerium.at/Informationen-zum-Coronavirus/Neuartiges-Coronavirus-(2019-nCov).html,98980804,94617222,74115,28215,0.2757255936675462,74115,28215,101688450,91909576
Austria,2022-08-03,193671589,193671589,73563,https://www.sozialministerium.at/Informationen-zum-Coronavirus/Neuartiges-Coronavirus-(2019-nCov).html,99050514,94621075,69710,3853,0.05237687424384541,69710,3853,101758160,91913429
Austria,2022-08-04,193765737,193765737,94148,https://www.sozialministerium.at/Informationen-zum-Coronavirus/Neuartiges-Coronavirus-(2019-nCov).html,99114122,94651615,63608,30540,0.3243828865190976,63608,30540,101821768,91943969
Austria,2022-08-05,193830947,193830947,65210,https://www.sozialministerium.at/Informationen-zum-Coronavirus/Neuartiges-Coronavirus-(2019-nCov).html,99174131,94656816,60009,5201,0.07975770587333231,60009,5201,101881777,91949170
Austria,2022-08-06,193892338,193892338,61391,https://www.sozialministerium.at/Informationen-zum-Coronavirus/Neuartiges-Coronavirus-(2019-nCov).html,99230164,94662174,56033,5358,0.08727663664054992,56033,5358,101937810,91954528
Austria,2022-08-07,193935607,193935607,43269,https://www.sozialministerium.at/Informationen-zum-Coronavirus/Neuartiges-Coronavirus-(2019-nCov).html,99272299,94663308,42135,1134,0.026208139776745475,42135,1134,101979945,91955662
Austria,2022-08-08,193951281,193951281,15674,https://www.sozialministerium.at/Informationen-zum-Coronavirus/Neuartiges-Coronavirus-(2019-nCov).html,99284674,94666607,12375,3299,0.21047594742886308,12375,3299,101992320,91958961
Austria,2022-08-09,194067808,194067808,116527,https://www.sozialministerium.at/Informationen-zum-Coronavirus/Neuartiges-Coronavirus-(2019-nCov).html,99374266,94693542,89592,26935,0.2311481459232624,89592,26935,102081912,91985896
Austria,2022-08-10,194158176,194158176,90368,https://www.sozialministerium.at/Informationen-zum-Coronavirus/Neuartiges-Coronavirus-(2019-nCov).html,99440539,94717637,66273,24095,0.2666319936260623,66273,24095,102148185,92009991
Austria,2022-08-11,194232379,194232379,74203,https://www.sozialministerium.at/Informationen-zum-Coronavirus/Neuartiges-Coronavirus-(2019-nCov).html,99497720,94734659,57181,17022,0.2293977332452866,57181,17022,102205366,92027013
Austria,2022-08-12,194298750,194298750,66371,https://www.sozialministerium.at/Informationen-zum-Coronavirus/Neuartiges-Coronavirus-(2019-nCov).html,99557210,94741540,59490,6881,0.10367479772792335,59490,6881,102264856,92033894
Austria,2022-08-13,194357227,194357227,58477,https://www.sozialministerium.at/Informationen-zum-Coronavirus/Neuartiges-Coronavirus-(2019-nCov).html,99611187,94746040,53977,4500,0.07695333207927903,53977,4500,102318833,92038394
Austria,2022-08-14,194398621,194398621,41394,https://www.sozialministerium.at/Informationen-zum-Coronavirus/Neuartiges-Coronavirus-(2019-nCov).html,99650283,94748338,39096,2298,0.055515292071314684,39096,2298,102357929,92040692
Austria,2022-08-15,194429903,194429903,31282,https://www.sozialministerium.at/Informationen-zum-Coronavirus/Neuartiges-Coronavirus-(2019-nCov).html,99679553,94750350,29270,2012,0.06431813822645611,29270,2012,102387199,92042704
Austria,2022-08-16,194473710,194473710,43807,https://www.sozialministerium.at/Informationen-zum-Coronavirus/Neuartiges-Coronavirus-(2019-nCov).html,99719074,94754636,39521,4286,0.0978382450293332,39521,4286,102426720,92046990
Austria,2022-08-17,194573857,194573857,100147,https://www.sozialministerium.at/Informationen-zum-Coronavirus/Neuartiges-Coronavirus-(2019-nCov).html,99787096,94786761,68022,32125,0.32077845567016483,68022,32125,102494742,92079115
Austria,2022-08-18,194654407,194654407,80550,https://www.sozialministerium.at/Informationen-zum-Coronavirus/Neuartiges-Coronavirus-(2019-nCov).html,99853845,94800562,66749,13801,0.17133457479826195,66749,13801,102561491,92092916
Austria,2022-08-19,194717291,194717291,62884,https://www.sozialministerium.at/Informationen-zum-Coronavirus/Neuartiges-Coronavirus-(2019-nCov).html,99908226,94809065,54381,8503,0.13521722536734304,54381,8503,102615872,92101419
Austria,2022-08-20,194771813,194771813,54522,https://www.sozialministerium.at/Informationen-zum-Coronavirus/Neuartiges-Coronavirus-(2019-nCov).html,99955988,94815825,47762,6760,0.12398664759179781,47762,6760,102663634,92108179
Austria,2022-08-21,194818332,194818332,46519,https://www.sozialministerium.at/Informationen-zum-Coronavirus/Neuartiges-Coronavirus-(2019-nCov).html,100000397,94817935,44409,2110,0.04535781078699026,44409,2110,102708043,92110289
Austria,2022-08-22,194856971,194856971,38639,https://www.sozialministerium.at/Informationen-zum-Coronavirus/Neuartiges-Coronavirus-(2019-nCov).html,100036123,94820848,35726,2913,0.07539014984859857,35726,2913,102743769,92113202
Austria,2022-08-23,194940272,194940272,83301,https://www.sozialministerium.at/Informationen-zum-Coronavirus/Neuartiges-Coronavirus-(2019-nCov).html,100101087,94839185,64964,18337,0.22012941021116192,64964,18337,102808733,92131539
Austria,2022-08-24,195047308,195047308,107036,https://www.sozialministerium.at/Informationen-zum-Coronavirus/Neuartiges-Coronavirus-(2019-nCov).html,100164876,94882432,63789,43247,0.4040416308531709,63789,43247,102872522,92174786
Austria,2022-08-25,195125367,195125367,78059,https://www.sozialministerium.at/Informationen-zum-Coronavirus/Neuartiges-Coronavirus-(2019-nCov).html,100222009,94903358,57133,20926,0.2680792733701431,57133,20926,102929655,92195712
Austria,2022-08-26,195187188,195187188,61821,https://www.sozialministerium.at/Informationen-zum-Coronavirus/Neuartiges-Coronavirus-(2019-nCov).html,100276457,94910731,54448,7373,0.11926368062632439,54448,7373,102984103,92203085
Austria,2022-08-27,195244560,195244560,57372,https://www.sozialministerium.at/Informationen-zum-Coronavirus/Neuartiges-Coronavirus-(2019-nCov).html,100327643,94916917,51186,6186,0.10782263124869274,51186,6186,103035289,92209271
Austria,2022-08-28,195286296,195286296,41736,https://www.sozialministerium.at/Informationen-zum-Coronavirus/Neuartiges-Coronavirus-(2019-nCov).html,100367177,94919119,39534,2202,0.05276020701552617,39534,2202,103074823,92211473
Austria,2022-08-29,195322960,195322960,36664,https://www.sozialministerium.at/Informationen-zum-Coronavirus/Neuartiges-Coronavirus-(2019-nCov).html,100400898,94922062,33721,2943,0.08026947414357408,33721,2943,103108544,92214416
Austria,2022-08-30,195410181,195410181,87221,https://www.sozialministerium.at/Informationen-zum-Coronavirus/Neuartiges-Coronavirus-(2019-nCov).html,100467021,94943160,66123,21098,0.24189128764861673,66123,21098,103174667,92235514
Austria,2022-08-31,195496226,195496226,86045,https://www.sozialministerium.at/Informationen-zum-Coronavirus/Neuartiges-Coronavirus-(2019-nCov).html,100530981,94965245,63960,22085,0.256668022546342,63960,22085,103238627,92257599
Austria,2022-09-01,195567915,195567915,71689,https://www.sozialministerium.at/Informationen-zum-Coronavirus/Neuartiges-Coronavirus-(2019-nCov).html,100587507,94980408,56526,15163,0.21151083150832067,56526,15163,103295153,92272762
Austria,2022-09-02,195634872,195634872,66957,https://www.sozialministerium.at/Informationen-zum-Coronavirus/Neuartiges-Coronavirus-(2019-nCov).html,100644601,94990271,57094,9863,0.14730349328673625,57094,9863,103352247,92282625
Austria,2022-09-03,195691611,195691611,56739,https://www.sozialministerium.at/Informationen-zum-Coronavirus/Neuartiges-Coronavirus-(2019-nCov).html,100694838,94996773,50237,6502,0.11459489945187613,50237,6502,103402484,92289127
Austria,2022-09-04,195742096,195742096,50485,https://www.sozialministerium.at/Informationen-zum-Coronavirus/Neuartiges-Coronavirus-(2019-nCov).html,100743250,94998846,48412,2073,0.04106170149549371,48412,2073,103450896,92291200
Austria,2022-09-05,195832618,195832618,90522,https://www.sozialministerium.at/Informationen-zum-Coronavirus/Neuartiges-Coronavirus-(2019-nCov).html,100830247,95002371,86997,3525,0.03894080996884735,86997,3525,103537893,92294725
Austria,2022-09-06,195966250,195966250,133632,https://www.sozialministerium.at/Informationen-zum-Coronavirus/Neuartiges-Coronavirus-(2019-nCov).html,100932119,95034131,101872,31760,0.2376676245210728,101872,31760,103639765,92326485
Austria,2022-09-07,196049378,196049378,83128,https://www.sozialministerium.at/Informationen-zum-Coronavirus/Neuartiges-Coronavirus-(2019-nCov).html,100993637,95055741,61518,21610,0.25996054277740355,61518,21610,103701283,92348095
Austria,2022-09-08,196126215,196126215,76837,https://www.sozialministerium.at/Informationen-zum-Coronavirus/Neuartiges-Coronavirus-(2019-nCov).html,101052826,95073389,59189,17648,0.229681013053607,59189,17648,103760472,92365743
Austria,2022-09-09,196152343,196152343,26128,https://www.sozialministerium.at/Informationen-zum-Coronavirus/Neuartiges-Coronavirus-(2019-nCov).html,101071630,95080713,18804,7324,0.2803123086344152,18804,7324,103779276,92373067
Austria,2022-09-10,196258938,196258938,106595,https://www.sozialministerium.at/Informationen-zum-Coronavirus/Neuartiges-Coronavirus-(2019-nCov).html,101165341,95093597,93711,12884,0.12086870866363338,93711,12884,103872987,92385951
Austria,2022-09-11,196305599,196305599,46661,https://www.sozialministerium.at/Informationen-zum-Coronavirus/Neuartiges-Coronavirus-(2019-nCov).html,101209640,95095959,44299,2362,0.05062043248108699,44299,2362,103917286,92388313
Austria,2022-09-12,196345918,196345918,40319,https://www.sozialministerium.at/Informationen-zum-Coronavirus/Neuartiges-Coronavirus-(2019-nCov).html,101246769,95099149,37129,3190,0.07911902576948833,37129,3190,103954415,92391503
Austria,2022-09-13,196345918,196345918,0,https://www.sozialministerium.at/Informationen-zum-Coronavirus/Neuartiges-Coronavirus-(2019-nCov).html,101246769,95099149,0,0,0.07911902576948833,0,0,103954415,92391503
Austria,2022-09-14,196345918,196345918,0,https://www.sozialministerium.at/Informationen-zum-Coronavirus/Neuartiges-Coronavirus-(2019-nCov).html,101246769,95099149,0,0,0.07911902576948833,0,0,103954415,92391503
Austria,2022-09-15,196345918,196345918,0,https://www.sozialministerium.at/Informationen-zum-Coronavirus/Neuartiges-Coronavirus-(2019-nCov).html,101246769,95099149,0,0,0.07911902576948833,0,0,103954415,92391503
Austria,2022-09-16,196345918,196345918,0,https://www.sozialministerium.at/Informationen-zum-Coronavirus/Neuartiges-Coronavirus-(2019-nCov).html,101246769,95099149,0,0,0.07911902576948833,0,0,103954415,92391503
Austria,2022-09-17,196345918,196345918,0,https://www.sozialministerium.at/Informationen-zum-Coronavirus/Neuartiges-Coronavirus-(2019-nCov).html,101246769,95099149,0,0,0.07911902576948833,0,0,103954415,92391503
Austria,2022-09-18,196345918,196345918,0,https://www.sozialministerium.at/Informationen-zum-Coronavirus/Neuartiges-Coronavirus-(2019-nCov).html,101246769,95099149,0,0,0.07911902576948833,0,0,103954415,92391503
Austria,2022-09-19,196345918,196345918,0,https://www.sozialministerium.at/Informationen-zum-Coronavirus/Neuartiges-Coronavirus-(2019-nCov).html,101246769,95099149,0,0,0.07911902576948833,0,0,103954415,92391503
Austria,2022-09-20,196345918,196345918,0,https://www.sozialministerium.at/Informationen-zum-Coronavirus/Neuartiges-Coronavirus-(2019-nCov).html,101246769,95099149,0,0,0.07911902576948833,0,0,103954415,92391503
Austria,2022-09-21,196345918,196345918,0,https://www.sozialministerium.at/Informationen-zum-Coronavirus/Neuartiges-Coronavirus-(2019-nCov).html,101246769,95099149,0,0,0.07911902576948833,0,0,103954415,92391503
Austria,2022-09-22,196345918,196345918,0,https://www.sozialministerium.at/Informationen-zum-Coronavirus/Neuartiges-Coronavirus-(2019-nCov).html,101246769,95099149,0,0,0.07911902576948833,0,0,103954415,92391503
Austria,2022-09-23,196345918,196345918,0,https://www.sozialministerium.at/Informationen-zum-Coronavirus/Neuartiges-Coronavirus-(2019-nCov).html,101246769,95099149,0,0,0.07911902576948833,0,0,103954415,92391503
Austria,2022-09-24,196345918,196345918,0,https://www.sozialministerium.at/Informationen-zum-Coronavirus/Neuartiges-Coronavirus-(2019-nCov).html,101246769,95099149,0,0,0.07911902576948833,0,0,103954415,92391503
Austria,2022-09-25,196345918,196345918,0,https://www.sozialministerium.at/Informationen-zum-Coronavirus/Neuartiges-Coronavirus-(2019-nCov).html,101246769,95099149,0,0,0.07911902576948833,0,0,103954415,92391503
Austria,2022-09-26,196345918,196345918,0,https://www.sozialministerium.at/Informationen-zum-Coronavirus/Neuartiges-Coronavirus-(2019-nCov).html,101246769,95099149,0,0,0.07911902576948833,0,0,103954415,92391503
Austria,2022-09-27,196345918,196345918,0,https://www.sozialministerium.at/Informationen-zum-Coronavirus/Neuartiges-Coronavirus-(2019-nCov).html,101246769,95099149,0,0,0.07911902576948833,0,0,103954415,92391503
Austria,2022-09-28,196345918,196345918,0,https://www.sozialministerium.at/Informationen-zum-Coronavirus/Neuartiges-Coronavirus-(2019-nCov).html,101246769,95099149,0,0,0.07911902576948833,0,0,103954415,92391503
Austria,2022-09-29,196345918,196345918,0,https://www.sozialministerium.at/Informationen-zum-Coronavirus/Neuartiges-Coronavirus-(2019-nCov).html,101246769,95099149,0,0,0.07911902576948833,0,0,103954415,92391503
Austria,2022-09-30,196345918,196345918,0,https://www.sozialministerium.at/Informationen-zum-Coronavirus/Neuartiges-Coronavirus-(2019-nCov).html,101246769,95099149,0,0,0.07911902576948833,0,0,103954415,92391503
Austria,2022-10-01,196345918,196345918,0,https://www.sozialministerium.at/Informationen-zum-Coronavirus/Neuartiges-Coronavirus-(2019-nCov).html,101246769,95099149,0,0,0.07911902576948833,0,0,103954415,92391503
Austria,2022-10-02,196345918,196345918,0,https://www.sozialministerium.at/Informationen-zum-Coronavirus/Neuartiges-Coronavirus-(2019-nCov).html,101246769,95099149,0,0,0.07911902576948833,0,0,103954415,92391503
Austria,2022-10-03,196345918,196345918,0,https://www.sozialministerium.at/Informationen-zum-Coronavirus/Neuartiges-Coronavirus-(2019-nCov).html,101246769,95099149,0,0,0.07911902576948833,0,0,103954415,92391503
Austria,2022-10-04,196345918,196345918,0,https://www.sozialministerium.at/Informationen-zum-Coronavirus/Neuartiges-Coronavirus-(2019-nCov).html,101246769,95099149,0,0,0.07911902576948833,0,0,103954415,92391503
Austria,2022-10-05,196345918,196345918,0,https://www.sozialministerium.at/Informationen-zum-Coronavirus/Neuartiges-Coronavirus-(2019-nCov).html,101246769,95099149,0,0,0.07911902576948833,0,0,103954415,92391503
Austria,2022-10-06,196345918,196345918,0,https://www.sozialministerium.at/Informationen-zum-Coronavirus/Neuartiges-Coronavirus-(2019-nCov).html,101246769,95099149,0,0,0.07911902576948833,0,0,103954415,92391503
Austria,2022-10-07,196345918,196345918,0,https://www.sozialministerium.at/Informationen-zum-Coronavirus/Neuartiges-Coronavirus-(2019-nCov).html,101246769,95099149,0,0,0.07911902576948833,0,0,103954415,92391503
Austria,2022-10-08,196345918,196345918,0,https://www.sozialministerium.at/Informationen-zum-Coronavirus/Neuartiges-Coronavirus-(2019-nCov).html,101246769,95099149,0,0,0.07911902576948833,0,0,103954415,92391503
Austria,2022-10-09,198389049,198389049,2043131,https://www.sozialministerium.at/Informationen-zum-Coronavirus/Neuartiges-Coronavirus-(2019-nCov).html,101246769,95099149,0,0,0.07911902576948833,1881480,161651,105835895,92553154
Austria,2022-10-10,198389049,198389049,0,https://www.sozialministerium.at/Informationen-zum-Coronavirus/Neuartiges-Coronavirus-(2019-nCov).html,101246769,95099149,0,0,0.07911902576948833,0,0,105835895,92553154
Austria,2022-10-11,198389049,198389049,0,https://www.sozialministerium.at/Informationen-zum-Coronavirus/Neuartiges-Coronavirus-(2019-nCov).html,101246769,95099149,0,0,0.07911902576948833,0,0,105835895,92553154
Austria,2022-10-12,198874675,198874675,485626,https://www.sozialministerium.at/Informationen-zum-Coronavirus/Neuartiges-Coronavirus-(2019-nCov).html,101246769,95099149,0,0,0.07911902576948833,447204,38422,106283099,92591576
Austria,2022-10-13,198874675,198874675,0,https://www.sozialministerium.at/Informationen-zum-Coronavirus/Neuartiges-Coronavirus-(2019-nCov).html,101246769,95099149,0,0,0.07911902576948833,0,0,106283099,92591576
Austria,2022-10-14,198874675,198874675,0,https://www.sozialministerium.at/Informationen-zum-Coronavirus/Neuartiges-Coronavirus-(2019-nCov).html,101246769,95099149,0,0,0.07911902576948833,0,0,106283099,92591576
Austria,2022-10-15,198874675,198874675,0,https://www.sozialministerium.at/Informationen-zum-Coronavirus/Neuartiges-Coronavirus-(2019-nCov).html,101246769,95099149,0,0,0.07911902576948833,0,0,106283099,92591576
Austria,2022-10-16,198972158,198972158,97483,https://www.sozialministerium.at/Informationen-zum-Coronavirus/Neuartiges-Coronavirus-(2019-nCov).html,101246769,95099149,0,0,0.07911902576948833,89770,7713,106372869,92599289
Austria,2022-10-17,199185495,199185495,213337,https://www.sozialministerium.at/Informationen-zum-Coronavirus/Neuartiges-Coronavirus-(2019-nCov).html,101246769,95099149,0,0,0.07911902576948833,196458,16879,106569327,92616168
Austria,2022-10-18,199308530,199308530,123035,https://www.sozialministerium.at/Informationen-zum-Coronavirus/Neuartiges-Coronavirus-(2019-nCov).html,101246769,95099149,0,0,0.07911902576948833,113301,9734,106682628,92625902
Austria,2022-10-19,199308530,199308530,0,https://www.sozialministerium.at/Informationen-zum-Coronavirus/Neuartiges-Coronavirus-(2019-nCov).html,101246769,95099149,0,0,0.07911902576948833,0,0,106682628,92625902
Austria,2022-10-20,199540284,199540284,231754,https://www.sozialministerium.at/Informationen-zum-Coronavirus/Neuartiges-Coronavirus-(2019-nCov).html,101246769,95099149,0,0,0.07911902576948833,213418,18336,106896046,92644238
Austria,2022-10-21,199540284,199540284,0,https://www.sozialministerium.at/Informationen-zum-Coronavirus/Neuartiges-Coronavirus-(2019-nCov).html,101246769,95099149,0,0,0.07911902576948833,0,0,106896046,92644238
Austria,2022-10-22,199540284,199540284,0,https://www.sozialministerium.at/Informationen-zum-Coronavirus/Neuartiges-Coronavirus-(2019-nCov).html,101246769,95099149,0,0,0.07911902576948833,0,0,106896046,92644238
Austria,2022-10-23,199625374,199625374,85090,https://www.sozialministerium.at/Informationen-zum-Coronavirus/Neuartiges-Coronavirus-(2019-nCov).html,101246769,95099149,0,0,0.07911902576948833,78358,6732,106974404,92650970
Austria,2022-10-24,199625374,199625374,0,https://www.sozialministerium.at/Informationen-zum-Coronavirus/Neuartiges-Coronavirus-(2019-nCov).html,101246769,95099149,0,0,0.07911902576948833,0,0,106974404,92650970
Austria,2022-10-25,199798293,199798293,172919,https://www.sozialministerium.at/Informationen-zum-Coronavirus/Neuartiges-Coronavirus-(2019-nCov).html,101246769,95099149,0,0,0.07911902576948833,159238,13681,107133642,92664651
Austria,2022-10-26,199898283,199898283,99990,https://www.sozialministerium.at/Informationen-zum-Coronavirus/Neuartiges-Coronavirus-(2019-nCov).html,101246769,95099149,0,0,0.07911902576948833,92079,7911,107225721,92672562
Austria,2022-10-27,199898283,199898283,0,https://www.sozialministerium.at/Informationen-zum-Coronavirus/Neuartiges-Coronavirus-(2019-nCov).html,101246769,95099149,0,0,0.07911902576948833,0,0,107225721,92672562
Austria,2022-10-28,200068069,200068069,169786,https://www.sozialministerium.at/Informationen-zum-Coronavirus/Neuartiges-Coronavirus-(2019-nCov).html,101246769,95099149,0,0,0.07911902576948833,156353,13433,107382074,92685995
Austria,2022-10-29,200127858,200127858,59789,https://www.sozialministerium.at/Informationen-zum-Coronavirus/Neuartiges-Coronavirus-(2019-nCov).html,101246769,95099149,0,0,0.07911902576948833,55059,4730,107437133,92690725
Austria,2022-10-30,200127858,200127858,0,https://www.sozialministerium.at/Informationen-zum-Coronavirus/Neuartiges-Coronavirus-(2019-nCov).html,101246769,95099149,0,0,0.07911902576948833,0,0,107437133,92690725
Austria,2022-10-31,200127858,200127858,0,https://www.sozialministerium.at/Informationen-zum-Coronavirus/Neuartiges-Coronavirus-(2019-nCov).html,101246769,95099149,0,0,0.07911902576948833,0,0,107437133,92690725
Austria,2022-11-01,200256001,200256001,128143,https://www.sozialministerium.at/Informationen-zum-Coronavirus/Neuartiges-Coronavirus-(2019-nCov).html,101246769,95099149,0,0,0.07911902576948833,118004,10139,107555137,92700864
Austria,2022-11-02,200256001,200256001,0,https://www.sozialministerium.at/Informationen-zum-Coronavirus/Neuartiges-Coronavirus-(2019-nCov).html,101246769,95099149,0,0,0.07911902576948833,0,0,107555137,92700864
Austria,2022-11-03,200404032,200404032,148031,https://www.sozialministerium.at/Informationen-zum-Coronavirus/Neuartiges-Coronavirus-(2019-nCov).html,101246769,95099149,0,0,0.07911902576948833,136319,11712,107691456,92712576
Austria,2022-11-04,200504558,200504558,100526,https://www.sozialministerium.at/Informationen-zum-Coronavirus/Neuartiges-Coronavirus-(2019-nCov).html,101246769,95099149,0,0,0.07911902576948833,92572,7954,107784028,92720530
Austria,2022-11-05,200577983,200577983,73425,https://www.sozialministerium.at/Informationen-zum-Coronavirus/Neuartiges-Coronavirus-(2019-nCov).html,101246769,95099149,0,0,0.07911902576948833,67616,5809,107851644,92726339
Austria,2022-11-06,200577983,200577983,0,https://www.sozialministerium.at/Informationen-zum-Coronavirus/Neuartiges-Coronavirus-(2019-nCov).html,101246769,95099149,0,0,0.07911902576948833,0,0,107851644,92726339
Austria,2022-11-07,200577983,200577983,0,https://www.sozialministerium.at/Informationen-zum-Coronavirus/Neuartiges-Coronavirus-(2019-nCov).html,101246769,95099149,0,0,0.07911902576948833,0,0,107851644,92726339
Austria,2022-11-08,200720764,200720764,142781,https://www.sozialministerium.at/Informationen-zum-Coronavirus/Neuartiges-Coronavirus-(2019-nCov).html,101246769,95099149,0,0,0.07911902576948833,131484,11297,107983128,92737636
Austria,2022-11-09,200816178,200816178,95414,https://www.sozialministerium.at/Informationen-zum-Coronavirus/Neuartiges-Coronavirus-(2019-nCov).html,101246769,95099149,0,0,0.07911902576948833,87865,7549,108070993,92745185
Austria,2022-11-10,200911007,200911007,94829,https://www.sozialministerium.at/Informationen-zum-Coronavirus/Neuartiges-Coronavirus-(2019-nCov).html,101246769,95099149,0,0,0.07911902576948833,87326,7503,108158319,92752688
Austria,2022-11-11,201543033,201543033,632026,https://www.sozialministerium.at/Informationen-zum-Coronavirus/Neuartiges-Coronavirus-(2019-nCov).html,101246769,95099149,0,0,0.07911902576948833,582021,50005,108740340,92802693
Austria,2022-11-12,201608119,201608119,65086,https://www.sozialministerium.at/Informationen-zum-Coronavirus/Neuartiges-Coronavirus-(2019-nCov).html,101246769,95099149,0,0,0.07911902576948833,59936,5150,108800276,92807843
Austria,2022-11-13,201608119,201608119,0,https://www.sozialministerium.at/Informationen-zum-Coronavirus/Neuartiges-Coronavirus-(2019-nCov).html,101246769,95099149,0,0,0.07911902576948833,0,0,108800276,92807843
Austria,2022-11-14,201608119,201608119,0,https://www.sozialministerium.at/Informationen-zum-Coronavirus/Neuartiges-Coronavirus-(2019-nCov).html,101246769,95099149,0,0,0.07911902576948833,0,0,108800276,92807843
Austria,2022-11-15,201608119,201608119,0,https://www.sozialministerium.at/Informationen-zum-Coronavirus/Neuartiges-Coronavirus-(2019-nCov).html,101246769,95099149,0,0,0.07911902576948833,0,0,108800276,92807843
Austria,2022-11-16,201837671,201837671,229552,https://www.sozialministerium.at/Informationen-zum-Coronavirus/Neuartiges-Coronavirus-(2019-nCov).html,101246769,95099149,0,0,0.07911902576948833,211390,18162,109011666,92826005
Austria,2022-11-17,201918373,201918373,80702,https://www.sozialministerium.at/Informationen-zum-Coronavirus/Neuartiges-Coronavirus-(2019-nCov).html,101246769,95099149,0,0,0.07911902576948833,74317,6385,109085983,92832390
Austria,2022-11-18,202022479,202022479,104106,https://www.sozialministerium.at/Informationen-zum-Coronavirus/Neuartiges-Coronavirus-(2019-nCov).html,101246769,95099149,0,0,0.07911902576948833,95869,8237,109181852,92840627
Austria,2022-11-19,202088800,202088800,66321,https://www.sozialministerium.at/Informationen-zum-Coronavirus/Neuartiges-Coronavirus-(2019-nCov).html,101246769,95099149,0,0,0.07911902576948833,61074,5247,109242926,92845874
Austria,2022-11-20,202088800,202088800,0,https://www.sozialministerium.at/Informationen-zum-Coronavirus/Neuartiges-Coronavirus-(2019-nCov).html,101246769,95099149,0,0,0.07911902576948833,0,0,109242926,92845874
Austria,2022-11-21,202088800,202088800,0,https://www.sozialministerium.at/Informationen-zum-Coronavirus/Neuartiges-Coronavirus-(2019-nCov).html,101246769,95099149,0,0,0.07911902576948833,0,0,109242926,92845874
Austria,2022-11-22,202229557,202229557,140757,https://www.sozialministerium.at/Informationen-zum-Coronavirus/Neuartiges-Coronavirus-(2019-nCov).html,101246769,95099149,0,0,0.07911902576948833,129620,11137,109372546,92857011
Austria,2022-11-23,202314361,202314361,84804,https://www.sozialministerium.at/Informationen-zum-Coronavirus/Neuartiges-Coronavirus-(2019-nCov).html,101246769,95099149,0,0,0.07911902576948833,78094,6710,109450640,92863721
Austria,2022-11-24,202409994,202409994,95633,https://www.sozialministerium.at/Informationen-zum-Coronavirus/Neuartiges-Coronavirus-(2019-nCov).html,101246769,95099149,0,0,0.07911902576948833,88067,7566,109538707,92871287
Austria,2022-11-25,202505081,202505081,95087,https://www.sozialministerium.at/Informationen-zum-Coronavirus/Neuartiges-Coronavirus-(2019-nCov).html,101246769,95099149,0,0,0.07911902576948833,87564,7523,109626271,92878810
Austria,2022-11-26,202576566,202576566,71485,https://www.sozialministerium.at/Informationen-zum-Coronavirus/Neuartiges-Coronavirus-(2019-nCov).html,101246769,95099149,0,0,0.07911902576948833,65829,5656,109692100,92884466
Austria,2022-11-27,202576566,202576566,0,https://www.sozialministerium.at/Informationen-zum-Coronavirus/Neuartiges-Coronavirus-(2019-nCov).html,101246769,95099149,0,0,0.07911902576948833,0,0,109692100,92884466
Austria,2022-11-28,202576566,202576566,0,https://www.sozialministerium.at/Informationen-zum-Coronavirus/Neuartiges-Coronavirus-(2019-nCov).html,101246769,95099149,0,0,0.07911902576948833,0,0,109692100,92884466
Austria,2022-11-29,202723557,202723557,146991,https://www.sozialministerium.at/Informationen-zum-Coronavirus/Neuartiges-Coronavirus-(2019-nCov).html,101246769,95099149,0,0,0.07911902576948833,135361,11630,109827461,92896096
Austria,2022-11-30,202723557,202723557,0,https://www.sozialministerium.at/Informationen-zum-Coronavirus/Neuartiges-Coronavirus-(2019-nCov).html,101246769,95099149,0,0,0.07911902576948833,0,0,109827461,92896096
Austria,2022-12-01,202723557,202723557,0,https://www.sozialministerium.at/Informationen-zum-Coronavirus/Neuartiges-Coronavirus-(2019-nCov).html,101246769,95099149,0,0,0.07911902576948833,0,0,109827461,92896096
Austria,2022-12-02,202723557,202723557,0,https://www.sozialministerium.at/Informationen-zum-Coronavirus/Neuartiges-Coronavirus-(2019-nCov).html,101246769,95099149,0,0,0.07911902576948833,0,0,109827461,92896096
Austria,2022-12-03,202791504,202791504,67947,https://www.sozialministerium.at/Informationen-zum-Coronavirus/Neuartiges-Coronavirus-(2019-nCov).html,101246769,95099149,0,0,0.07911902576948833,62571,5376,109890032,92901472
Austria,2022-12-04,202791504,202791504,0,https://www.sozialministerium.at/Informationen-zum-Coronavirus/Neuartiges-Coronavirus-(2019-nCov).html,101246769,95099149,0,0,0.07911902576948833,0,0,109890032,92901472
Austria,2022-12-05,202791504,202791504,0,https://www.sozialministerium.at/Informationen-zum-Coronavirus/Neuartiges-Coronavirus-(2019-nCov).html,101246769,95099149,0,0,0.07911902576948833,0,0,109890032,92901472
Austria,2022-12-06,202928484,202928484,136980,https://www.sozialministerium.at/Informationen-zum-Coronavirus/Neuartiges-Coronavirus-(2019-nCov).html,101246769,95099149,0,0,0.07911902576948833,126142,10838,110016174,92912310
Austria,2022-12-07,203060135,203060135,131651,https://www.sozialministerium.at/Informationen-zum-Coronavirus/Neuartiges-Coronavirus-(2019-nCov).html,101246769,95099149,0,0,0.07911902576948833,121235,10416,110137409,92922726
Austria,2022-12-08,203156436,203156436,96301,https://www.sozialministerium.at/Informationen-zum-Coronavirus/Neuartiges-Coronavirus-(2019-nCov).html,101246769,95099149,0,0,0.07911902576948833,88682,7619,110226091,92930345
Austria,2022-12-09,203156436,203156436,0,https://www.sozialministerium.at/Informationen-zum-Coronavirus/Neuartiges-Coronavirus-(2019-nCov).html,101246769,95099149,0,0,0.07911902576948833,0,0,110226091,92930345
Austria,2022-12-10,203290090,203290090,133654,https://www.sozialministerium.at/Informationen-zum-Coronavirus/Neuartiges-Coronavirus-(2019-nCov).html,101246769,95099149,0,0,0.07911902576948833,123079,10575,110349170,92940920
Austria,2022-12-11,203290090,203290090,0,https://www.sozialministerium.at/Informationen-zum-Coronavirus/Neuartiges-Coronavirus-(2019-nCov).html,101246769,95099149,0,0,0.07911902576948833,0,0,110349170,92940920
Austria,2022-12-12,203290090,203290090,0,https://www.sozialministerium.at/Informationen-zum-Coronavirus/Neuartiges-Coronavirus-(2019-nCov).html,101246769,95099149,0,0,0.07911902576948833,0,0,110349170,92940920
Austria,2022-12-13,203440675,203440675,150585,https://www.sozialministerium.at/Informationen-zum-Coronavirus/Neuartiges-Coronavirus-(2019-nCov).html,101246769,95099149,0,0,0.07911902576948833,138671,11914,110487841,92952834
Austria,2022-12-14,203540037,203540037,99362,https://www.sozialministerium.at/Informationen-zum-Coronavirus/Neuartiges-Coronavirus-(2019-nCov).html,101246769,95099149,0,0,0.07911902576948833,91501,7861,110579342,92960695
Austria,2022-12-15,203650358,203650358,110321,https://www.sozialministerium.at/Informationen-zum-Coronavirus/Neuartiges-Coronavirus-(2019-nCov).html,101246769,95099149,0,0,0.07911902576948833,101593,8728,110680935,92969423
Austria,2022-12-16,203650358,203650358,0,https://www.sozialministerium.at/Informationen-zum-Coronavirus/Neuartiges-Coronavirus-(2019-nCov).html,101246769,95099149,0,0,0.07911902576948833,0,0,110680935,92969423
Austria,2022-12-17,203807198,203807198,156840,https://www.sozialministerium.at/Informationen-zum-Coronavirus/Neuartiges-Coronavirus-(2019-nCov).html,101246769,95099149,0,0,0.07911902576948833,144431,12409,110825366,92981832
Austria,2022-12-18,203807198,203807198,0,https://www.sozialministerium.at/Informationen-zum-Coronavirus/Neuartiges-Coronavirus-(2019-nCov).html,101246769,95099149,0,0,0.07911902576948833,0,0,110825366,92981832
Austria,2022-12-19,203807198,203807198,0,https://www.sozialministerium.at/Informationen-zum-Coronavirus/Neuartiges-Coronavirus-(2019-nCov).html,101246769,95099149,0,0,0.07911902576948833,0,0,110825366,92981832
Austria,2022-12-20,203952675,203952675,145477,https://www.sozialministerium.at/Informationen-zum-Coronavirus/Neuartiges-Coronavirus-(2019-nCov).html,101246769,95099149,0,0,0.07911902576948833,133967,11510,110959333,92993342
Austria,2022-12-21,203952675,203952675,0,https://www.sozialministerium.at/Informationen-zum-Coronavirus/Neuartiges-Coronavirus-(2019-nCov).html,101246769,95099149,0,0,0.07911902576948833,0,0,110959333,92993342
Austria,2022-12-22,204039989,204039989,87314,https://www.sozialministerium.at/Informationen-zum-Coronavirus/Neuartiges-Coronavirus-(2019-nCov).html,101246769,95099149,0,0,0.07911902576948833,80406,6908,111039739,93000250
Austria,2022-12-23,204188813,204188813,148824,https://www.sozialministerium.at/Informationen-zum-Coronavirus/Neuartiges-Coronavirus-(2019-nCov).html,101246769,95099149,0,0,0.07911902576948833,137049,11775,111176788,93012025
Austria,2022-12-24,204188813,204188813,0,https://www.sozialministerium.at/Informationen-zum-Coronavirus/Neuartiges-Coronavirus-(2019-nCov).html,101246769,95099149,0,0,0.07911902576948833,0,0,111176788,93012025
Austria,2022-12-25,204241209,204241209,52396,https://www.sozialministerium.at/Informationen-zum-Coronavirus/Neuartiges-Coronavirus-(2019-nCov).html,101246769,95099149,0,0,0.07911902576948833,48250,4146,111225038,93016171
Austria,2022-12-26,204241209,204241209,0,https://www.sozialministerium.at/Informationen-zum-Coronavirus/Neuartiges-Coronavirus-(2019-nCov).html,101246769,95099149,0,0,0.07911902576948833,0,0,111225038,93016171
Austria,2022-12-27,204241209,204241209,0,https://www.sozialministerium.at/Informationen-zum-Coronavirus/Neuartiges-Coronavirus-(2019-nCov).html,101246769,95099149,0,0,0.07911902576948833,0,0,111225038,93016171
Austria,2022-12-28,204391491,204391491,150282,https://www.sozialministerium.at/Informationen-zum-Coronavirus/Neuartiges-Coronavirus-(2019-nCov).html,101246769,95099149,0,0,0.07911902576948833,138392,11890,111363430,93028061
Austria,2022-12-29,204456791,204456791,65300,https://www.sozialministerium.at/Informationen-zum-Coronavirus/Neuartiges-Coronavirus-(2019-nCov).html,101246769,95099149,0,0,0.07911902576948833,60134,5166,111423564,93033227
Austria,2022-12-30,204481907,204481907,25116,https://www.sozialministerium.at/Informationen-zum-Coronavirus/Neuartiges-Coronavirus-(2019-nCov).html,101246769,95099149,0,0,0.07911902576948833,23129,1987,111446693,93035214
Austria,2022-12-31,204546961,204546961,65054,https://www.sozialministerium.at/Informationen-zum-Coronavirus/Neuartiges-Coronavirus-(2019-nCov).html,101246769,95099149,0,0,0.07911902576948833,59907,5147,111506600,93040361
Austria,2023-01-01,204546961,204546961,0,https://www.sozialministerium.at/Informationen-zum-Coronavirus/Neuartiges-Coronavirus-(2019-nCov).html,101246769,95099149,0,0,0.07911902576948833,0,0,111506600,93040361
Austria,2023-01-02,204546961,204546961,0,https://www.sozialministerium.at/Informationen-zum-Coronavirus/Neuartiges-Coronavirus-(2019-nCov).html,101246769,95099149,0,0,0.07911902576948833,0,0,111506600,93040361
Austria,2023-01-03,204628586,204628586,81625,https://www.sozialministerium.at/Informationen-zum-Coronavirus/Neuartiges-Coronavirus-(2019-nCov).html,101246769,95099149,0,0,0.07911902576948833,75167,6458,111581767,93046819
Austria,2023-01-04,204676026,204676026,47440,https://www.sozialministerium.at/Informationen-zum-Coronavirus/Neuartiges-Coronavirus-(2019-nCov).html,101246769,95099149,0,0,0.07911902576948833,43687,3753,111625454,93050572
Austria,2023-01-05,204725396,204725396,49370,https://www.sozialministerium.at/Informationen-zum-Coronavirus/Neuartiges-Coronavirus-(2019-nCov).html,101246769,95099149,0,0,0.07911902576948833,45464,3906,111670918,93054478
Austria,2023-01-06,204767733,204767733,42337,https://www.sozialministerium.at/Informationen-zum-Coronavirus/Neuartiges-Coronavirus-(2019-nCov).html,101246769,95099149,0,0,0.07911902576948833,38987,3350,111709905,93057828
Austria,2023-01-07,204767733,204767733,0,https://www.sozialministerium.at/Informationen-zum-Coronavirus/Neuartiges-Coronavirus-(2019-nCov).html,101246769,95099149,0,0,0.07911902576948833,0,0,111709905,93057828
Austria,2023-01-08,204767733,204767733,0,https://www.sozialministerium.at/Informationen-zum-Coronavirus/Neuartiges-Coronavirus-(2019-nCov).html,101246769,95099149,0,0,0.07911902576948833,0,0,111709905,93057828
Austria,2023-01-09,204767733,204767733,0,https://www.sozialministerium.at/Informationen-zum-Coronavirus/Neuartiges-Coronavirus-(2019-nCov).html,101246769,95099149,0,0,0.07911902576948833,0,0,111709905,93057828
Austria,2023-01-10,204891207,204891207,123474,https://www.sozialministerium.at/Informationen-zum-Coronavirus/Neuartiges-Coronavirus-(2019-nCov).html,101246769,95099149,0,0,0.07911902576948833,113705,9769,111823610,93067597
Austria,2023-01-11,204959003,204959003,67796,https://www.sozialministerium.at/Informationen-zum-Coronavirus/Neuartiges-Coronavirus-(2019-nCov).html,101246769,95099149,0,0,0.07911902576948833,62432,5364,111886042,93072961
Austria,2023-01-12,205012497,205012497,53494,https://www.sozialministerium.at/Informationen-zum-Coronavirus/Neuartiges-Coronavirus-(2019-nCov).html,101246769,95099149,0,0,0.07911902576948833,49262,4232,111935304,93077193
Austria,2023-01-13,205084197,205084197,71700,https://www.sozialministerium.at/Informationen-zum-Coronavirus/Neuartiges-Coronavirus-(2019-nCov).html,101246769,95099149,0,0,0.07911902576948833,66027,5673,112001331,93082866
Austria,2023-01-14,205094777,205094777,10580,https://www.sozialministerium.at/Informationen-zum-Coronavirus/Neuartiges-Coronavirus-(2019-nCov).html,101246769,95099149,0,0,0.07911902576948833,9743,837,112011074,93083703
Austria,2023-01-15,205094777,205094777,0,https://www.sozialministerium.at/Informationen-zum-Coronavirus/Neuartiges-Coronavirus-(2019-nCov).html,101246769,95099149,0,0,0.07911902576948833,0,0,112011074,93083703
Austria,2023-01-16,205094777,205094777,0,https://www.sozialministerium.at/Informationen-zum-Coronavirus/Neuartiges-Coronavirus-(2019-nCov).html,101246769,95099149,0,0,0.07911902576948833,0,0,112011074,93083703
Austria,2023-01-17,205209662,205209662,114885,https://www.sozialministerium.at/Informationen-zum-Coronavirus/Neuartiges-Coronavirus-(2019-nCov).html,101246769,95099149,0,0,0.07911902576948833,105795,9090,112116869,93092793
Austria,2023-01-18,205247898,205247898,38236,https://www.sozialministerium.at/Informationen-zum-Coronavirus/Neuartiges-Coronavirus-(2019-nCov).html,101246769,95099149,0,0,0.07911902576948833,35211,3025,112152080,93095818
Austria,2023-01-19,205307182,205307182,59284,https://www.sozialministerium.at/Informationen-zum-Coronavirus/Neuartiges-Coronavirus-(2019-nCov).html,101246769,95099149,0,0,0.07911902576948833,54594,4690,112206674,93100508
Austria,2023-01-20,205355230,205355230,48048,https://www.sozialministerium.at/Informationen-zum-Coronavirus/Neuartiges-Coronavirus-(2019-nCov).html,101246769,95099149,0,0,0.07911902576948833,44246,3802,112250920,93104310
Austria,2023-01-21,205391270,205391270,36040,https://www.sozialministerium.at/Informationen-zum-Coronavirus/Neuartiges-Coronavirus-(2019-nCov).html,101246769,95099149,0,0,0.07911902576948833,33189,2851,112284109,93107161
Austria,2023-01-22,205391270,205391270,0,https://www.sozialministerium.at/Informationen-zum-Coronavirus/Neuartiges-Coronavirus-(2019-nCov).html,101246769,95099149,0,0,0.07911902576948833,0,0,112284109,93107161
Austria,2023-01-23,205391270,205391270,0,https://www.sozialministerium.at/Informationen-zum-Coronavirus/Neuartiges-Coronavirus-(2019-nCov).html,101246769,95099149,0,0,0.07911902576948833,0,0,112284109,93107161
Austria,2023-01-24,205462812,205462812,71542,https://www.sozialministerium.at/Informationen-zum-Coronavirus/Neuartiges-Coronavirus-(2019-nCov).html,101246769,95099149,0,0,0.07911902576948833,65882,5660,112349991,93112821
Austria,2023-01-25,205510626,205510626,47814,https://www.sozialministerium.at/Informationen-zum-Coronavirus/Neuartiges-Coronavirus-(2019-nCov).html,101246769,95099149,0,0,0.07911902576948833,44031,3783,112394022,93116604
Austria,2023-01-26,205558255,205558255,47629,https://www.sozialministerium.at/Informationen-zum-Coronavirus/Neuartiges-Coronavirus-(2019-nCov).html,101246769,95099149,0,0,0.07911902576948833,43861,3768,112437883,93120372
Austria,2023-01-27,205606966,205606966,48711,https://www.sozialministerium.at/Informationen-zum-Coronavirus/Neuartiges-Coronavirus-(2019-nCov).html,101246769,95099149,0,0,0.07911902576948833,44857,3854,112482740,93124226
Austria,2023-01-28,205640816,205640816,33850,https://www.sozialministerium.at/Informationen-zum-Coronavirus/Neuartiges-Coronavirus-(2019-nCov).html,101246769,95099149,0,0,0.07911902576948833,31172,2678,112513912,93126904
Austria,2023-01-29,205640816,205640816,0,https://www.sozialministerium.at/Informationen-zum-Coronavirus/Neuartiges-Coronavirus-(2019-nCov).html,101246769,95099149,0,0,0.07911902576948833,0,0,112513912,93126904
Austria,2023-01-30,205640816,205640816,0,https://www.sozialministerium.at/Informationen-zum-Coronavirus/Neuartiges-Coronavirus-(2019-nCov).html,101246769,95099149,0,0,0.07911902576948833,0,0,112513912,93126904
Austria,2023-01-31,205718597,205718597,77781,https://www.sozialministerium.at/Informationen-zum-Coronavirus/Neuartiges-Coronavirus-(2019-nCov).html,101246769,95099149,0,0,0.07911902576948833,71627,6154,112585539,93133058
Austria,2023-02-01,205767065,205767065,48468,https://www.sozialministerium.at/Informationen-zum-Coronavirus/Neuartiges-Coronavirus-(2019-nCov).html,101246769,95099149,0,0,0.07911902576948833,44633,3835,112630172,93136893
Austria,2023-02-02,205817752,205817752,50687,https://www.sozialministerium.at/Informationen-zum-Coronavirus/Neuartiges-Coronavirus-(2019-nCov).html,101246769,95099149,0,0,0.07911902576948833,46677,4010,112676849,93140903
Austria,2023-02-03,205860000,205860000,42248,https://www.sozialministerium.at/Informationen-zum-Coronavirus/Neuartiges-Coronavirus-(2019-nCov).html,101246769,95099149,0,0,0.07911902576948833,38905,3343,112715754,93144246
Austria,2023-02-04,205911184,205911184,51184,https://www.sozialministerium.at/Informationen-zum-Coronavirus/Neuartiges-Coronavirus-(2019-nCov).html,101246769,95099149,0,0,0.07911902576948833,47134,4050,112762888,93148296
Austria,2023-02-05,205911184,205911184,0,https://www.sozialministerium.at/Informationen-zum-Coronavirus/Neuartiges-Coronavirus-(2019-nCov).html,101246769,95099149,0,0,0.07911902576948833,0,0,112762888,93148296
Austria,2023-02-06,205911184,205911184,0,https://www.sozialministerium.at/Informationen-zum-Coronavirus/Neuartiges-Coronavirus-(2019-nCov).html,101246769,95099149,0,0,0.07911902576948833,0,0,112762888,93148296
Austria,2023-02-07,205985606,205985606,74422,https://www.sozialministerium.at/Informationen-zum-Coronavirus/Neuartiges-Coronavirus-(2019-nCov).html,101246769,95099149,0,0,0.07911902576948833,68534,5888,112831422,93154184
Austria,2023-02-08,206027727,206027727,42121,https://www.sozialministerium.at/Informationen-zum-Coronavirus/Neuartiges-Coronavirus-(2019-nCov).html,101246769,95099149,0,0,0.07911902576948833,38788,3333,112870210,93157517
Austria,2023-02-09,206071393,206071393,43666,https://www.sozialministerium.at/Informationen-zum-Coronavirus/Neuartiges-Coronavirus-(2019-nCov).html,101246769,95099149,0,0,0.07911902576948833,40211,3455,112910421,93160972
Austria,2023-02-10,206222803,206222803,151410,https://www.sozialministerium.at/Informationen-zum-Coronavirus/Neuartiges-Coronavirus-(2019-nCov).html,101246769,95099149,0,0,0.07911902576948833,139431,11979,113049852,93172951
Austria,2023-02-11,206263759,206263759,40956,https://www.sozialministerium.at/Informationen-zum-Coronavirus/Neuartiges-Coronavirus-(2019-nCov).html,101246769,95099149,0,0,0.07911902576948833,37716,3240,113087568,93176191
Austria,2023-02-12,206263759,206263759,0,https://www.sozialministerium.at/Informationen-zum-Coronavirus/Neuartiges-Coronavirus-(2019-nCov).html,101246769,95099149,0,0,0.07911902576948833,0,0,113087568,93176191
Austria,2023-02-13,206263759,206263759,0,https://www.sozialministerium.at/Informationen-zum-Coronavirus/Neuartiges-Coronavirus-(2019-nCov).html,101246769,95099149,0,0,0.07911902576948833,0,0,113087568,93176191
Austria,2023-02-14,206339712,206339712,75953,https://www.sozialministerium.at/Informationen-zum-Coronavirus/Neuartiges-Coronavirus-(2019-nCov).html,101246769,95099149,0,0,0.07911902576948833,69944,6009,113157512,93182200
Colombia,2021-06-08,17625675,17625675,124171,https://infogram.com/panorama-general-1h7z2lgn3l9l4ow?live,11976902,5648773,196867,123640,0.3857638054707073,76270,47901,11976902,5648773
Colombia,2021-06-09,17799489,17799489,173814,https://infogram.com/panorama-general-1h7z2lgn3l9l4ow?live,11976902,5648773,0,0,0.3857638054707073,106763,67051,12083665,5715824
Colombia,2021-06-10,17799489,17799489,0,https://infogram.com/panorama-general-1h7z2lgn3l9l4ow?live,11976902,5648773,0,0,0.3857638054707073,0,0,12083665,5715824
Colombia,2021-06-11,17799489,17799489,0,https://infogram.com/panorama-general-1h7z2lgn3l9l4ow?live,12133538,5778507,156636,129734,0.45302929776163703,0,0,12083665,5715824
Colombia,2021-06-12,17799489,17799489,0,https://infogram.com/panorama-general-1h7z2lgn3l9l4ow?live,12133538,5778507,0,0,0.45302929776163703,0,0,12083665,5715824
Colombia,2021-06-13,18206556,18206556,407067,https://infogram.com/panorama-general-1h7z2lgn3l9l4ow?live,12237799,5876874,104261,98367,0.48545610675721024,209454,197613,12293119,5913437
Colombia,2021-06-14,18206556,18206556,0,https://infogram.com/panorama-general-1h7z2lgn3l9l4ow?live,12237799,5876874,0,0,0.48545610675721024,0,0,12293119,5913437
Colombia,2021-06-15,18340111,18340111,133555,https://infogram.com/panorama-general-1h7z2lgn3l9l4ow?live,12237799,5876874,0,0,0.48545610675721024,68720,64835,12361839,5978272
Colombia,2021-06-16,18340111,18340111,0,https://infogram.com/panorama-general-1h7z2lgn3l9l4ow?live,12386306,5953805,148507,76931,0.3412512531161561,0,0,12361839,5978272
Colombia,2021-06-17,18451017,18451017,110906,https://infogram.com/panorama-general-1h7z2lgn3l9l4ow?live,12450266,6000751,63960,46946,0.4232954033145186,63960,46946,12425799,6025218
Colombia,2021-06-18,18671429,18671429,220412,https://infogram.com/panorama-general-1h7z2lgn3l9l4ow?live,12450266,6000751,0,0,0.4232954033145186,127113,93299,12552912,6118517
Colombia,2021-06-19,18772724,18772724,101295,https://infogram.com/panorama-general-1h7z2lgn3l9l4ow?live,12450266,6000751,0,0,0.4232954033145186,58417,42878,12611329,6161395
Colombia,2021-06-20,18849191,18849191,76467,https://infogram.com/panorama-general-1h7z2lgn3l9l4ow?live,12450266,6000751,0,0,0.4232954033145186,44099,32368,12655428,6193763
Colombia,2021-06-21,18849191,18849191,0,https://infogram.com/panorama-general-1h7z2lgn3l9l4ow?live,12450266,6000751,0,0,0.4232954033145186,0,0,12655428,6193763
Colombia,2021-06-22,18929047,18929047,79856,https://infogram.com/panorama-general-1h7z2lgn3l9l4ow?live,12710986,6218061,260720,217310,0.45459489990167984,43554,36302,12698982,6230065
Colombia,2021-06-23,19040100,19040100,111053,https://infogram.com/panorama-general-1h7z2lgn3l9l4ow?live,12771176,6268924,60190,50863,0.45800653741907016,60190,50863,12759172,6280928
Colombia,2021-06-24,19168055,19168055,127955,https://infogram.com/panorama-general-1h7z2lgn3l9l4ow?live,12827165,6340890,55989,71966,0.5624321050369271,55989,71966,12815161,6352894
Colombia,2021-06-25,19409243,19409243,241188,https://infogram.com/panorama-general-1h7z2lgn3l9l4ow?live,12827165,6340890,0,0,0.5624321050369271,105536,135652,12920697,6488546
Colombia,2021-06-26,19519944,19519944,110701,https://infogram.com/panorama-general-1h7z2lgn3l9l4ow?live,12827165,6340890,0,0,0.5624321050369271,48439,62262,12969136,6550808
Colombia,2021-06-27,19519944,19519944,0,https://infogram.com/panorama-general-1h7z2lgn3l9l4ow?live,13014457,6505487,187292,164597,0.4677526151712614,0,0,12969136,6550808
Colombia,2021-06-28,19519944,19519944,0,https://infogram.com/panorama-general-1h7z2lgn3l9l4ow?live,13014457,6505487,0,0,0.4677526151712614,0,0,12969136,6550808
Colombia,2021-06-29,19822624,19822624,302680,https://infogram.com/panorama-general-1h7z2lgn3l9l4ow?live,13117346,6578319,102889,72832,0.41447521923959,177227,125453,13146363,6676261
Colombia,2021-06-30,19936910,19936910,114286,https://infogram.com/panorama-general-1h7z2lgn3l9l4ow?live,13182990,6639634,65644,61315,0.48295118896651673,59091,55195,13205454,6731456
Colombia,2021-07-01,20060182,20060182,123272,https://infogram.com/panorama-general-1h7z2lgn3l9l4ow?live,13182990,6639634,0,0,0.48295118896651673,63738,59534,13269192,6790990
Colombia,2021-07-02,20060182,20060182,0,https://infogram.com/panorama-general-1h7z2lgn3l9l4ow?live,13305465,6754717,122475,115083,0.4844416942388806,0,0,13269192,6790990
Colombia,2021-07-03,20060182,20060182,0,https://infogram.com/panorama-general-1h7z2lgn3l9l4ow?live,13305465,6754717,0,0,0.4844416942388806,0,0,13269192,6790990
Colombia,2021-07-04,20384649,20384649,324467,https://infogram.com/panorama-general-1h7z2lgn3l9l4ow?live,13419109,6863034,113644,108317,0.48800014416947124,166127,158340,13435319,6949330
Colombia,2021-07-05,20384649,20384649,0,https://infogram.com/panorama-general-1h7z2lgn3l9l4ow?live,13475059,6909590,55950,46556,0.4541782920024194,0,0,13435319,6949330
Colombia,2021-07-06,20384649,20384649,0,https://infogram.com/panorama-general-1h7z2lgn3l9l4ow?live,13513159,6921960,38100,12370,0.24509609669110363,0,0,13435319,6949330
Colombia,2021-07-07,20384649,20384649,0,https://infogram.com/panorama-general-1h7z2lgn3l9l4ow?live,13513159,6921960,0,0,0.24509609669110363,0,0,13435319,6949330
Colombia,2021-07-08,20384649,20384649,0,https://infogram.com/panorama-general-1h7z2lgn3l9l4ow?live,13513159,6921960,0,0,0.24509609669110363,0,0,13435319,6949330
Colombia,2021-07-09,20384649,20384649,0,https://infogram.com/panorama-general-1h7z2lgn3l9l4ow?live,13668071,7043858,154912,121898,0.44036703876305044,0,0,13435319,6949330
Colombia,2021-07-10,20384649,20384649,0,https://infogram.com/panorama-general-1h7z2lgn3l9l4ow?live,13732835,7095452,64764,51594,0.4434074150466663,0,0,13435319,6949330
Colombia,2021-07-11,20915420,20915420,530771,https://infogram.com/panorama-general-1h7z2lgn3l9l4ow?live,13775442,7139978,42607,44526,0.5110119013462179,259541,271230,13694860,7220560
Colombia,2021-07-12,20915420,20915420,0,https://infogram.com/panorama-general-1h7z2lgn3l9l4ow?live,13775442,7139978,0,0,0.5110119013462179,0,0,13694860,7220560
Colombia,2021-07-13,20915420,20915420,0,https://infogram.com/panorama-general-1h7z2lgn3l9l4ow?live,13869988,7190572,94546,50594,0.34858757062146895,0,0,13694860,7220560
Colombia,2021-07-14,20915420,20915420,0,https://infogram.com/panorama-general-1h7z2lgn3l9l4ow?live,13923043,7233440,53055,42868,0.446900117802821,0,0,13694860,7220560
Colombia,2021-07-15,20915420,20915420,0,https://infogram.com/panorama-general-1h7z2lgn3l9l4ow?live,13969656,7279768,46613,46328,0.4984667692407011,0,0,13694860,7220560
Colombia,2021-07-16,21345447,21345447,430027,https://infogram.com/panorama-general-1h7z2lgn3l9l4ow?live,14020615,7324832,50959,45064,0.4693042291950887,228214,201813,13923074,7422373
Colombia,2021-07-17,21439559,21439559,94112,https://infogram.com/panorama-general-1h7z2lgn3l9l4ow?live,14070940,7368619,50325,43787,0.46526479088745326,50325,43787,13973399,7466160
Colombia,2021-07-18,21532578,21532578,93019,https://infogram.com/panorama-general-1h7z2lgn3l9l4ow?live,14121319,7411259,50379,42640,0.4584009718444619,50379,42640,14023778,7508800
Colombia,2021-07-19,21612085,21612085,79507,https://infogram.com/panorama-general-1h7z2lgn3l9l4ow?live,14169064,7443021,47745,31762,0.39948683763693765,47745,31762,14071523,7540562
Colombia,2021-07-20,21744142,21744142,132057,https://infogram.com/panorama-general-1h7z2lgn3l9l4ow?live,14169064,7443021,0,0,0.39948683763693765,79302,52755,14150825,7593317
Colombia,2021-07-21,21744142,21744142,0,https://infogram.com/panorama-general-1h7z2lgn3l9l4ow?live,14169064,7443021,0,0,0.39948683763693765,0,0,14150825,7593317
Colombia,2021-07-22,21744142,21744142,0,https://infogram.com/panorama-general-1h7z2lgn3l9l4ow?live,14169064,7443021,0,0,0.39948683763693765,0,0,14150825,7593317
Colombia,2021-07-23,21744142,21744142,0,https://infogram.com/panorama-general-1h7z2lgn3l9l4ow?live,14169064,7443021,0,0,0.39948683763693765,0,0,14150825,7593317
Colombia,2021-07-24,21744142,21744142,0,https://infogram.com/panorama-general-1h7z2lgn3l9l4ow?live,14364811,7588536,195747,145515,0.4264025880408601,0,0,14150825,7593317
Colombia,2021-07-25,21744142,21744142,0,https://infogram.com/panorama-general-1h7z2lgn3l9l4ow?live,14364811,7588536,0,0,0.4264025880408601,0,0,14150825,7593317
Colombia,2021-07-26,22098977,22098977,354835,https://infogram.com/panorama-general-1h7z2lgn3l9l4ow?live,14442974,7656003,78163,67467,0.46327679736318067,190448,164387,14341273,7757704
Colombia,2021-07-27,22098977,22098977,0,https://infogram.com/panorama-general-1h7z2lgn3l9l4ow?live,14442974,7656003,0,0,0.46327679736318067,0,0,14341273,7757704
Colombia,2021-07-28,22098977,22098977,0,https://infogram.com/panorama-general-1h7z2lgn3l9l4ow?live,14442974,7656003,0,0,0.46327679736318067,0,0,14341273,7757704
Colombia,2021-07-29,22098977,22098977,0,https://infogram.com/panorama-general-1h7z2lgn3l9l4ow?live,14442974,7656003,0,0,0.46327679736318067,0,0,14341273,7757704
Colombia,2021-07-30,22098977,22098977,0,https://infogram.com/panorama-general-1h7z2lgn3l9l4ow?live,14442974,7656003,0,0,0.46327679736318067,0,0,14341273,7757704
Colombia,2021-07-31,22448016,22448016,349039,https://infogram.com/panorama-general-1h7z2lgn3l9l4ow?live,14625390,7822626,182416,166623,0.4773764536341211,182416,166623,14523689,7924327
Colombia,2021-08-01,22448016,22448016,0,https://infogram.com/panorama-general-1h7z2lgn3l9l4ow?live,14625390,7822626,0,0,0.4773764536341211,0,0,14523689,7924327
Colombia,2021-08-02,22609561,22609561,161545,https://infogram.com/panorama-general-1h7z2lgn3l9l4ow?live,14706998,7902563,81608,79937,0.4948280664830233,81608,79937,14605297,8004264
Colombia,2021-08-03,22609561,22609561,0,https://infogram.com/panorama-general-1h7z2lgn3l9l4ow?live,14706998,7902563,0,0,0.4948280664830233,0,0,14605297,8004264
Colombia,2021-08-04,22609561,22609561,0,https://infogram.com/panorama-general-1h7z2lgn3l9l4ow?live,14706998,7902563,0,0,0.4948280664830233,0,0,14605297,8004264
Colombia,2021-08-05,22609561,22609561,0,https://infogram.com/panorama-general-1h7z2lgn3l9l4ow?live,14706998,7902563,0,0,0.4948280664830233,0,0,14605297,8004264
Colombia,2021-08-06,22837298,22837298,227737,https://infogram.com/panorama-general-1h7z2lgn3l9l4ow?live,14827165,8010133,120167,107570,0.47234309752038534,120167,107570,14725464,8111834
Colombia,2021-08-07,22837298,22837298,0,https://infogram.com/panorama-general-1h7z2lgn3l9l4ow?live,14827165,8010133,0,0,0.47234309752038534,0,0,14725464,8111834
Colombia,2021-08-08,22837298,22837298,0,https://infogram.com/panorama-general-1h7z2lgn3l9l4ow?live,14827165,8010133,0,0,0.47234309752038534,0,0,14725464,8111834
Colombia,2021-08-09,22837298,22837298,0,https://infogram.com/panorama-general-1h7z2lgn3l9l4ow?live,14827165,8010133,0,0,0.47234309752038534,0,0,14725464,8111834
Colombia,2021-08-10,23060033,23060033,222735,https://infogram.com/panorama-general-1h7z2lgn3l9l4ow?live,14950830,8109203,123665,99070,0.4447886501896873,123665,99070,14849129,8210904
Colombia,2021-08-11,23113937,23113937,53904,https://infogram.com/panorama-general-1h7z2lgn3l9l4ow?live,14974564,8139373,23734,30170,0.5596987236568715,23734,30170,14872863,8241074
Colombia,2021-08-12,23172860,23172860,58923,https://infogram.com/panorama-general-1h7z2lgn3l9l4ow?live,15000118,8172742,25554,33369,0.566315360725014,25554,33369,14898417,8274443
Colombia,2021-08-13,23233309,23233309,60449,https://infogram.com/panorama-general-1h7z2lgn3l9l4ow?live,15028139,8205170,28021,32428,0.5364522159175503,28021,32428,14926438,8306871
Colombia,2021-08-14,23233309,23233309,0,https://infogram.com/panorama-general-1h7z2lgn3l9l4ow?live,15028139,8205170,0,0,0.5364522159175503,0,0,14926438,8306871
Colombia,2021-08-15,23233309,23233309,0,https://infogram.com/panorama-general-1h7z2lgn3l9l4ow?live,15028139,8205170,0,0,0.5364522159175503,0,0,14926438,8306871
Colombia,2021-08-16,23233309,23233309,0,https://infogram.com/panorama-general-1h7z2lgn3l9l4ow?live,15028139,8205170,0,0,0.5364522159175503,0,0,14926438,8306871
Colombia,2021-08-17,23479835,23479835,246526,https://infogram.com/panorama-general-1h7z2lgn3l9l4ow?live,15028139,8205170,0,0,0.5364522159175503,114277,132249,15040715,8439120
Colombia,2021-08-18,23530438,23530438,50603,https://infogram.com/panorama-general-1h7z2lgn3l9l4ow?live,15028139,8205170,0,0,0.5364522159175503,23457,27146,15064172,8466266
Colombia,2021-08-19,23587059,23587059,56621,https://infogram.com/panorama-general-1h7z2lgn3l9l4ow?live,15028139,8205170,0,0,0.5364522159175503,26247,30374,15090419,8496640
Colombia,2021-08-20,23647617,23647617,60558,https://infogram.com/panorama-general-1h7z2lgn3l9l4ow?live,15028139,8205170,0,0,0.5364522159175503,28072,32486,15118491,8529126
Colombia,2021-08-21,23701448,23701448,53831,https://infogram.com/panorama-general-1h7z2lgn3l9l4ow?live,15267093,8434355,238954,229185,0.48956613313567127,27477,26354,15145968,8555480
Colombia,2021-08-22,23754923,23754923,53475,https://infogram.com/panorama-general-1h7z2lgn3l9l4ow?live,15296483,8458440,29390,24085,0.4503973819541842,29390,24085,15175358,8579565
Colombia,2021-08-23,23754923,23754923,0,https://infogram.com/panorama-general-1h7z2lgn3l9l4ow?live,15296483,8458440,0,0,0.4503973819541842,0,0,15175358,8579565
Colombia,2021-08-24,23831605,23831605,76682,https://infogram.com/panorama-general-1h7z2lgn3l9l4ow?live,15296483,8458440,0,0,0.4503973819541842,42145,34537,15217503,8614102
Colombia,2021-08-25,23883552,23883552,51947,https://infogram.com/panorama-general-1h7z2lgn3l9l4ow?live,15296483,8458440,0,0,0.4503973819541842,28550,23397,15246053,8637499
Colombia,2021-08-26,23936680,23936680,53128,https://infogram.com/panorama-general-1h7z2lgn3l9l4ow?live,15392191,8544489,95708,86049,0.4734288087941592,27976,25152,15274029,8662651
Colombia,2021-08-27,23936680,23936680,0,https://infogram.com/panorama-general-1h7z2lgn3l9l4ow?live,15392191,8544489,0,0,0.4734288087941592,0,0,15274029,8662651
Colombia,2021-08-28,23936680,23936680,0,https://infogram.com/panorama-general-1h7z2lgn3l9l4ow?live,15421830,8570357,29639,25868,0.466031311366134,0,0,15274029,8662651
Colombia,2021-08-29,24043550,24043550,106870,https://infogram.com/panorama-general-1h7z2lgn3l9l4ow?live,15448348,8595202,26518,24845,0.48371395751805774,55175,51695,15329204,8714346
Colombia,2021-08-30,24121717,24121717,78167,https://infogram.com/panorama-general-1h7z2lgn3l9l4ow?live,15448348,8595202,0,0,0.48371395751805774,40357,37810,15369561,8752156
Colombia,2021-08-31,24169791,24169791,48074,https://infogram.com/panorama-general-1h7z2lgn3l9l4ow?live,15448348,8595202,0,0,0.48371395751805774,24820,23254,15394381,8775410
Colombia,2021-09-01,24217542,24217542,47751,https://infogram.com/panorama-general-1h7z2lgn3l9l4ow?live,15448348,8595202,0,0,0.48371395751805774,24653,23098,15419034,8798508
Colombia,2021-09-02,24217542,24217542,0,https://infogram.com/panorama-general-1h7z2lgn3l9l4ow?live,15541569,8675973,93221,80771,0.46422249298818336,0,0,15419034,8798508
Colombia,2021-09-03,24268743,24268743,51201,https://infogram.com/panorama-general-1h7z2lgn3l9l4ow?live,15568018,8700725,26449,24752,0.4834280580457413,26449,24752,15445483,8823260
Colombia,2021-09-04,24322614,24322614,53871,https://infogram.com/panorama-general-1h7z2lgn3l9l4ow?live,15598014,8724600,29996,23875,0.4431883573722411,29996,23875,15475479,8847135
Colombia,2021-09-05,24322614,24322614,0,https://infogram.com/panorama-general-1h7z2lgn3l9l4ow?live,15598014,8724600,0,0,0.4431883573722411,0,0,15475479,8847135
Colombia,2021-09-06,24322614,24322614,0,https://infogram.com/panorama-general-1h7z2lgn3l9l4ow?live,15598014,8724600,0,0,0.4431883573722411,0,0,15475479,8847135
Colombia,2021-09-07,24493353,24493353,170739,https://infogram.com/panorama-general-1h7z2lgn3l9l4ow?live,15598014,8724600,0,0,0.4431883573722411,95069,75670,15570548,8922805
Colombia,2021-09-08,24493353,24493353,0,https://infogram.com/panorama-general-1h7z2lgn3l9l4ow?live,15598014,8724600,0,0,0.4431883573722411,0,0,15570548,8922805
Colombia,2021-09-09,24493353,24493353,0,https://infogram.com/panorama-general-1h7z2lgn3l9l4ow?live,15598014,8724600,0,0,0.4431883573722411,0,0,15570548,8922805
Colombia,2021-09-10,24598042,24598042,104689,https://infogram.com/panorama-general-1h7z2lgn3l9l4ow?live,15737214,8860828,139200,136228,0.4946047605907896,52909,51780,15623457,8974585
Colombia,2021-09-11,24598042,24598042,0,https://infogram.com/panorama-general-1h7z2lgn3l9l4ow?live,15737214,8860828,0,0,0.4946047605907896,0,0,15623457,8974585
Colombia,2021-09-12,24598042,24598042,0,https://infogram.com/panorama-general-1h7z2lgn3l9l4ow?live,15791206,8901961,53992,41133,0.4324099868593955,0,0,15623457,8974585
Colombia,2021-09-13,24769016,24769016,170974,https://infogram.com/panorama-general-1h7z2lgn3l9l4ow?live,15839098,8929918,47892,27957,0.3685875884982004,107955,63019,15731412,9037604
Colombia,2021-09-14,24818784,24818784,49768,https://infogram.com/panorama-general-1h7z2lgn3l9l4ow?live,15839098,8929918,0,0,0.3685875884982004,31424,18344,15762836,9055948
Colombia,2021-09-15,24864504,24864504,45720,https://infogram.com/panorama-general-1h7z2lgn3l9l4ow?live,15879595,8984909,40497,54991,0.5758943532171582,19390,26330,15782226,9082278
Colombia,2021-09-16,24864504,24864504,0,https://infogram.com/panorama-general-1h7z2lgn3l9l4ow?live,15879595,8984909,0,0,0.5758943532171582,0,0,15782226,9082278
Colombia,2021-09-17,24864504,24864504,0,https://infogram.com/panorama-general-1h7z2lgn3l9l4ow?live,15879595,8984909,0,0,0.5758943532171582,0,0,15782226,9082278
Colombia,2021-09-18,24864504,24864504,0,https://infogram.com/panorama-general-1h7z2lgn3l9l4ow?live,15879595,8984909,0,0,0.5758943532171582,0,0,15782226,9082278
Colombia,2021-09-19,24864504,24864504,0,https://infogram.com/panorama-general-1h7z2lgn3l9l4ow?live,15959737,9051317,80142,66408,0.45314227226202664,0,0,15782226,9082278
Colombia,2021-09-20,24864504,24864504,0,https://infogram.com/panorama-general-1h7z2lgn3l9l4ow?live,15959737,9051317,0,0,0.45314227226202664,0,0,15782226,9082278
Colombia,2021-09-21,25085322,25085322,220818,https://infogram.com/panorama-general-1h7z2lgn3l9l4ow?live,16004322,9081000,44585,29683,0.3996741530672699,132563,88255,15914789,9170533
Colombia,2021-09-22,25135649,25135649,50327,https://infogram.com/panorama-general-1h7z2lgn3l9l4ow?live,16028313,9107336,23991,26336,0.52329763347706,23991,26336,15938780,9196869
Colombia,2021-09-23,25183060,25183060,47411,https://infogram.com/panorama-general-1h7z2lgn3l9l4ow?live,16047715,9135345,19402,28009,0.5907700744552952,19402,28009,15958182,9224878
Colombia,2021-09-24,25232844,25232844,49784,https://infogram.com/panorama-general-1h7z2lgn3l9l4ow?live,16076168,9156676,28453,21331,0.42847099469709143,28453,21331,15986635,9246209
Colombia,2021-09-25,25232844,25232844,0,https://infogram.com/panorama-general-1h7z2lgn3l9l4ow?live,16076168,9156676,0,0,0.42847099469709143,0,0,15986635,9246209
Colombia,2021-09-26,25232844,25232844,0,https://infogram.com/panorama-general-1h7z2lgn3l9l4ow?live,16076168,9156676,0,0,0.42847099469709143,0,0,15986635,9246209
Colombia,2021-09-27,25232844,25232844,0,https://infogram.com/panorama-general-1h7z2lgn3l9l4ow?live,16177875,9226695,101707,70019,0.40773674341683847,0,0,15986635,9246209
Colombia,2021-09-28,25404570,25404570,171726,https://infogram.com/panorama-general-1h7z2lgn3l9l4ow?live,16177875,9226695,0,0,0.40773674341683847,101707,70019,16088342,9316228
Colombia,2021-09-29,25404570,25404570,0,https://infogram.com/panorama-general-1h7z2lgn3l9l4ow?live,16177875,9226695,0,0,0.40773674341683847,0,0,16088342,9316228
Colombia,2021-09-30,25404570,25404570,0,https://infogram.com/panorama-general-1h7z2lgn3l9l4ow?live,16177875,9226695,0,0,0.40773674341683847,0,0,16088342,9316228
Colombia,2021-10-01,25404570,25404570,0,https://infogram.com/panorama-general-1h7z2lgn3l9l4ow?live,16177875,9226695,0,0,0.40773674341683847,0,0,16088342,9316228
Colombia,2021-10-02,25404570,25404570,0,https://infogram.com/panorama-general-1h7z2lgn3l9l4ow?live,16177875,9226695,0,0,0.40773674341683847,0,0,16088342,9316228
Colombia,2021-10-03,25404570,25404570,0,https://infogram.com/panorama-general-1h7z2lgn3l9l4ow?live,16317372,9353207,139497,126512,0.4755929310662421,0,0,16088342,9316228
Colombia,2021-10-04,25404570,25404570,0,https://infogram.com/panorama-general-1h7z2lgn3l9l4ow?live,16317372,9353207,0,0,0.4755929310662421,0,0,16088342,9316228
Colombia,2021-10-05,25404570,25404570,0,https://infogram.com/panorama-general-1h7z2lgn3l9l4ow?live,16317372,9353207,0,0,0.4755929310662421,0,0,16088342,9316228
Colombia,2021-10-06,25404570,25404570,0,https://infogram.com/panorama-general-1h7z2lgn3l9l4ow?live,16317372,9353207,0,0,0.4755929310662421,0,0,16088342,9316228
Colombia,2021-10-07,25404570,25404570,0,https://infogram.com/panorama-general-1h7z2lgn3l9l4ow?live,16384292,9411011,66920,57804,0.4634553093229852,0,0,16088342,9316228
Colombia,2021-10-08,25404570,25404570,0,https://infogram.com/panorama-general-1h7z2lgn3l9l4ow?live,16384292,9411011,0,0,0.4634553093229852,0,0,16088342,9316228
Colombia,2021-10-09,25404570,25404570,0,https://infogram.com/panorama-general-1h7z2lgn3l9l4ow?live,16384292,9411011,0,0,0.4634553093229852,0,0,16088342,9316228
Colombia,2021-10-10,25404570,25404570,0,https://infogram.com/panorama-general-1h7z2lgn3l9l4ow?live,16460865,9477637,76573,66626,0.46526861221097915,0,0,16088342,9316228
Colombia,2021-10-11,25404570,25404570,0,https://infogram.com/panorama-general-1h7z2lgn3l9l4ow?live,16460865,9477637,0,0,0.46526861221097915,0,0,16088342,9316228
Colombia,2021-10-12,25404570,25404570,0,https://infogram.com/panorama-general-1h7z2lgn3l9l4ow?live,16505652,9505479,44787,27842,0.38334549560093073,0,0,16088342,9316228
Colombia,2021-10-13,25404570,25404570,0,https://infogram.com/panorama-general-1h7z2lgn3l9l4ow?live,16505652,9505479,0,0,0.38334549560093073,0,0,16088342,9316228
Colombia,2021-10-14,25404570,25404570,0,https://infogram.com/panorama-general-1h7z2lgn3l9l4ow?live,16505652,9505479,0,0,0.38334549560093073,0,0,16088342,9316228
Colombia,2021-10-15,25404570,25404570,0,https://infogram.com/panorama-general-1h7z2lgn3l9l4ow?live,16569494,9579440,63842,73961,0.5367154561221453,0,0,16088342,9316228
Colombia,2021-10-16,25404570,25404570,0,https://infogram.com/panorama-general-1h7z2lgn3l9l4ow?live,16569494,9579440,0,0,0.5367154561221453,0,0,16088342,9316228
Colombia,2021-10-17,25404570,25404570,0,https://infogram.com/panorama-general-1h7z2lgn3l9l4ow?live,16569494,9579440,0,0,0.5367154561221453,0,0,16088342,9316228
Colombia,2021-10-18,25404570,25404570,0,https://infogram.com/panorama-general-1h7z2lgn3l9l4ow?live,16633143,9633857,63649,54417,0.46090322362068675,0,0,16088342,9316228
Colombia,2021-10-19,26295671,26295671,891101,https://infogram.com/panorama-general-1h7z2lgn3l9l4ow?live,16651483,9644188,18340,10331,0.3603292525548464,570011,321090,16658353,9637318
Colombia,2021-10-20,26358743,26358743,63072,https://infogram.com/panorama-general-1h7z2lgn3l9l4ow?live,16683112,9675631,31629,31443,0.4985254946727549,31629,31443,16689982,9668761
Colombia,2021-10-21,26358743,26358743,0,https://infogram.com/panorama-general-1h7z2lgn3l9l4ow?live,16683112,9675631,0,0,0.4985254946727549,0,0,16689982,9668761
Colombia,2021-10-22,26405615,26405615,46872,https://infogram.com/panorama-general-1h7z2lgn3l9l4ow?live,16704316,9701299,21204,25668,0.5476190476190477,21204,25668,16711186,9694429
Colombia,2021-10-23,26451223,26451223,45608,https://infogram.com/panorama-general-1h7z2lgn3l9l4ow?live,16728055,9723168,23739,21869,0.47949921066479567,23739,21869,16734925,9716298
Colombia,2021-10-24,26494409,26494409,43186,https://infogram.com/panorama-general-1h7z2lgn3l9l4ow?live,16750741,9743668,22686,20500,0.47469087204186544,22686,20500,16757611,9736798
Colombia,2021-10-25,26525120,26525120,30711,https://infogram.com/panorama-general-1h7z2lgn3l9l4ow?live,16770261,9754859,19520,11191,0.3643971215525382,19520,11191,16777131,9747989
Colombia,2021-10-26,26525120,26525120,0,https://infogram.com/panorama-general-1h7z2lgn3l9l4ow?live,16770261,9754859,0,0,0.3643971215525382,0,0,16777131,9747989
Colombia,2021-10-27,26525120,26525120,0,https://infogram.com/panorama-general-1h7z2lgn3l9l4ow?live,16837188,9813953,66927,59094,0.4689218463589402,0,0,16777131,9747989
Colombia,2021-10-28,26651141,26651141,126021,https://infogram.com/panorama-general-1h7z2lgn3l9l4ow?live,16837188,9813953,0,0,0.4689218463589402,66927,59094,16844058,9807083
Colombia,2021-10-29,26651141,26651141,0,https://infogram.com/panorama-general-1h7z2lgn3l9l4ow?live,16837188,9813953,0,0,0.4689218463589402,0,0,16844058,9807083
Colombia,2021-10-30,26651141,26651141,0,https://infogram.com/panorama-general-1h7z2lgn3l9l4ow?live,16884846,9857063,47658,43110,0.47494711792702277,0,0,16844058,9807083
Colombia,2021-10-31,26651141,26651141,0,https://infogram.com/panorama-general-1h7z2lgn3l9l4ow?live,16884846,9857063,0,0,0.47494711792702277,0,0,16844058,9807083
Colombia,2021-11-01,26845376,26845376,194235,https://infogram.com/panorama-general-1h7z2lgn3l9l4ow?live,16948159,9897217,63313,40154,0.38808508993205565,118855,75380,16962913,9882463
Colombia,2021-11-02,26871137,26871137,25761,https://infogram.com/panorama-general-1h7z2lgn3l9l4ow?live,16965222,9905915,17063,8698,0.33764217227592097,17063,8698,16979976,9891161
Colombia,2021-11-03,26871137,26871137,0,https://infogram.com/panorama-general-1h7z2lgn3l9l4ow?live,16965222,9905915,0,0,0.33764217227592097,0,0,16979976,9891161
Colombia,2021-11-04,26871137,26871137,0,https://infogram.com/panorama-general-1h7z2lgn3l9l4ow?live,16965222,9905915,0,0,0.33764217227592097,0,0,16979976,9891161
Colombia,2021-11-05,26871137,26871137,0,https://infogram.com/panorama-general-1h7z2lgn3l9l4ow?live,17002341,9950154,37119,44239,0.5437572211706286,0,0,16979976,9891161
Colombia,2021-11-06,26997594,26997594,126457,https://infogram.com/panorama-general-1h7z2lgn3l9l4ow?live,17026887,9970707,24546,20553,0.4557307257367126,68827,57630,17048803,9948791
Colombia,2021-11-07,27042399,27042399,44805,https://infogram.com/panorama-general-1h7z2lgn3l9l4ow?live,17051146,9991253,24259,20546,0.458564892311126,24259,20546,17073062,9969337
Colombia,2021-11-08,27073018,27073018,30619,https://infogram.com/panorama-general-1h7z2lgn3l9l4ow?live,17070134,10002884,18988,11631,0.3798621770795911,18988,11631,17092050,9980968
Colombia,2021-11-09,27119056,27119056,46038,https://infogram.com/panorama-general-1h7z2lgn3l9l4ow?live,17100065,10018991,29931,16107,0.3498631565228724,29931,16107,17121981,9997075
Colombia,2021-11-10,27164477,27164477,45421,https://infogram.com/panorama-general-1h7z2lgn3l9l4ow?live,17119880,10044597,19815,25606,0.5637480460579908,19815,25606,17141796,10022681
Colombia,2021-11-11,27210750,27210750,46273,https://infogram.com/panorama-general-1h7z2lgn3l9l4ow?live,17140547,10070203,20667,25606,0.5533680548051779,20667,25606,17162463,10048287
Colombia,2021-11-12,27210750,27210750,0,https://infogram.com/panorama-general-1h7z2lgn3l9l4ow?live,17140547,10070203,0,0,0.5533680548051779,0,0,17162463,10048287
Colombia,2021-11-13,27210750,27210750,0,https://infogram.com/panorama-general-1h7z2lgn3l9l4ow?live,17191138,10116308,50591,46105,0.47680359063456607,0,0,17162463,10048287
Colombia,2021-11-14,27210750,27210750,0,https://infogram.com/panorama-general-1h7z2lgn3l9l4ow?live,17191138,10116308,0,0,0.47680359063456607,0,0,17162463,10048287
Colombia,2021-11-15,27210750,27210750,0,https://infogram.com/panorama-general-1h7z2lgn3l9l4ow?live,17191138,10116308,0,0,0.47680359063456607,0,0,17162463,10048287
Colombia,2021-11-16,27429312,27429312,218562,https://infogram.com/panorama-general-1h7z2lgn3l9l4ow?live,17263770,10165542,72632,49234,0.4040011159798467,130263,88299,17292726,10136586
Colombia,2021-11-17,27429312,27429312,0,https://infogram.com/panorama-general-1h7z2lgn3l9l4ow?live,17263770,10165542,0,0,0.4040011159798467,0,0,17292726,10136586
Colombia,2021-11-18,27429312,27429312,0,https://infogram.com/panorama-general-1h7z2lgn3l9l4ow?live,17304882,10205570,41112,40028,0.4933201873305398,0,0,17292726,10136586
Colombia,2021-11-19,27557748,27557748,128436,https://infogram.com/panorama-general-1h7z2lgn3l9l4ow?live,17324487,10233261,19605,27691,0.5854829161028416,53239,75197,17345965,10211783
Colombia,2021-11-20,27610201,27610201,52453,https://infogram.com/panorama-general-1h7z2lgn3l9l4ow?live,17351513,10258688,27026,25427,0.48475778315825596,27026,25427,17372991,10237210
Colombia,2021-11-21,27610201,27610201,0,https://infogram.com/panorama-general-1h7z2lgn3l9l4ow?live,17351513,10258688,0,0,0.48475778315825596,0,0,17372991,10237210
Colombia,2021-11-22,27610201,27610201,0,https://infogram.com/panorama-general-1h7z2lgn3l9l4ow?live,17351513,10258688,0,0,0.48475778315825596,0,0,17372991,10237210
Colombia,2021-11-23,27788024,27788024,177823,https://infogram.com/panorama-general-1h7z2lgn3l9l4ow?live,17452443,10335581,100930,76893,0.43241312991007913,100930,76893,17473921,10314103
Colombia,2021-11-24,27788024,27788024,0,https://infogram.com/panorama-general-1h7z2lgn3l9l4ow?live,17452443,10335581,0,0,0.43241312991007913,0,0,17473921,10314103
Colombia,2021-11-25,27788024,27788024,0,https://infogram.com/panorama-general-1h7z2lgn3l9l4ow?live,17452443,10335581,0,0,0.43241312991007913,0,0,17473921,10314103
Colombia,2021-11-26,27891010,27891010,102986,https://infogram.com/panorama-general-1h7z2lgn3l9l4ow?live,17501090,10389920,48647,54339,0.5276348241508555,48647,54339,17522568,10368442
Colombia,2021-11-27,27891010,27891010,0,https://infogram.com/panorama-general-1h7z2lgn3l9l4ow?live,17501090,10389920,0,0,0.5276348241508555,0,0,17522568,10368442
Colombia,2021-11-28,28017929,28017929,126919,https://infogram.com/panorama-general-1h7z2lgn3l9l4ow?live,17573943,10443986,72853,54066,0.42598822871280106,72853,54066,17595421,10422508
Colombia,2021-11-29,28017929,28017929,0,https://infogram.com/panorama-general-1h7z2lgn3l9l4ow?live,17573943,10443986,0,0,0.42598822871280106,0,0,17595421,10422508
Colombia,2021-11-30,28017929,28017929,0,https://infogram.com/panorama-general-1h7z2lgn3l9l4ow?live,17573943,10443986,0,0,0.42598822871280106,0,0,17595421,10422508
Colombia,2021-12-01,28017929,28017929,0,https://infogram.com/panorama-general-1h7z2lgn3l9l4ow?live,17645170,10515535,71227,71549,0.5011276404998039,0,0,17595421,10422508
Colombia,2021-12-02,28160705,28160705,142776,https://infogram.com/panorama-general-1h7z2lgn3l9l4ow?live,17645170,10515535,0,0,0.5011276404998039,71227,71549,17666648,10494057
Colombia,2021-12-03,28258816,28258816,98111,https://infogram.com/panorama-general-1h7z2lgn3l9l4ow?live,17696244,10562572,51074,47037,0.4794263640162673,51074,47037,17717722,10541094
Colombia,2021-12-04,28258816,28258816,0,https://infogram.com/panorama-general-1h7z2lgn3l9l4ow?live,17696244,10562572,0,0,0.4794263640162673,0,0,17717722,10541094
Colombia,2021-12-05,28258816,28258816,0,https://infogram.com/panorama-general-1h7z2lgn3l9l4ow?live,17696244,10562572,0,0,0.4794263640162673,0,0,17717722,10541094
Colombia,2021-12-06,28330663,28330663,71847,https://infogram.com/panorama-general-1h7z2lgn3l9l4ow?live,17737950,10592713,41706,30141,0.41951647250407115,41706,30141,17759428,10571235
Colombia,2021-12-07,28382350,28382350,51687,https://infogram.com/panorama-general-1h7z2lgn3l9l4ow?live,17771216,10611134,33266,18421,0.3563952251049587,33266,18421,17792694,10589656
Colombia,2021-12-08,28382350,28382350,0,https://infogram.com/panorama-general-1h7z2lgn3l9l4ow?live,17771216,10611134,0,0,0.3563952251049587,0,0,17792694,10589656
Colombia,2021-12-09,28506132,28506132,123782,https://infogram.com/panorama-general-1h7z2lgn3l9l4ow?live,17833000,10673132,61784,61998,0.5008644229370991,61784,61998,17854478,10651654
Colombia,2021-12-10,28559483,28559483,53351,https://infogram.com/panorama-general-1h7z2lgn3l9l4ow?live,17859591,10699892,26591,26760,0.5015838503495718,26591,26760,17881069,10678414
Colombia,2021-12-11,28559483,28559483,0,https://infogram.com/panorama-general-1h7z2lgn3l9l4ow?live,17859591,10699892,0,0,0.5015838503495718,0,0,17881069,10678414
Colombia,2021-12-12,28587711,28587711,28228,https://infogram.com/panorama-general-1h7z2lgn3l9l4ow?live,17875093,10712618,15502,12726,0.45082896414907186,15502,12726,17896571,10691140
Colombia,2021-12-13,28684089,28684089,96378,https://infogram.com/panorama-general-1h7z2lgn3l9l4ow?live,17930020,10754069,54927,41451,0.4300877793687356,54927,41451,17951498,10732591
Colombia,2021-12-14,28684089,28684089,0,https://infogram.com/panorama-general-1h7z2lgn3l9l4ow?live,17930020,10754069,0,0,0.4300877793687356,0,0,17951498,10732591
Colombia,2021-12-15,28684089,28684089,0,https://infogram.com/panorama-general-1h7z2lgn3l9l4ow?live,17930020,10754069,0,0,0.4300877793687356,0,0,17951498,10732591
Colombia,2021-12-16,28830092,28830092,146003,https://infogram.com/panorama-general-1h7z2lgn3l9l4ow?live,17997849,10832243,67829,78174,0.5354273542324473,67829,78174,18019327,10810765
Colombia,2021-12-17,28830092,28830092,0,https://infogram.com/panorama-general-1h7z2lgn3l9l4ow?live,17997849,10832243,0,0,0.5354273542324473,0,0,18019327,10810765
Colombia,2021-12-18,28919466,28919466,89374,https://infogram.com/panorama-general-1h7z2lgn3l9l4ow?live,18046172,10873294,48323,41051,0.45931702732338264,48323,41051,18067650,10851816
Colombia,2021-12-19,28919466,28919466,0,https://infogram.com/panorama-general-1h7z2lgn3l9l4ow?live,18046172,10873294,0,0,0.45931702732338264,0,0,18067650,10851816
Colombia,2021-12-20,28919466,28919466,0,https://infogram.com/panorama-general-1h7z2lgn3l9l4ow?live,18046172,10873294,0,0,0.45931702732338264,0,0,18067650,10851816
Colombia,2021-12-21,28919466,28919466,0,https://infogram.com/panorama-general-1h7z2lgn3l9l4ow?live,18046172,10873294,0,0,0.45931702732338264,0,0,18067650,10851816
Colombia,2021-12-22,28919466,28919466,0,https://infogram.com/panorama-general-1h7z2lgn3l9l4ow?live,18046172,10873294,0,0,0.45931702732338264,0,0,18067650,10851816
Colombia,2021-12-23,28919466,28919466,0,https://infogram.com/panorama-general-1h7z2lgn3l9l4ow?live,18170624,10995461,124452,122167,0.49536734801454874,0,0,18067650,10851816
Colombia,2021-12-24,29195867,29195867,276401,https://infogram.com/panorama-general-1h7z2lgn3l9l4ow?live,18200406,10995461,29782,0,0,276401,0,18344051,10851816
Colombia,2021-12-25,29228550,29228550,32683,https://infogram.com/panorama-general-1h7z2lgn3l9l4ow?live,18200406,11028144,0,32683,1,0,32683,18344051,10884499
Colombia,2021-12-26,29255860,29255860,27310,https://infogram.com/panorama-general-1h7z2lgn3l9l4ow?live,18216336,11039524,15930,11380,0.4166971805199561,15930,11380,18359981,10895879
Colombia,2021-12-27,29313779,29313779,57919,https://infogram.com/panorama-general-1h7z2lgn3l9l4ow?live,18249365,11064414,33029,24890,0.4297380824945182,33029,24890,18393010,10920769
Colombia,2021-12-28,29352283,29352283,38504,https://infogram.com/panorama-general-1h7z2lgn3l9l4ow?live,18272063,11080220,22698,15806,0.41050280490338664,22698,15806,18415708,10936575
Colombia,2021-12-29,29352283,29352283,0,https://infogram.com/panorama-general-1h7z2lgn3l9l4ow?live,18272063,11080220,0,0,0.41050280490338664,0,0,18415708,10936575
Colombia,2021-12-30,29565827,29565827,213544,https://infogram.com/panorama-general-1h7z2lgn3l9l4ow?live,18320643,11159277,48580,79057,0.6193893620188503,81277,132267,18496985,11068842
Colombia,2021-12-31,29565827,29565827,0,https://infogram.com/panorama-general-1h7z2lgn3l9l4ow?live,18320643,11159277,0,0,0.6193893620188503,0,0,18496985,11068842
Colombia,2022-01-01,29565827,29565827,0,https://infogram.com/panorama-general-1h7z2lgn3l9l4ow?live,18385226,11237347,64583,78070,0.5472720517619678,0,0,18496985,11068842
Colombia,2022-01-02,29699775,29699775,133948,https://infogram.com/panorama-general-1h7z2lgn3l9l4ow?live,18420448,11279327,35222,41980,0.5437682961581306,61111,72837,18558096,11141679
Colombia,2022-01-03,29764087,29764087,64312,https://infogram.com/panorama-general-1h7z2lgn3l9l4ow?live,18454030,11310057,33582,30730,0.47782684413484267,33582,30730,18591678,11172409
Colombia,2022-01-04,29889802,29889802,125715,https://infogram.com/panorama-general-1h7z2lgn3l9l4ow?live,18511185,11378617,57155,68560,0.5453605377242174,57155,68560,18648833,11240969
Colombia,2022-01-05,29889802,29889802,0,https://infogram.com/panorama-general-1h7z2lgn3l9l4ow?live,18511185,11378617,0,0,0.5453605377242174,0,0,18648833,11240969
Colombia,2022-01-06,29980901,29980901,91099,https://infogram.com/panorama-general-1h7z2lgn3l9l4ow?live,18541568,11439333,30383,60716,0.6664837155182823,30383,60716,18679216,11301685
Colombia,2022-01-07,30077449,30077449,96548,https://infogram.com/panorama-general-1h7z2lgn3l9l4ow?live,18584169,11493280,42601,53947,0.5587583378216017,42601,53947,18721817,11355632
Colombia,2022-01-08,30077449,30077449,0,https://infogram.com/panorama-general-1h7z2lgn3l9l4ow?live,18584169,11493280,0,0,0.5587583378216017,0,0,18721817,11355632
Colombia,2022-01-09,30077449,30077449,0,https://infogram.com/panorama-general-1h7z2lgn3l9l4ow?live,18584169,11493280,0,0,0.5587583378216017,0,0,18721817,11355632
Colombia,2022-01-10,30077449,30077449,0,https://infogram.com/panorama-general-1h7z2lgn3l9l4ow?live,18584169,11493280,0,0,0.5587583378216017,0,0,18721817,11355632
Colombia,2022-01-11,30077449,30077449,0,https://infogram.com/panorama-general-1h7z2lgn3l9l4ow?live,18584169,11493280,0,0,0.5587583378216017,0,0,18721817,11355632
Colombia,2022-01-12,30077449,30077449,0,https://infogram.com/panorama-general-1h7z2lgn3l9l4ow?live,18840675,11745871,256506,252591,0.4961549567174821,0,0,18721817,11355632
Colombia,2022-01-13,30718358,30718358,640909,https://infogram.com/panorama-general-1h7z2lgn3l9l4ow?live,18908190,11810168,67515,64297,0.487793220647589,328278,312631,19050095,11668263
Colombia,2022-01-14,30718358,30718358,0,https://infogram.com/panorama-general-1h7z2lgn3l9l4ow?live,18908190,11810168,0,0,0.487793220647589,0,0,19050095,11668263
Colombia,2022-01-15,30718358,30718358,0,https://infogram.com/panorama-general-1h7z2lgn3l9l4ow?live,19003999,11928551,95809,118383,0.5526957122581609,0,0,19050095,11668263
Colombia,2022-01-16,30718358,30718358,0,https://infogram.com/panorama-general-1h7z2lgn3l9l4ow?live,19003999,11928551,0,0,0.5526957122581609,0,0,19050095,11668263
Colombia,2022-01-17,30718358,30718358,0,https://infogram.com/panorama-general-1h7z2lgn3l9l4ow?live,19069693,12001190,65694,72639,0.5251024701264341,0,0,19050095,11668263
Colombia,2022-01-18,31171683,31171683,453325,https://infogram.com/panorama-general-1h7z2lgn3l9l4ow?live,19125180,12046503,55487,45313,0.44953373015873016,249540,203785,19299635,11872048
Colombia,2022-01-19,31264531,31264531,92848,https://infogram.com/panorama-general-1h7z2lgn3l9l4ow?live,19167094,12097437,41914,50934,0.5485740134413235,41914,50934,19341549,11922982
Colombia,2022-01-20,31264531,31264531,0,https://infogram.com/panorama-general-1h7z2lgn3l9l4ow?live,19167094,12097437,0,0,0.5485740134413235,0,0,19341549,11922982
Colombia,2022-01-21,31264531,31264531,0,https://infogram.com/panorama-general-1h7z2lgn3l9l4ow?live,19167094,12097437,0,0,0.5485740134413235,0,0,19341549,11922982
Colombia,2022-01-22,31264531,31264531,0,https://infogram.com/panorama-general-1h7z2lgn3l9l4ow?live,19167094,12097437,0,0,0.5485740134413235,0,0,19341549,11922982
Colombia,2022-01-23,31264531,31264531,0,https://infogram.com/panorama-general-1h7z2lgn3l9l4ow?live,19167094,12097437,0,0,0.5485740134413235,0,0,19341549,11922982
Colombia,2022-01-24,31264531,31264531,0,https://infogram.com/panorama-general-1h7z2lgn3l9l4ow?live,19167094,12097437,0,0,0.5485740134413235,0,0,19341549,11922982
Colombia,2022-01-25,31736335,31736335,471804,https://infogram.com/panorama-general-1h7z2lgn3l9l4ow?live,19402847,12333488,235753,236051,0.5003158091071717,235753,236051,19577302,12159033
Colombia,2022-01-26,31736335,31736335,0,https://infogram.com/panorama-general-1h7z2lgn3l9l4ow?live,19402847,12333488,0,0,0.5003158091071717,0,0,19577302,12159033
Colombia,2022-01-27,31875825,31875825,139490,https://infogram.com/panorama-general-1h7z2lgn3l9l4ow?live,19463421,12412404,60574,78916,0.5657466485052692,60574,78916,19637876,12237949
Colombia,2022-01-28,31875825,31875825,0,https://infogram.com/panorama-general-1h7z2lgn3l9l4ow?live,19463421,12412404,0,0,0.5657466485052692,0,0,19637876,12237949
Colombia,2022-01-29,31875825,31875825,0,https://infogram.com/panorama-general-1h7z2lgn3l9l4ow?live,19463421,12412404,0,0,0.5657466485052692,0,0,19637876,12237949
Colombia,2022-01-30,31875825,31875825,0,https://infogram.com/panorama-general-1h7z2lgn3l9l4ow?live,19551988,12499304,88567,86900,0.4952498190542951,0,0,19637876,12237949
Colombia,2022-01-31,32157058,32157058,281233,https://infogram.com/panorama-general-1h7z2lgn3l9l4ow?live,19608974,12548084,56986,48780,0.46120681504453226,151526,129707,19789402,12367656
Colombia,2022-02-01,32157058,32157058,0,https://infogram.com/panorama-general-1h7z2lgn3l9l4ow?live,19608974,12548084,0,0,0.46120681504453226,0,0,19789402,12367656
Colombia,2022-02-02,32278055,32278055,120997,https://infogram.com/panorama-general-1h7z2lgn3l9l4ow?live,19652853,12625202,43879,77118,0.6373546451564914,43879,77118,19833281,12444774
Colombia,2022-02-03,32278055,32278055,0,https://infogram.com/panorama-general-1h7z2lgn3l9l4ow?live,19652853,12625202,0,0,0.6373546451564914,0,0,19833281,12444774
Colombia,2022-02-04,32278055,32278055,0,https://infogram.com/panorama-general-1h7z2lgn3l9l4ow?live,19652853,12625202,0,0,0.6373546451564914,0,0,19833281,12444774
Colombia,2022-02-05,32278055,32278055,0,https://infogram.com/panorama-general-1h7z2lgn3l9l4ow?live,19652853,12625202,0,0,0.6373546451564914,0,0,19833281,12444774
Colombia,2022-02-06,32278055,32278055,0,https://infogram.com/panorama-general-1h7z2lgn3l9l4ow?live,19652853,12625202,0,0,0.6373546451564914,0,0,19833281,12444774
Colombia,2022-02-07,32500240,32500240,222185,https://infogram.com/panorama-general-1h7z2lgn3l9l4ow?live,19764036,12736204,111183,111002,0.4995926817741972,111183,111002,19944464,12555776
Colombia,2022-02-08,32500240,32500240,0,https://infogram.com/panorama-general-1h7z2lgn3l9l4ow?live,19764036,12736204,0,0,0.4995926817741972,0,0,19944464,12555776
Colombia,2022-02-09,32500240,32500240,0,https://infogram.com/panorama-general-1h7z2lgn3l9l4ow?live,19764036,12736204,0,0,0.4995926817741972,0,0,19944464,12555776
Colombia,2022-02-10,32585489,32585489,85249,https://infogram.com/panorama-general-1h7z2lgn3l9l4ow?live,19800140,12785349,36104,49145,0.5764877007354925,36104,49145,19980568,12604921
Colombia,2022-02-11,32585489,32585489,0,https://infogram.com/panorama-general-1h7z2lgn3l9l4ow?live,19800140,12785349,0,0,0.5764877007354925,0,0,19980568,12604921
Colombia,2022-02-12,32585489,32585489,0,https://infogram.com/panorama-general-1h7z2lgn3l9l4ow?live,19800140,12785349,0,0,0.5764877007354925,0,0,19980568,12604921
Colombia,2022-02-13,32585489,32585489,0,https://infogram.com/panorama-general-1h7z2lgn3l9l4ow?live,19850253,12842304,50113,56955,0.5319516568909478,0,0,19980568,12604921
Colombia,2022-02-14,32585489,32585489,0,https://infogram.com/panorama-general-1h7z2lgn3l9l4ow?live,19850253,12842304,0,0,0.5319516568909478,0,0,19980568,12604921
Colombia,2022-02-15,32585489,32585489,0,https://infogram.com/panorama-general-1h7z2lgn3l9l4ow?live,19850253,12842304,0,0,0.5319516568909478,0,0,19980568,12604921
Colombia,2022-02-16,32868692,32868692,283203,https://infogram.com/panorama-general-1h7z2lgn3l9l4ow?live,19850253,12842304,0,0,0.5319516568909478,132553,150650,20113121,12755571
Colombia,2022-02-17,32868692,32868692,0,https://infogram.com/panorama-general-1h7z2lgn3l9l4ow?live,19926771,12941921,76518,99617,0.5655718624918387,0,0,20113121,12755571
Colombia,2022-02-18,32868692,32868692,0,https://infogram.com/panorama-general-1h7z2lgn3l9l4ow?live,19926771,12941921,0,0,0.5655718624918387,0,0,20113121,12755571
Colombia,2022-02-19,32902670,32902670,33978,https://infogram.com/panorama-general-1h7z2lgn3l9l4ow?live,19943066,12959604,16295,17683,0.5204249808699747,16295,17683,20129416,12773254
Colombia,2022-02-20,32922807,32922807,20137,https://infogram.com/panorama-general-1h7z2lgn3l9l4ow?live,19953633,12969174,10567,9570,0.47524457466355463,10567,9570,20139983,12782824
Colombia,2022-02-21,32980562,32980562,57755,https://infogram.com/panorama-general-1h7z2lgn3l9l4ow?live,19953633,12969174,0,0,0.47524457466355463,30307,27448,20170290,12810272
Colombia,2022-02-22,32980562,32980562,0,https://infogram.com/panorama-general-1h7z2lgn3l9l4ow?live,19983006,12997556,29373,28382,0.49142065622024067,0,0,20170290,12810272
Colombia,2022-02-23,33016280,33016280,35718,https://infogram.com/panorama-general-1h7z2lgn3l9l4ow?live,19994904,13021376,11898,23820,0.6668906433730892,11898,23820,20182188,12834092
Colombia,2022-02-24,33085533,33085533,69253,https://infogram.com/panorama-general-1h7z2lgn3l9l4ow?live,20021202,13064331,26298,42955,0.6202619381109844,26298,42955,20208486,12877047
Colombia,2022-02-25,33085533,33085533,0,https://infogram.com/panorama-general-1h7z2lgn3l9l4ow?live,20021202,13064331,0,0,0.6202619381109844,0,0,20208486,12877047
Colombia,2022-02-26,33085533,33085533,0,https://infogram.com/panorama-general-1h7z2lgn3l9l4ow?live,20021202,13064331,0,0,0.6202619381109844,0,0,20208486,12877047
Colombia,2022-02-27,33165748,33165748,80215,https://infogram.com/panorama-general-1h7z2lgn3l9l4ow?live,20021202,13064331,0,0,0.6202619381109844,30461,49754,20238947,12926801
Colombia,2022-02-28,33165748,33165748,0,https://infogram.com/panorama-general-1h7z2lgn3l9l4ow?live,20058545,13107203,37343,42872,0.5344636289970703,0,0,20238947,12926801
Colombia,2022-03-01,33224395,33224395,58647,https://infogram.com/panorama-general-1h7z2lgn3l9l4ow?live,20058545,13107203,0,0,0.5344636289970703,27302,31345,20266249,12958146
Colombia,2022-03-02,33250588,33250588,26193,https://infogram.com/panorama-general-1h7z2lgn3l9l4ow?live,20058545,13107203,0,0,0.5344636289970703,12194,13999,20278443,12972145
Colombia,2022-03-03,33281725,33281725,31137,https://infogram.com/panorama-general-1h7z2lgn3l9l4ow?live,20058545,13107203,0,0,0.5344636289970703,14495,16642,20292938,12988787
Colombia,2022-03-04,33281725,33281725,0,https://infogram.com/panorama-general-1h7z2lgn3l9l4ow?live,20104122,13177603,45577,70400,0.6070169085249661,0,0,20292938,12988787
Colombia,2022-03-05,33281725,33281725,0,https://infogram.com/panorama-general-1h7z2lgn3l9l4ow?live,20104122,13177603,0,0,0.6070169085249661,0,0,20292938,12988787
Colombia,2022-03-06,33350542,33350542,68817,https://infogram.com/panorama-general-1h7z2lgn3l9l4ow?live,20124906,13201059,20784,23456,0.5301989150090416,32330,36487,20325268,13025274
Colombia,2022-03-07,33374605,33374605,24063,https://infogram.com/panorama-general-1h7z2lgn3l9l4ow?live,20147298,13227307,22392,26248,0.5396381578947368,11078,12985,20336346,13038259
Colombia,2022-03-08,33400734,33400734,26129,https://infogram.com/panorama-general-1h7z2lgn3l9l4ow?live,20147298,13227307,0,0,0.5396381578947368,12029,14100,20348375,13052359
Colombia,2022-03-09,33400734,33400734,0,https://infogram.com/panorama-general-1h7z2lgn3l9l4ow?live,20156568,13244166,9270,16859,0.645221784224425,0,0,20348375,13052359
Colombia,2022-03-10,33454522,33454522,53788,https://infogram.com/panorama-general-1h7z2lgn3l9l4ow?live,20176977,13277545,20409,33379,0.6205659254852384,20409,33379,20368784,13085738
Colombia,2022-03-11,33454522,33454522,0,https://infogram.com/panorama-general-1h7z2lgn3l9l4ow?live,20176977,13277545,0,0,0.6205659254852384,0,0,20368784,13085738
Colombia,2022-03-12,33481801,33481801,27279,https://infogram.com/panorama-general-1h7z2lgn3l9l4ow?live,20188007,13293794,11030,16249,0.5956596649437296,11030,16249,20379814,13101987
Colombia,2022-03-13,33495384,33495384,13583,https://infogram.com/panorama-general-1h7z2lgn3l9l4ow?live,20195127,13300257,7120,6463,0.4758153574320842,7120,6463,20386934,13108450
Colombia,2022-03-14,33540156,33540156,44772,https://infogram.com/panorama-general-1h7z2lgn3l9l4ow?live,20195127,13300257,0,0,0.4758153574320842,23469,21303,20410403,13129753
Colombia,2022-03-15,33566181,33566181,26025,https://infogram.com/panorama-general-1h7z2lgn3l9l4ow?live,20226061,13340120,30934,39863,0.5630605816630648,11371,14654,20421774,13144407
Colombia,2022-03-16,33595864,33595864,29683,https://infogram.com/panorama-general-1h7z2lgn3l9l4ow?live,20226061,13340120,0,0,0.5630605816630648,12970,16713,20434744,13161120
Colombia,2022-03-17,33623076,33623076,27212,https://infogram.com/panorama-general-1h7z2lgn3l9l4ow?live,20244569,13378507,18508,38387,0.6746990069426135,8852,18360,20443596,13179480
Colombia,2022-03-18,33623076,33623076,0,https://infogram.com/panorama-general-1h7z2lgn3l9l4ow?live,20244569,13378507,0,0,0.6746990069426135,0,0,20443596,13179480
Colombia,2022-03-19,33623076,33623076,0,https://infogram.com/panorama-general-1h7z2lgn3l9l4ow?live,20261857,13400171,17288,21664,0.5561716985007188,0,0,20443596,13179480
Colombia,2022-03-20,33623076,33623076,0,https://infogram.com/panorama-general-1h7z2lgn3l9l4ow?live,20261857,13400171,0,0,0.5561716985007188,0,0,20443596,13179480
Colombia,2022-03-21,33705356,33705356,82280,https://infogram.com/panorama-general-1h7z2lgn3l9l4ow?live,20270251,13413145,8394,12974,0.6071695994009734,32322,49958,20475918,13229438
Colombia,2022-03-22,33716878,33716878,11522,https://infogram.com/panorama-general-1h7z2lgn3l9l4ow?live,20284801,13432077,14550,18932,0.5654381458694224,5007,6515,20480925,13235953
Colombia,2022-03-23,33742049,33742049,25171,https://infogram.com/panorama-general-1h7z2lgn3l9l4ow?live,20292509,13449540,7708,17463,0.6937745818600771,7708,17463,20488633,13253416
Colombia,2022-03-24,33742049,33742049,0,https://infogram.com/panorama-general-1h7z2lgn3l9l4ow?live,20292509,13449540,0,0,0.6937745818600771,0,0,20488633,13253416
Colombia,2022-03-25,33742049,33742049,0,https://infogram.com/panorama-general-1h7z2lgn3l9l4ow?live,20292509,13449540,0,0,0.6937745818600771,0,0,20488633,13253416
Colombia,2022-03-26,33742049,33742049,0,https://infogram.com/panorama-general-1h7z2lgn3l9l4ow?live,20292509,13449540,0,0,0.6937745818600771,0,0,20488633,13253416
Colombia,2022-03-27,33829312,33829312,87263,https://infogram.com/panorama-general-1h7z2lgn3l9l4ow?live,20292509,13449540,0,0,0.6937745818600771,26722,60541,20515355,13313957
Colombia,2022-03-28,33829312,33829312,0,https://infogram.com/panorama-general-1h7z2lgn3l9l4ow?live,20324804,13504508,32295,54968,0.6299118755944673,0,0,20515355,13313957
Colombia,2022-03-29,33899469,33899469,70157,https://infogram.com/panorama-general-1h7z2lgn3l9l4ow?live,20324804,13504508,0,0,0.6299118755944673,25964,44193,20541319,13358150
Colombia,2022-03-30,33899469,33899469,0,https://infogram.com/panorama-general-1h7z2lgn3l9l4ow?live,20324804,13504508,0,0,0.6299118755944673,0,0,20541319,13358150
Colombia,2022-03-31,33922578,33922578,23109,https://infogram.com/panorama-general-1h7z2lgn3l9l4ow?live,20324804,13504508,0,0,0.6299118755944673,8552,14557,20549871,13372707
Colombia,2022-04-01,33922578,33922578,0,https://infogram.com/panorama-general-1h7z2lgn3l9l4ow?live,20358757,13563821,33953,59313,0.635955224840778,0,0,20549871,13372707
Colombia,2022-04-02,33922578,33922578,0,https://infogram.com/panorama-general-1h7z2lgn3l9l4ow?live,20358757,13563821,0,0,0.635955224840778,0,0,20549871,13372707
Colombia,2022-04-03,33971965,33971965,49387,https://infogram.com/panorama-general-1h7z2lgn3l9l4ow?live,20358757,13563821,0,0,0.635955224840778,17979,31408,20567850,13404115
Colombia,2022-04-04,34019306,34019306,47341,https://infogram.com/panorama-general-1h7z2lgn3l9l4ow?live,20358757,13563821,0,0,0.635955224840778,17234,30107,20585084,13434222
Colombia,2022-04-05,34019306,34019306,0,https://infogram.com/panorama-general-1h7z2lgn3l9l4ow?live,20358757,13563821,0,0,0.635955224840778,0,0,20585084,13434222
Colombia,2022-04-06,34019306,34019306,0,https://infogram.com/panorama-general-1h7z2lgn3l9l4ow?live,20393810,13625496,35053,61675,0.6376126871226532,0,0,20585084,13434222
Colombia,2022-04-07,34074406,34074406,55100,https://infogram.com/panorama-general-1h7z2lgn3l9l4ow?live,20393810,13625496,0,0,0.6376126871226532,19968,35132,20605052,13469354
Colombia,2022-04-08,34074406,34074406,0,https://infogram.com/panorama-general-1h7z2lgn3l9l4ow?live,20417033,13657373,23223,31877,0.578529945553539,0,0,20605052,13469354
Colombia,2022-04-09,34074406,34074406,0,https://infogram.com/panorama-general-1h7z2lgn3l9l4ow?live,20417033,13657373,0,0,0.578529945553539,0,0,20605052,13469354
Colombia,2022-04-10,34135355,34135355,60949,https://infogram.com/panorama-general-1h7z2lgn3l9l4ow?live,20417033,13657373,0,0,0.578529945553539,25688,35261,20630740,13504615
Colombia,2022-04-11,34135355,34135355,0,https://infogram.com/panorama-general-1h7z2lgn3l9l4ow?live,20442293,13693062,25260,35689,0.5855551362614645,0,0,20630740,13504615
Colombia,2022-04-12,34183285,34183285,47930,https://infogram.com/panorama-general-1h7z2lgn3l9l4ow?live,20442293,13693062,0,0,0.5855551362614645,19864,28066,20650604,13532681
Colombia,2022-04-13,34183285,34183285,0,https://infogram.com/panorama-general-1h7z2lgn3l9l4ow?live,20460196,13723089,17903,30027,0.6264761109952013,0,0,20650604,13532681
Colombia,2022-04-14,34183285,34183285,0,https://infogram.com/panorama-general-1h7z2lgn3l9l4ow?live,20460196,13723089,0,0,0.6264761109952013,0,0,20650604,13532681
Colombia,2022-04-15,34183285,34183285,0,https://infogram.com/panorama-general-1h7z2lgn3l9l4ow?live,20474291,13752179,14095,29090,0.673613523214079,0,0,20650604,13532681
Colombia,2022-04-16,34236252,34236252,52967,https://infogram.com/panorama-general-1h7z2lgn3l9l4ow?live,20479295,13756957,5004,4778,0.4884481701083623,27095,25872,20677699,13558553
Colombia,2022-04-17,34236252,34236252,0,https://infogram.com/panorama-general-1h7z2lgn3l9l4ow?live,20479295,13756957,0,0,0.4884481701083623,0,0,20677699,13558553
Colombia,2022-04-18,34265772,34265772,29520,https://infogram.com/panorama-general-1h7z2lgn3l9l4ow?live,20483749,13765701,4454,8744,0.6625246249431732,9962,19558,20687661,13578111
Colombia,2022-04-19,34287337,34287337,21565,https://infogram.com/panorama-general-1h7z2lgn3l9l4ow?live,20493575,13793762,9826,28061,0.740649827117481,5593,15972,20693254,13594083
Colombia,2022-04-20,34287337,34287337,0,https://infogram.com/panorama-general-1h7z2lgn3l9l4ow?live,20493575,13793762,0,0,0.740649827117481,0,0,20693254,13594083
Colombia,2022-04-21,34306661,34306661,19324,https://infogram.com/panorama-general-1h7z2lgn3l9l4ow?live,20499596,13807065,6021,13303,0.6884185468847029,6021,13303,20699275,13607386
Colombia,2022-04-22,34327907,34327907,21246,https://infogram.com/panorama-general-1h7z2lgn3l9l4ow?live,20506556,13821351,6960,14286,0.6724089240327591,6960,14286,20706235,13621672
Colombia,2022-04-23,34327907,34327907,0,https://infogram.com/panorama-general-1h7z2lgn3l9l4ow?live,20506556,13821351,0,0,0.6724089240327591,0,0,20706235,13621672
Colombia,2022-04-24,34371690,34371690,43783,https://infogram.com/panorama-general-1h7z2lgn3l9l4ow?live,20506556,13821351,0,0,0.6724089240327591,14343,29440,20720578,13651112
Colombia,2022-04-25,34388490,34388490,16800,https://infogram.com/panorama-general-1h7z2lgn3l9l4ow?live,20530761,13857729,24205,36378,0.6004654771140419,6712,10088,20727290,13661200
Colombia,2022-04-26,34407374,34407374,18884,https://infogram.com/panorama-general-1h7z2lgn3l9l4ow?live,20530761,13857729,0,0,0.6004654771140419,7545,11339,20734835,13672539
Colombia,2022-04-27,34428355,34428355,20981,https://infogram.com/panorama-general-1h7z2lgn3l9l4ow?live,20530761,13857729,0,0,0.6004654771140419,8383,12598,20743218,13685137
Colombia,2022-04-28,34428355,34428355,0,https://infogram.com/panorama-general-1h7z2lgn3l9l4ow?live,20544023,13884332,13262,26603,0.6673272293992224,0,0,20743218,13685137
Colombia,2022-04-29,34428355,34428355,0,https://infogram.com/panorama-general-1h7z2lgn3l9l4ow?live,20544023,13884332,0,0,0.6673272293992224,0,0,20743218,13685137
Colombia,2022-04-30,34428355,34428355,0,https://infogram.com/panorama-general-1h7z2lgn3l9l4ow?live,20557437,13907615,13414,23283,0.6344660326457203,0,0,20743218,13685137
Colombia,2022-05-01,34474551,34474551,46196,https://infogram.com/panorama-general-1h7z2lgn3l9l4ow?live,20557437,13907615,0,0,0.6344660326457203,16886,29310,20760104,13714447
Colombia,2022-05-02,34474551,34474551,0,https://infogram.com/panorama-general-1h7z2lgn3l9l4ow?live,20557437,13907615,0,0,0.6344660326457203,0,0,20760104,13714447
Colombia,2022-05-03,34474551,34474551,0,https://infogram.com/panorama-general-1h7z2lgn3l9l4ow?live,20557437,13907615,0,0,0.6344660326457203,0,0,20760104,13714447
Colombia,2022-05-04,34474551,34474551,0,https://infogram.com/panorama-general-1h7z2lgn3l9l4ow?live,20561456,2275113,4019,-11632502,0.6344660326457203,0,0,20760104,13714447
Colombia,2022-05-05,34474551,34474551,0,https://infogram.com/panorama-general-1h7z2lgn3l9l4ow?live,20561456,13913095,0,11637982,1,0,0,20760104,13714447
Colombia,2022-05-06,34560302,34560302,85751,https://infogram.com/panorama-general-1h7z2lgn3l9l4ow?live,20590016,13970286,28560,57191,0.6669426595608214,28560,57191,20788664,13771638
Colombia,2022-05-07,34560302,34560302,0,https://infogram.com/panorama-general-1h7z2lgn3l9l4ow?live,20590016,13970286,0,0,0.6669426595608214,0,0,20788664,13771638
Colombia,2022-05-08,34560302,34560302,0,https://infogram.com/panorama-general-1h7z2lgn3l9l4ow?live,20590016,13970286,0,0,0.6669426595608214,0,0,20788664,13771638
Colombia,2022-05-09,34560302,34560302,0,https://infogram.com/panorama-general-1h7z2lgn3l9l4ow?live,20590016,13970286,0,0,0.6669426595608214,0,0,20788664,13771638
Colombia,2022-05-10,34560302,34560302,0,https://infogram.com/panorama-general-1h7z2lgn3l9l4ow?live,20590016,13970286,0,0,0.6669426595608214,0,0,20788664,13771638
Colombia,2022-05-11,34560302,34560302,0,https://infogram.com/panorama-general-1h7z2lgn3l9l4ow?live,20590016,13970286,0,0,0.6669426595608214,0,0,20788664,13771638
Colombia,2022-05-12,34560302,34560302,0,https://infogram.com/panorama-general-1h7z2lgn3l9l4ow?live,20590016,13970286,0,0,0.6669426595608214,0,0,20788664,13771638
Colombia,2022-05-13,34560302,34560302,0,https://infogram.com/panorama-general-1h7z2lgn3l9l4ow?live,20590016,13970286,0,0,0.6669426595608214,0,0,20788664,13771638
Colombia,2022-05-14,34560302,34560302,0,https://infogram.com/panorama-general-1h7z2lgn3l9l4ow?live,20627333,14048248,37317,77962,0.6762896971694758,0,0,20788664,13771638
Colombia,2022-05-15,34560302,34560302,0,https://infogram.com/panorama-general-1h7z2lgn3l9l4ow?live,20627333,14048248,0,0,0.6762896971694758,0,0,20788664,13771638
Colombia,2022-05-16,34675581,34675581,115279,https://infogram.com/panorama-general-1h7z2lgn3l9l4ow?live,20627333,14048248,0,0,0.6762896971694758,37317,77962,20825981,13849600
Colombia,2022-05-17,34675581,34675581,0,https://infogram.com/panorama-general-1h7z2lgn3l9l4ow?live,20627333,14048248,0,0,0.6762896971694758,0,0,20825981,13849600
Colombia,2022-05-18,34675581,34675581,0,https://infogram.com/panorama-general-1h7z2lgn3l9l4ow?live,20627333,14048248,0,0,0.6762896971694758,0,0,20825981,13849600
Colombia,2022-05-19,34792844,34792844,117263,https://infogram.com/panorama-general-1h7z2lgn3l9l4ow?live,20669480,14123364,42147,75116,0.6405771641523754,42147,75116,20868128,13924716
Colombia,2022-05-20,34792844,34792844,0,https://infogram.com/panorama-general-1h7z2lgn3l9l4ow?live,20669480,14123364,0,0,0.6405771641523754,0,0,20868128,13924716
Colombia,2022-05-21,34792844,34792844,0,https://infogram.com/panorama-general-1h7z2lgn3l9l4ow?live,20669480,14123364,0,0,0.6405771641523754,0,0,20868128,13924716
Colombia,2022-05-22,34792844,34792844,0,https://infogram.com/panorama-general-1h7z2lgn3l9l4ow?live,20669480,14123364,0,0,0.6405771641523754,0,0,20868128,13924716
Colombia,2022-05-23,34792844,34792844,0,https://infogram.com/panorama-general-1h7z2lgn3l9l4ow?live,20669480,14123364,0,0,0.6405771641523754,0,0,20868128,13924716
Colombia,2022-05-24,34792844,34792844,0,https://infogram.com/panorama-general-1h7z2lgn3l9l4ow?live,20669480,14123364,0,0,0.6405771641523754,0,0,20868128,13924716
Colombia,2022-05-25,34792844,34792844,0,https://infogram.com/panorama-general-1h7z2lgn3l9l4ow?live,20669480,14123364,0,0,0.6405771641523754,0,0,20868128,13924716
Colombia,2022-05-26,34922533,34922533,129689,https://infogram.com/panorama-general-1h7z2lgn3l9l4ow?live,20669480,14123364,0,0,0.6405771641523754,46613,83076,20914741,14007792
Colombia,2022-05-27,34922533,34922533,0,https://infogram.com/panorama-general-1h7z2lgn3l9l4ow?live,20714036,14208497,44556,85133,0.6564396363608325,0,0,20914741,14007792
Colombia,2022-05-28,34922533,34922533,0,https://infogram.com/panorama-general-1h7z2lgn3l9l4ow?live,20714036,14208497,0,0,0.6564396363608325,0,0,20914741,14007792
Colombia,2022-05-29,34922533,34922533,0,https://infogram.com/panorama-general-1h7z2lgn3l9l4ow?live,20714036,14208497,0,0,0.6564396363608325,0,0,20914741,14007792
Colombia,2022-05-30,34922533,34922533,0,https://infogram.com/panorama-general-1h7z2lgn3l9l4ow?live,20714036,14208497,0,0,0.6564396363608325,0,0,20914741,14007792
Colombia,2022-05-31,34922533,34922533,0,https://infogram.com/panorama-general-1h7z2lgn3l9l4ow?live,20714036,14208497,0,0,0.6564396363608325,0,0,20914741,14007792
Colombia,2022-06-01,34922533,34922533,0,https://infogram.com/panorama-general-1h7z2lgn3l9l4ow?live,20714036,14208497,0,0,0.6564396363608325,0,0,20914741,14007792
Colombia,2022-06-02,35041646,35041646,119113,https://infogram.com/panorama-general-1h7z2lgn3l9l4ow?live,20756510,14285136,42474,76639,0.6434142369010939,42474,76639,20957215,14084431
Colombia,2022-06-03,35041646,35041646,0,https://infogram.com/panorama-general-1h7z2lgn3l9l4ow?live,20756510,14285136,0,0,0.6434142369010939,0,0,20957215,14084431
Colombia,2022-06-04,35041646,35041646,0,https://infogram.com/panorama-general-1h7z2lgn3l9l4ow?live,20756510,14285136,0,0,0.6434142369010939,0,0,20957215,14084431
Colombia,2022-06-05,35041646,35041646,0,https://infogram.com/panorama-general-1h7z2lgn3l9l4ow?live,20756510,14285136,0,0,0.6434142369010939,0,0,20957215,14084431
Colombia,2022-06-06,35041646,35041646,0,https://infogram.com/panorama-general-1h7z2lgn3l9l4ow?live,20756510,14285136,0,0,0.6434142369010939,0,0,20957215,14084431
Colombia,2022-06-07,35041646,35041646,0,https://infogram.com/panorama-general-1h7z2lgn3l9l4ow?live,20756510,14285136,0,0,0.6434142369010939,0,0,20957215,14084431
Colombia,2022-06-08,35041646,35041646,0,https://infogram.com/panorama-general-1h7z2lgn3l9l4ow?live,20756510,14285136,0,0,0.6434142369010939,0,0,20957215,14084431
Colombia,2022-06-09,35041646,35041646,0,https://infogram.com/panorama-general-1h7z2lgn3l9l4ow?live,20756510,14285136,0,0,0.6434142369010939,0,0,20957215,14084431
Colombia,2022-06-10,35175528,35175528,133882,https://infogram.com/panorama-general-1h7z2lgn3l9l4ow?live,20802975,14372553,46465,87417,0.652940649228425,46465,87417,21003680,14171848
Colombia,2022-06-11,35175528,35175528,0,https://infogram.com/panorama-general-1h7z2lgn3l9l4ow?live,20802975,14372553,0,0,0.652940649228425,0,0,21003680,14171848
Colombia,2022-06-12,35175528,35175528,0,https://infogram.com/panorama-general-1h7z2lgn3l9l4ow?live,20802975,14372553,0,0,0.652940649228425,0,0,21003680,14171848
Colombia,2022-06-13,35175528,35175528,0,https://infogram.com/panorama-general-1h7z2lgn3l9l4ow?live,20802975,14372553,0,0,0.652940649228425,0,0,21003680,14171848
Colombia,2022-06-14,35175528,35175528,0,https://infogram.com/panorama-general-1h7z2lgn3l9l4ow?live,20802975,14372553,0,0,0.652940649228425,0,0,21003680,14171848
Colombia,2022-06-15,35175528,35175528,0,https://infogram.com/panorama-general-1h7z2lgn3l9l4ow?live,20802975,14372553,0,0,0.652940649228425,0,0,21003680,14171848
Colombia,2022-06-16,35304331,35304331,128803,https://infogram.com/panorama-general-1h7z2lgn3l9l4ow?live,20802975,14372553,0,0,0.652940649228425,44702,84101,21048382,14255949
Colombia,2022-06-17,35304331,35304331,0,https://infogram.com/panorama-general-1h7z2lgn3l9l4ow?live,20852042,14452289,49067,79736,0.6190539040239746,0,0,21048382,14255949
Colombia,2022-06-18,35304331,35304331,0,https://infogram.com/panorama-general-1h7z2lgn3l9l4ow?live,20852042,14452289,0,0,0.6190539040239746,0,0,21048382,14255949
Colombia,2022-06-19,35304331,35304331,0,https://infogram.com/panorama-general-1h7z2lgn3l9l4ow?live,20852042,14452289,0,0,0.6190539040239746,0,0,21048382,14255949
Colombia,2022-06-20,35304331,35304331,0,https://infogram.com/panorama-general-1h7z2lgn3l9l4ow?live,20852042,14452289,0,0,0.6190539040239746,0,0,21048382,14255949
Colombia,2022-06-21,35304331,35304331,0,https://infogram.com/panorama-general-1h7z2lgn3l9l4ow?live,20852042,14452289,0,0,0.6190539040239746,0,0,21048382,14255949
Colombia,2022-06-22,35304331,35304331,0,https://infogram.com/panorama-general-1h7z2lgn3l9l4ow?live,20852042,14452289,0,0,0.6190539040239746,0,0,21048382,14255949
Colombia,2022-06-23,35422380,35422380,118049,https://infogram.com/panorama-general-1h7z2lgn3l9l4ow?live,20852042,14452289,0,0,0.6190539040239746,44970,73079,21093352,14329028
Colombia,2022-06-24,35422380,35422380,0,https://infogram.com/panorama-general-1h7z2lgn3l9l4ow?live,20852042,14452289,0,0,0.6190539040239746,0,0,21093352,14329028
Colombia,2022-06-25,35422380,35422380,0,https://infogram.com/panorama-general-1h7z2lgn3l9l4ow?live,20899738,14522642,47696,70353,0.5959643876695271,0,0,21093352,14329028
Colombia,2022-06-26,35422380,35422380,0,https://infogram.com/panorama-general-1h7z2lgn3l9l4ow?live,20899738,14522642,0,0,0.5959643876695271,0,0,21093352,14329028
Colombia,2022-06-27,35422380,35422380,0,https://infogram.com/panorama-general-1h7z2lgn3l9l4ow?live,20899738,14522642,0,0,0.5959643876695271,0,0,21093352,14329028
Colombia,2022-06-28,35422380,35422380,0,https://infogram.com/panorama-general-1h7z2lgn3l9l4ow?live,20899738,14522642,0,0,0.5959643876695271,0,0,21093352,14329028
Colombia,2022-06-29,35422380,35422380,0,https://infogram.com/panorama-general-1h7z2lgn3l9l4ow?live,20899738,14522642,0,0,0.5959643876695271,0,0,21093352,14329028
Colombia,2022-06-30,35422380,35422380,0,https://infogram.com/panorama-general-1h7z2lgn3l9l4ow?live,20899738,14522642,0,0,0.5959643876695271,0,0,21093352,14329028
Colombia,2022-07-01,35422380,35422380,0,https://infogram.com/panorama-general-1h7z2lgn3l9l4ow?live,20899738,14522642,0,0,0.5959643876695271,0,0,21093352,14329028
Colombia,2022-07-02,35422380,35422380,0,https://infogram.com/panorama-general-1h7z2lgn3l9l4ow?live,20899738,14522642,0,0,0.5959643876695271,0,0,21093352,14329028
Colombia,2022-07-03,35422380,35422380,0,https://infogram.com/panorama-general-1h7z2lgn3l9l4ow?live,20899738,14522642,0,0,0.5959643876695271,0,0,21093352,14329028
Colombia,2022-07-04,35422380,35422380,0,https://infogram.com/panorama-general-1h7z2lgn3l9l4ow?live,20899738,14522642,0,0,0.5959643876695271,0,0,21093352,14329028
Colombia,2022-07-05,35422380,35422380,0,https://infogram.com/panorama-general-1h7z2lgn3l9l4ow?live,20899738,14522642,0,0,0.5959643876695271,0,0,21093352,14329028
Colombia,2022-07-06,35422380,35422380,0,https://infogram.com/panorama-general-1h7z2lgn3l9l4ow?live,20899738,14522642,0,0,0.5959643876695271,0,0,21093352,14329028
Colombia,2022-07-07,35662857,35662857,240477,https://infogram.com/panorama-general-1h7z2lgn3l9l4ow?live,21014070,14648787,114332,126145,0.5245616004857013,114332,126145,21207684,14455173
Colombia,2022-07-08,35662857,35662857,0,https://infogram.com/panorama-general-1h7z2lgn3l9l4ow?live,21014070,14648787,0,0,0.5245616004857013,0,0,21207684,14455173
Colombia,2022-07-09,35662857,35662857,0,https://infogram.com/panorama-general-1h7z2lgn3l9l4ow?live,21014070,14648787,0,0,0.5245616004857013,0,0,21207684,14455173
Colombia,2022-07-10,35662857,35662857,0,https://infogram.com/panorama-general-1h7z2lgn3l9l4ow?live,21014070,14648787,0,0,0.5245616004857013,0,0,21207684,14455173
Colombia,2022-07-11,35662857,35662857,0,https://infogram.com/panorama-general-1h7z2lgn3l9l4ow?live,21014070,14648787,0,0,0.5245616004857013,0,0,21207684,14455173
Colombia,2022-07-12,35662857,35662857,0,https://infogram.com/panorama-general-1h7z2lgn3l9l4ow?live,21014070,14648787,0,0,0.5245616004857013,0,0,21207684,14455173
Colombia,2022-07-13,35662857,35662857,0,https://infogram.com/panorama-general-1h7z2lgn3l9l4ow?live,21014070,14648787,0,0,0.5245616004857013,0,0,21207684,14455173
Colombia,2022-07-14,35781769,35781769,118912,https://infogram.com/panorama-general-1h7z2lgn3l9l4ow?live,21014070,14648787,0,0,0.5245616004857013,56535,62377,21264219,14517550
Colombia,2022-07-15,35781769,35781769,0,https://infogram.com/panorama-general-1h7z2lgn3l9l4ow?live,21060547,14721222,46477,72435,0.6091479413347686,0,0,21264219,14517550
Colombia,2022-07-16,35781769,35781769,0,https://infogram.com/panorama-general-1h7z2lgn3l9l4ow?live,21060547,14721222,0,0,0.6091479413347686,0,0,21264219,14517550
Colombia,2022-07-17,35781769,35781769,0,https://infogram.com/panorama-general-1h7z2lgn3l9l4ow?live,21060547,14721222,0,0,0.6091479413347686,0,0,21264219,14517550
Colombia,2022-07-18,35781769,35781769,0,https://infogram.com/panorama-general-1h7z2lgn3l9l4ow?live,21060547,14721222,0,0,0.6091479413347686,0,0,21264219,14517550
Colombia,2022-07-19,35781769,35781769,0,https://infogram.com/panorama-general-1h7z2lgn3l9l4ow?live,21060547,14721222,0,0,0.6091479413347686,0,0,21264219,14517550
Colombia,2022-07-20,35781769,35781769,0,https://infogram.com/panorama-general-1h7z2lgn3l9l4ow?live,21060547,14721222,0,0,0.6091479413347686,0,0,21264219,14517550
Colombia,2022-07-21,35889624,35889624,107855,https://infogram.com/panorama-general-1h7z2lgn3l9l4ow?live,21103816,14785808,43269,64586,0.5988224931621158,43269,64586,21307488,14582136
Colombia,2022-07-22,35889624,35889624,0,https://infogram.com/panorama-general-1h7z2lgn3l9l4ow?live,21103816,14785808,0,0,0.5988224931621158,0,0,21307488,14582136
Colombia,2022-07-23,35889624,35889624,0,https://infogram.com/panorama-general-1h7z2lgn3l9l4ow?live,21103816,14785808,0,0,0.5988224931621158,0,0,21307488,14582136
Colombia,2022-07-24,35889624,35889624,0,https://infogram.com/panorama-general-1h7z2lgn3l9l4ow?live,21103816,14785808,0,0,0.5988224931621158,0,0,21307488,14582136
Colombia,2022-07-25,35889624,35889624,0,https://infogram.com/panorama-general-1h7z2lgn3l9l4ow?live,21103816,14785808,0,0,0.5988224931621158,0,0,21307488,14582136
Colombia,2022-07-26,35889624,35889624,0,https://infogram.com/panorama-general-1h7z2lgn3l9l4ow?live,21103816,14785808,0,0,0.5988224931621158,0,0,21307488,14582136
Colombia,2022-07-27,35889624,35889624,0,https://infogram.com/panorama-general-1h7z2lgn3l9l4ow?live,21103816,14785808,0,0,0.5988224931621158,0,0,21307488,14582136
Colombia,2022-07-28,35889624,35889624,0,https://infogram.com/panorama-general-1h7z2lgn3l9l4ow?live,21103816,14785808,0,0,0.5988224931621158,0,0,21307488,14582136
Colombia,2022-07-29,35889624,35889624,0,https://infogram.com/panorama-general-1h7z2lgn3l9l4ow?live,21103816,14785808,0,0,0.5988224931621158,0,0,21307488,14582136
Colombia,2022-07-30,35889624,35889624,0,https://infogram.com/panorama-general-1h7z2lgn3l9l4ow?live,21143701,14848346,39885,62538,0.6105855130195367,0,0,21307488,14582136
Colombia,2022-07-31,35992047,35992047,102423,https://infogram.com/panorama-general-1h7z2lgn3l9l4ow?live,21143701,14848346,0,0,0.6105855130195367,39885,62538,21347373,14644674
Colombia,2022-08-01,35992047,35992047,0,https://infogram.com/panorama-general-1h7z2lgn3l9l4ow?live,21143701,14848346,0,0,0.6105855130195367,0,0,21347373,14644674
Colombia,2022-08-02,35992047,35992047,0,https://infogram.com/panorama-general-1h7z2lgn3l9l4ow?live,21143701,14848346,0,0,0.6105855130195367,0,0,21347373,14644674
Colombia,2022-08-03,35992047,35992047,0,https://infogram.com/panorama-general-1h7z2lgn3l9l4ow?live,21143701,14848346,0,0,0.6105855130195367,0,0,21347373,14644674
Colombia,2022-08-04,35992047,35992047,0,https://infogram.com/panorama-general-1h7z2lgn3l9l4ow?live,21143701,14848346,0,0,0.6105855130195367,0,0,21347373,14644674
Colombia,2022-08-05,36086570,36086570,94523,https://infogram.com/panorama-general-1h7z2lgn3l9l4ow?live,21182147,14904423,38446,56077,0.5932630153507612,38446,56077,21385819,14700751
Colombia,2022-08-06,36086570,36086570,0,https://infogram.com/panorama-general-1h7z2lgn3l9l4ow?live,21182147,14904423,0,0,0.5932630153507612,0,0,21385819,14700751
Colombia,2022-08-07,36086570,36086570,0,https://infogram.com/panorama-general-1h7z2lgn3l9l4ow?live,21182147,14904423,0,0,0.5932630153507612,0,0,21385819,14700751
Colombia,2022-08-08,36086570,36086570,0,https://infogram.com/panorama-general-1h7z2lgn3l9l4ow?live,21182147,14904423,0,0,0.5932630153507612,0,0,21385819,14700751
Colombia,2022-08-09,36086570,36086570,0,https://infogram.com/panorama-general-1h7z2lgn3l9l4ow?live,21182147,14904423,0,0,0.5932630153507612,0,0,21385819,14700751
Colombia,2022-08-10,36086570,36086570,0,https://infogram.com/panorama-general-1h7z2lgn3l9l4ow?live,21182147,14904423,0,0,0.5932630153507612,0,0,21385819,14700751
Colombia,2022-08-11,36086570,36086570,0,https://infogram.com/panorama-general-1h7z2lgn3l9l4ow?live,21182147,14904423,0,0,0.5932630153507612,0,0,21385819,14700751
Colombia,2022-08-12,36086570,36086570,0,https://infogram.com/panorama-general-1h7z2lgn3l9l4ow?live,21182147,14904423,0,0,0.5932630153507612,0,0,21385819,14700751
Colombia,2022-08-13,36086570,36086570,0,https://infogram.com/panorama-general-1h7z2lgn3l9l4ow?live,21214281,14950958,32134,46535,0.5915290648158741,0,0,21385819,14700751
Colombia,2022-08-14,36165239,36165239,78669,https://infogram.com/panorama-general-1h7z2lgn3l9l4ow?live,21214281,14950958,0,0,0.5915290648158741,32134,46535,21417953,14747286
Colombia,2022-08-15,36165239,36165239,0,https://infogram.com/panorama-general-1h7z2lgn3l9l4ow?live,21214281,14950958,0,0,0.5915290648158741,0,0,21417953,14747286
Colombia,2022-08-16,36165239,36165239,0,https://infogram.com/panorama-general-1h7z2lgn3l9l4ow?live,21214281,14950958,0,0,0.5915290648158741,0,0,21417953,14747286
Colombia,2022-08-17,36228532,36228532,63293,https://infogram.com/panorama-general-1h7z2lgn3l9l4ow?live,21214281,14950958,0,0,0.5915290648158741,25853,37440,21443806,14784726
Colombia,2022-08-18,36228532,36228532,0,https://infogram.com/panorama-general-1h7z2lgn3l9l4ow?live,21239332,14989200,25051,38242,0.6042058363484114,0,0,21443806,14784726
Colombia,2022-08-19,36228532,36228532,0,https://infogram.com/panorama-general-1h7z2lgn3l9l4ow?live,21239332,14989200,0,0,0.6042058363484114,0,0,21443806,14784726
Colombia,2022-08-20,36228532,36228532,0,https://infogram.com/panorama-general-1h7z2lgn3l9l4ow?live,21239332,14989200,0,0,0.6042058363484114,0,0,21443806,14784726
Colombia,2022-08-21,36228532,36228532,0,https://infogram.com/panorama-general-1h7z2lgn3l9l4ow?live,21239332,14989200,0,0,0.6042058363484114,0,0,21443806,14784726
Colombia,2022-08-22,36228532,36228532,0,https://infogram.com/panorama-general-1h7z2lgn3l9l4ow?live,21239332,14989200,0,0,0.6042058363484114,0,0,21443806,14784726
Colombia,2022-08-23,36228532,36228532,0,https://infogram.com/panorama-general-1h7z2lgn3l9l4ow?live,21239332,14989200,0,0,0.6042058363484114,0,0,21443806,14784726
Colombia,2022-08-24,36279188,36279188,50656,https://infogram.com/panorama-general-1h7z2lgn3l9l4ow?live,21239332,14989200,0,0,0.6042058363484114,20049,30607,21463855,14815333
Colombia,2022-08-25,36279188,36279188,0,https://infogram.com/panorama-general-1h7z2lgn3l9l4ow?live,21269565,15009623,30233,20423,0.40317040429564116,0,0,21463855,14815333
Colombia,2022-08-26,36279188,36279188,0,https://infogram.com/panorama-general-1h7z2lgn3l9l4ow?live,21269565,15009623,0,0,0.40317040429564116,0,0,21463855,14815333
Colombia,2022-08-27,36279188,36279188,0,https://infogram.com/panorama-general-1h7z2lgn3l9l4ow?live,21269565,15009623,0,0,0.40317040429564116,0,0,21463855,14815333
Colombia,2022-08-28,36279188,36279188,0,https://infogram.com/panorama-general-1h7z2lgn3l9l4ow?live,21269565,15009623,0,0,0.40317040429564116,0,0,21463855,14815333
Colombia,2022-08-29,36279188,36279188,0,https://infogram.com/panorama-general-1h7z2lgn3l9l4ow?live,21269565,15009623,0,0,0.40317040429564116,0,0,21463855,14815333
Colombia,2022-08-30,36279188,36279188,0,https://infogram.com/panorama-general-1h7z2lgn3l9l4ow?live,21269565,15009623,0,0,0.40317040429564116,0,0,21463855,14815333
Colombia,2022-08-31,36279188,36279188,0,https://infogram.com/panorama-general-1h7z2lgn3l9l4ow?live,21269565,15009623,0,0,0.40317040429564116,0,0,21463855,14815333
Colombia,2022-09-01,36279188,36279188,0,https://infogram.com/panorama-general-1h7z2lgn3l9l4ow?live,21269565,15009623,0,0,0.40317040429564116,0,0,21463855,14815333
Colombia,2022-09-02,36358694,36358694,79506,https://infogram.com/panorama-general-1h7z2lgn3l9l4ow?live,21293031,15065663,23466,56040,0.7048524639649838,23466,56040,21487321,14871373
Colombia,2022-09-03,36358694,36358694,0,https://infogram.com/panorama-general-1h7z2lgn3l9l4ow?live,21293031,15065663,0,0,0.7048524639649838,0,0,21487321,14871373
Colombia,2022-09-04,36358694,36358694,0,https://infogram.com/panorama-general-1h7z2lgn3l9l4ow?live,21293031,15065663,0,0,0.7048524639649838,0,0,21487321,14871373
Colombia,2022-09-05,36358694,36358694,0,https://infogram.com/panorama-general-1h7z2lgn3l9l4ow?live,21293031,15065663,0,0,0.7048524639649838,0,0,21487321,14871373
Colombia,2022-09-06,36358694,36358694,0,https://infogram.com/panorama-general-1h7z2lgn3l9l4ow?live,21293031,15065663,0,0,0.7048524639649838,0,0,21487321,14871373
Colombia,2022-09-07,36358694,36358694,0,https://infogram.com/panorama-general-1h7z2lgn3l9l4ow?live,21293031,15065663,0,0,0.7048524639649838,0,0,21487321,14871373
Colombia,2022-09-08,36358694,36358694,0,https://infogram.com/panorama-general-1h7z2lgn3l9l4ow?live,21293031,15065663,0,0,0.7048524639649838,0,0,21487321,14871373
Colombia,2022-09-09,36413329,36413329,54635,https://infogram.com/panorama-general-1h7z2lgn3l9l4ow?live,21315562,15097767,22531,32104,0.5876086757572985,22531,32104,21509852,14903477
Colombia,2022-09-10,36413329,36413329,0,https://infogram.com/panorama-general-1h7z2lgn3l9l4ow?live,21315562,15097767,0,0,0.5876086757572985,0,0,21509852,14903477
Colombia,2022-09-11,36413329,36413329,0,https://infogram.com/panorama-general-1h7z2lgn3l9l4ow?live,21315562,15097767,0,0,0.5876086757572985,0,0,21509852,14903477
Colombia,2022-09-12,36413329,36413329,0,https://infogram.com/panorama-general-1h7z2lgn3l9l4ow?live,21315562,15097767,0,0,0.5876086757572985,0,0,21509852,14903477
Colombia,2022-09-13,36413329,36413329,0,https://infogram.com/panorama-general-1h7z2lgn3l9l4ow?live,21315562,15097767,0,0,0.5876086757572985,0,0,21509852,14903477
Colombia,2022-09-14,36413329,36413329,0,https://infogram.com/panorama-general-1h7z2lgn3l9l4ow?live,21315562,15097767,0,0,0.5876086757572985,0,0,21509852,14903477
Colombia,2022-09-15,36413329,36413329,0,https://infogram.com/panorama-general-1h7z2lgn3l9l4ow?live,21315562,15097767,0,0,0.5876086757572985,0,0,21509852,14903477
Colombia,2022-09-16,36469553,36469553,56224,https://infogram.com/panorama-general-1h7z2lgn3l9l4ow?live,21335363,15134190,19801,36423,0.6478194365395561,19801,36423,21529653,14939900
Colombia,2022-09-17,36469553,36469553,0,https://infogram.com/panorama-general-1h7z2lgn3l9l4ow?live,21335363,15134190,0,0,0.6478194365395561,0,0,21529653,14939900
Colombia,2022-09-18,36469553,36469553,0,https://infogram.com/panorama-general-1h7z2lgn3l9l4ow?live,21335363,15134190,0,0,0.6478194365395561,0,0,21529653,14939900
Colombia,2022-09-19,36469553,36469553,0,https://infogram.com/panorama-general-1h7z2lgn3l9l4ow?live,21335363,15134190,0,0,0.6478194365395561,0,0,21529653,14939900
Colombia,2022-09-20,36469553,36469553,0,https://infogram.com/panorama-general-1h7z2lgn3l9l4ow?live,21335363,15134190,0,0,0.6478194365395561,0,0,21529653,14939900
Colombia,2022-09-21,36469553,36469553,0,https://infogram.com/panorama-general-1h7z2lgn3l9l4ow?live,21335363,15134190,0,0,0.6478194365395561,0,0,21529653,14939900
Colombia,2022-09-22,36469553,36469553,0,https://infogram.com/panorama-general-1h7z2lgn3l9l4ow?live,21335363,15134190,0,0,0.6478194365395561,0,0,21529653,14939900
Colombia,2022-09-23,36519532,36519532,49979,https://infogram.com/panorama-general-1h7z2lgn3l9l4ow?live,21335363,15134190,0,0,0.6478194365395561,17602,32377,21547255,14972277
Colombia,2022-09-24,36519532,36519532,0,https://infogram.com/panorama-general-1h7z2lgn3l9l4ow?live,21354810,15164722,19447,30532,0.6108965765621561,0,0,21547255,14972277
Colombia,2022-09-25,36519532,36519532,0,https://infogram.com/panorama-general-1h7z2lgn3l9l4ow?live,21354810,15164722,0,0,0.6108965765621561,0,0,21547255,14972277
Colombia,2022-09-26,36519532,36519532,0,https://infogram.com/panorama-general-1h7z2lgn3l9l4ow?live,21354810,15164722,0,0,0.6108965765621561,0,0,21547255,14972277
Colombia,2022-09-27,36519532,36519532,0,https://infogram.com/panorama-general-1h7z2lgn3l9l4ow?live,21354810,15164722,0,0,0.6108965765621561,0,0,21547255,14972277
Colombia,2022-09-28,36519532,36519532,0,https://infogram.com/panorama-general-1h7z2lgn3l9l4ow?live,21354810,15164722,0,0,0.6108965765621561,0,0,21547255,14972277
Colombia,2022-09-29,36572720,36572720,53188,https://infogram.com/panorama-general-1h7z2lgn3l9l4ow?live,21373282,15199438,18472,34716,0.6527036173572986,18472,34716,21565727,15006993
Colombia,2022-09-30,36572720,36572720,0,https://infogram.com/panorama-general-1h7z2lgn3l9l4ow?live,21373282,15199438,0,0,0.6527036173572986,0,0,21565727,15006993
Colombia,2022-10-01,36572720,36572720,0,https://infogram.com/panorama-general-1h7z2lgn3l9l4ow?live,21373282,15199438,0,0,0.6527036173572986,0,0,21565727,15006993
Colombia,2022-10-02,36572720,36572720,0,https://infogram.com/panorama-general-1h7z2lgn3l9l4ow?live,21373282,15199438,0,0,0.6527036173572986,0,0,21565727,15006993
Colombia,2022-10-03,36572720,36572720,0,https://infogram.com/panorama-general-1h7z2lgn3l9l4ow?live,21373282,15199438,0,0,0.6527036173572986,0,0,21565727,15006993
Colombia,2022-10-04,36572720,36572720,0,https://infogram.com/panorama-general-1h7z2lgn3l9l4ow?live,21373282,15199438,0,0,0.6527036173572986,0,0,21565727,15006993
Colombia,2022-10-05,36572720,36572720,0,https://infogram.com/panorama-general-1h7z2lgn3l9l4ow?live,21373282,15199438,0,0,0.6527036173572986,0,0,21565727,15006993
Colombia,2022-10-06,36572720,36572720,0,https://infogram.com/panorama-general-1h7z2lgn3l9l4ow?live,21373282,15199438,0,0,0.6527036173572986,0,0,21565727,15006993
Colombia,2022-10-07,36615681,36615681,42961,https://infogram.com/panorama-general-1h7z2lgn3l9l4ow?live,21389054,15226627,15772,27189,0.632876329694374,15772,27189,21581499,15034182
Colombia,2022-10-08,36615681,36615681,0,https://infogram.com/panorama-general-1h7z2lgn3l9l4ow?live,21389054,15226627,0,0,0.632876329694374,0,0,21581499,15034182
Colombia,2022-10-09,36615681,36615681,0,https://infogram.com/panorama-general-1h7z2lgn3l9l4ow?live,21389054,15226627,0,0,0.632876329694374,0,0,21581499,15034182
Colombia,2022-10-10,36615681,36615681,0,https://infogram.com/panorama-general-1h7z2lgn3l9l4ow?live,21389054,15226627,0,0,0.632876329694374,0,0,21581499,15034182
Colombia,2022-10-11,36615681,36615681,0,https://infogram.com/panorama-general-1h7z2lgn3l9l4ow?live,21389054,15226627,0,0,0.632876329694374,0,0,21581499,15034182
Colombia,2022-10-12,36615681,36615681,0,https://infogram.com/panorama-general-1h7z2lgn3l9l4ow?live,21389054,15226627,0,0,0.632876329694374,0,0,21581499,15034182
Colombia,2022-10-13,36654229,36654229,38548,https://infogram.com/panorama-general-1h7z2lgn3l9l4ow?live,21403853,15250376,14799,23749,0.6160890318563869,14799,23749,21596298,15057931
Colombia,2022-10-14,36654229,36654229,0,https://infogram.com/panorama-general-1h7z2lgn3l9l4ow?live,21403853,15250376,0,0,0.6160890318563869,0,0,21596298,15057931
Colombia,2022-10-15,36654229,36654229,0,https://infogram.com/panorama-general-1h7z2lgn3l9l4ow?live,21403853,15250376,0,0,0.6160890318563869,0,0,21596298,15057931
Colombia,2022-10-16,36654229,36654229,0,https://infogram.com/panorama-general-1h7z2lgn3l9l4ow?live,21403853,15250376,0,0,0.6160890318563869,0,0,21596298,15057931
Colombia,2022-10-17,36654229,36654229,0,https://infogram.com/panorama-general-1h7z2lgn3l9l4ow?live,21403853,15250376,0,0,0.6160890318563869,0,0,21596298,15057931
Colombia,2022-10-18,36654229,36654229,0,https://infogram.com/panorama-general-1h7z2lgn3l9l4ow?live,21403853,15250376,0,0,0.6160890318563869,0,0,21596298,15057931
Colombia,2022-10-19,36654229,36654229,0,https://infogram.com/panorama-general-1h7z2lgn3l9l4ow?live,21403853,15250376,0,0,0.6160890318563869,0,0,21596298,15057931
Colombia,2022-10-20,36654229,36654229,0,https://infogram.com/panorama-general-1h7z2lgn3l9l4ow?live,21403853,15250376,0,0,0.6160890318563869,0,0,21596298,15057931
Colombia,2022-10-21,36654229,36654229,0,https://infogram.com/panorama-general-1h7z2lgn3l9l4ow?live,21403853,15250376,0,0,0.6160890318563869,0,0,21596298,15057931
Colombia,2022-10-22,36654229,36654229,0,https://infogram.com/panorama-general-1h7z2lgn3l9l4ow?live,21403853,15250376,0,0,0.6160890318563869,0,0,21596298,15057931
Colombia,2022-10-23,36654229,36654229,0,https://infogram.com/panorama-general-1h7z2lgn3l9l4ow?live,21403853,15250376,0,0,0.6160890318563869,0,0,21596298,15057931
Colombia,2022-10-24,36654229,36654229,0,https://infogram.com/panorama-general-1h7z2lgn3l9l4ow?live,21403853,15250376,0,0,0.6160890318563869,0,0,21596298,15057931
Colombia,2022-10-25,36654229,36654229,0,https://infogram.com/panorama-general-1h7z2lgn3l9l4ow?live,21403853,15250376,0,0,0.6160890318563869,0,0,21596298,15057931
Colombia,2022-10-26,36654229,36654229,0,https://infogram.com/panorama-general-1h7z2lgn3l9l4ow?live,21403853,15250376,0,0,0.6160890318563869,0,0,21596298,15057931
Colombia,2022-10-27,36724183,36724183,69954,https://infogram.com/panorama-general-1h7z2lgn3l9l4ow?live,21430806,15293377,26953,43001,0.6147039483088887,26953,43001,21623251,15100932
Colombia,2022-10-28,36724183,36724183,0,https://infogram.com/panorama-general-1h7z2lgn3l9l4ow?live,21430806,15293377,0,0,0.6147039483088887,0,0,21623251,15100932
Colombia,2022-10-29,36724183,36724183,0,https://infogram.com/panorama-general-1h7z2lgn3l9l4ow?live,21430806,15293377,0,0,0.6147039483088887,0,0,21623251,15100932
Colombia,2022-10-30,36724183,36724183,0,https://infogram.com/panorama-general-1h7z2lgn3l9l4ow?live,21430806,15293377,0,0,0.6147039483088887,0,0,21623251,15100932
Colombia,2022-10-31,36724183,36724183,0,https://infogram.com/panorama-general-1h7z2lgn3l9l4ow?live,21430806,15293377,0,0,0.6147039483088887,0,0,21623251,15100932
Colombia,2022-11-01,36724183,36724183,0,https://infogram.com/panorama-general-1h7z2lgn3l9l4ow?live,21430806,15293377,0,0,0.6147039483088887,0,0,21623251,15100932
Colombia,2022-11-02,36724183,36724183,0,https://infogram.com/panorama-general-1h7z2lgn3l9l4ow?live,21430806,15293377,0,0,0.6147039483088887,0,0,21623251,15100932
Colombia,2022-11-03,36760659,36760659,36476,https://infogram.com/panorama-general-1h7z2lgn3l9l4ow?live,21446833,15313826,16027,20449,0.5606151990349819,16027,20449,21639278,15121381
Colombia,2022-11-04,36760659,36760659,0,https://infogram.com/panorama-general-1h7z2lgn3l9l4ow?live,21446833,15313826,0,0,0.5606151990349819,0,0,21639278,15121381
Colombia,2022-11-05,36760659,36760659,0,https://infogram.com/panorama-general-1h7z2lgn3l9l4ow?live,21446833,15313826,0,0,0.5606151990349819,0,0,21639278,15121381
Colombia,2022-11-06,36760659,36760659,0,https://infogram.com/panorama-general-1h7z2lgn3l9l4ow?live,21446833,15313826,0,0,0.5606151990349819,0,0,21639278,15121381
Colombia,2022-11-07,36760659,36760659,0,https://infogram.com/panorama-general-1h7z2lgn3l9l4ow?live,21446833,15313826,0,0,0.5606151990349819,0,0,21639278,15121381
Colombia,2022-11-08,36760659,36760659,0,https://infogram.com/panorama-general-1h7z2lgn3l9l4ow?live,21446833,15313826,0,0,0.5606151990349819,0,0,21639278,15121381
Colombia,2022-11-09,36760659,36760659,0,https://infogram.com/panorama-general-1h7z2lgn3l9l4ow?live,21446833,15313826,0,0,0.5606151990349819,0,0,21639278,15121381
Colombia,2022-11-10,36791759,36791759,31100,https://infogram.com/panorama-general-1h7z2lgn3l9l4ow?live,21460301,15331458,13468,17632,0.5669453376205787,13468,17632,21652746,15139013
Colombia,2022-11-11,36791759,36791759,0,https://infogram.com/panorama-general-1h7z2lgn3l9l4ow?live,21460301,15331458,0,0,0.5669453376205787,0,0,21652746,15139013
Colombia,2022-11-12,36791759,36791759,0,https://infogram.com/panorama-general-1h7z2lgn3l9l4ow?live,21460301,15331458,0,0,0.5669453376205787,0,0,21652746,15139013
Colombia,2022-11-13,36791759,36791759,0,https://infogram.com/panorama-general-1h7z2lgn3l9l4ow?live,21460301,15331458,0,0,0.5669453376205787,0,0,21652746,15139013
Colombia,2022-11-14,36791759,36791759,0,https://infogram.com/panorama-general-1h7z2lgn3l9l4ow?live,21460301,15331458,0,0,0.5669453376205787,0,0,21652746,15139013
Colombia,2022-11-15,36791759,36791759,0,https://infogram.com/panorama-general-1h7z2lgn3l9l4ow?live,21460301,15331458,0,0,0.5669453376205787,0,0,21652746,15139013
Colombia,2022-11-16,36791759,36791759,0,https://infogram.com/panorama-general-1h7z2lgn3l9l4ow?live,21460301,15331458,0,0,0.5669453376205787,0,0,21652746,15139013
Colombia,2022-11-17,36831583,36831583,39824,https://infogram.com/panorama-general-1h7z2lgn3l9l4ow?live,21473464,15358119,13163,26661,0.6694706709521896,13163,26661,21665909,15165674
Colombia,2022-11-18,36831583,36831583,0,https://infogram.com/panorama-general-1h7z2lgn3l9l4ow?live,21473464,15358119,0,0,0.6694706709521896,0,0,21665909,15165674
Colombia,2022-11-19,36831583,36831583,0,https://infogram.com/panorama-general-1h7z2lgn3l9l4ow?live,21473464,15358119,0,0,0.6694706709521896,0,0,21665909,15165674
Colombia,2022-11-20,36831583,36831583,0,https://infogram.com/panorama-general-1h7z2lgn3l9l4ow?live,21473464,15358119,0,0,0.6694706709521896,0,0,21665909,15165674
Colombia,2022-11-21,36831583,36831583,0,https://infogram.com/panorama-general-1h7z2lgn3l9l4ow?live,21473464,15358119,0,0,0.6694706709521896,0,0,21665909,15165674
Colombia,2022-11-22,36831583,36831583,0,https://infogram.com/panorama-general-1h7z2lgn3l9l4ow?live,21473464,15358119,0,0,0.6694706709521896,0,0,21665909,15165674
Colombia,2022-11-23,36831583,36831583,0,https://infogram.com/panorama-general-1h7z2lgn3l9l4ow?live,21473464,15358119,0,0,0.6694706709521896,0,0,21665909,15165674
Colombia,2022-11-24,36831583,36831583,0,https://infogram.com/panorama-general-1h7z2lgn3l9l4ow?live,21473464,15358119,0,0,0.6694706709521896,0,0,21665909,15165674
Colombia,2022-11-25,36858057,36858057,26474,https://infogram.com/panorama-general-1h7z2lgn3l9l4ow?live,21473464,15384593,0,26474,1,0,26474,21665909,15192148
Colombia,2022-11-26,36858057,36858057,0,https://infogram.com/panorama-general-1h7z2lgn3l9l4ow?live,21473464,15384593,0,0,1,0,0,21665909,15192148
Colombia,2022-11-27,36858057,36858057,0,https://infogram.com/panorama-general-1h7z2lgn3l9l4ow?live,21473464,15384593,0,0,1,0,0,21665909,15192148
Colombia,2022-11-28,36858057,36858057,0,https://infogram.com/panorama-general-1h7z2lgn3l9l4ow?live,21473464,15384593,0,0,1,0,0,21665909,15192148
Colombia,2022-11-29,36874914,36874914,16857,https://infogram.com/panorama-general-1h7z2lgn3l9l4ow?live,21490321,15384593,16857,0,0,16857,0,21682766,15192148
Colombia,2022-11-30,36874914,36874914,0,https://infogram.com/panorama-general-1h7z2lgn3l9l4ow?live,21490321,15384593,0,0,0,0,0,21682766,15192148
Colombia,2022-12-01,36874914,36874914,0,https://infogram.com/panorama-general-1h7z2lgn3l9l4ow?live,21490321,15384593,0,0,0,0,0,21682766,15192148
Colombia,2022-12-02,36895418,36895418,20504,https://infogram.com/panorama-general-1h7z2lgn3l9l4ow?live,21490321,15405097,0,20504,1,0,20504,21682766,15212652
Colombia,2022-12-03,36895418,36895418,0,https://infogram.com/panorama-general-1h7z2lgn3l9l4ow?live,21490321,15405097,0,0,1,0,0,21682766,15212652
Colombia,2022-12-04,36895418,36895418,0,https://infogram.com/panorama-general-1h7z2lgn3l9l4ow?live,21490321,15405097,0,0,1,0,0,21682766,15212652
Colombia,2022-12-05,36895418,36895418,0,https://infogram.com/panorama-general-1h7z2lgn3l9l4ow?live,21490321,15405097,0,0,1,0,0,21682766,15212652
Colombia,2022-12-06,36895418,36895418,0,https://infogram.com/panorama-general-1h7z2lgn3l9l4ow?live,21490321,15405097,0,0,1,0,0,21682766,15212652
Colombia,2022-12-07,36895418,36895418,0,https://infogram.com/panorama-general-1h7z2lgn3l9l4ow?live,21490321,15405097,0,0,1,0,0,21682766,15212652
Colombia,2022-12-08,36934671,36934671,39253,https://infogram.com/panorama-general-1h7z2lgn3l9l4ow?live,21490321,15444350,0,39253,1,0,39253,21682766,15251905
Colombia,2022-12-09,36934671,36934671,0,https://infogram.com/panorama-general-1h7z2lgn3l9l4ow?live,21490321,15444350,0,0,1,0,0,21682766,15251905
Colombia,2022-12-10,36934671,36934671,0,https://infogram.com/panorama-general-1h7z2lgn3l9l4ow?live,21490321,15444350,0,0,1,0,0,21682766,15251905
Colombia,2022-12-11,36934671,36934671,0,https://infogram.com/panorama-general-1h7z2lgn3l9l4ow?live,21490321,15444350,0,0,1,0,0,21682766,15251905
Colombia,2022-12-12,36934671,36934671,0,https://infogram.com/panorama-general-1h7z2lgn3l9l4ow?live,21490321,15444350,0,0,1,0,0,21682766,15251905
Colombia,2022-12-13,36987412,36987412,52741,https://infogram.com/panorama-general-1h7z2lgn3l9l4ow?live,21490321,15444350,0,0,1,0,52741,21682766,15304646
Colombia,2022-12-14,36987412,36987412,0,https://infogram.com/panorama-general-1h7z2lgn3l9l4ow?live,21490321,15444350,0,0,1,0,0,21682766,15304646
Colombia,2022-12-15,36987412,36987412,0,https://infogram.com/panorama-general-1h7z2lgn3l9l4ow?live,21490321,15444350,0,0,1,0,0,21682766,15304646
Colombia,2022-12-16,36987412,36987412,0,https://infogram.com/panorama-general-1h7z2lgn3l9l4ow?live,21490321,15444350,0,0,1,0,0,21682766,15304646
Colombia,2022-12-17,36987412,36987412,0,https://infogram.com/panorama-general-1h7z2lgn3l9l4ow?live,21490321,15444350,0,0,1,0,0,21682766,15304646
Colombia,2022-12-18,36987412,36987412,0,https://infogram.com/panorama-general-1h7z2lgn3l9l4ow?live,21490321,15444350,0,0,1,0,0,21682766,15304646
Colombia,2022-12-19,36987412,36987412,0,https://infogram.com/panorama-general-1h7z2lgn3l9l4ow?live,21490321,15444350,0,0,1,0,0,21682766,15304646
Colombia,2022-12-20,36987412,36987412,0,https://infogram.com/panorama-general-1h7z2lgn3l9l4ow?live,21490321,15444350,0,0,1,0,0,21682766,15304646
Colombia,2022-12-21,36987412,36987412,0,https://infogram.com/panorama-general-1h7z2lgn3l9l4ow?live,21490321,15444350,0,0,1,0,0,21682766,15304646
Colombia,2022-12-22,36987412,36987412,0,https://infogram.com/panorama-general-1h7z2lgn3l9l4ow?live,21490321,15444350,0,0,1,0,0,21682766,15304646
Colombia,2022-12-23,36987412,36987412,0,https://infogram.com/panorama-general-1h7z2lgn3l9l4ow?live,21490321,15444350,0,0,1,0,0,21682766,15304646
Colombia,2022-12-24,36987412,36987412,0,https://infogram.com/panorama-general-1h7z2lgn3l9l4ow?live,21490321,15444350,0,0,1,0,0,21682766,15304646
Colombia,2022-12-25,36987412,36987412,0,https://infogram.com/panorama-general-1h7z2lgn3l9l4ow?live,21490321,15444350,0,0,1,0,0,21682766,15304646
Colombia,2022-12-26,36987412,36987412,0,https://infogram.com/panorama-general-1h7z2lgn3l9l4ow?live,21490321,15444350,0,0,1,0,0,21682766,15304646
Colombia,2022-12-27,36987412,36987412,0,https://infogram.com/panorama-general-1h7z2lgn3l9l4ow?live,21490321,15444350,0,0,1,0,0,21682766,15304646
Colombia,2022-12-28,36987412,36987412,0,https://infogram.com/panorama-general-1h7z2lgn3l9l4ow?live,21490321,15444350,0,0,1,0,0,21682766,15304646
Colombia,2022-12-29,36987412,36987412,0,https://infogram.com/panorama-general-1h7z2lgn3l9l4ow?live,21490321,15444350,0,0,1,0,0,21682766,15304646
Colombia,2022-12-30,36987412,36987412,0,https://infogram.com/panorama-general-1h7z2lgn3l9l4ow?live,21490321,15444350,0,0,1,0,0,21682766,15304646
Colombia,2022-12-31,36987412,36987412,0,https://infogram.com/panorama-general-1h7z2lgn3l9l4ow?live,21490321,15444350,0,0,1,0,0,21682766,15304646
Colombia,2023-01-01,36987412,36987412,0,https://infogram.com/panorama-general-1h7z2lgn3l9l4ow?live,21490321,15444350,0,0,1,0,0,21682766,15304646
Colombia,2023-01-02,36987412,36987412,0,https://infogram.com/panorama-general-1h7z2lgn3l9l4ow?live,21490321,15444350,0,0,1,0,0,21682766,15304646
Colombia,2023-01-03,36987412,36987412,0,https://infogram.com/panorama-general-1h7z2lgn3l9l4ow?live,21490321,15444350,0,0,1,0,0,21682766,15304646
Colombia,2023-01-04,36987412,36987412,0,https://infogram.com/panorama-general-1h7z2lgn3l9l4ow?live,21490321,15444350,0,0,1,0,0,21682766,15304646
Colombia,2023-01-05,36987412,36987412,0,https://infogram.com/panorama-general-1h7z2lgn3l9l4ow?live,21490321,15444350,0,0,1,0,0,21682766,15304646
Colombia,2023-01-06,36987412,36987412,0,https://infogram.com/panorama-general-1h7z2lgn3l9l4ow?live,21490321,15444350,0,0,1,0,0,21682766,15304646
Colombia,2023-01-07,36987412,36987412,0,https://infogram.com/panorama-general-1h7z2lgn3l9l4ow?live,21490321,15444350,0,0,1,0,0,21682766,15304646
Colombia,2023-01-08,36987412,36987412,0,https://infogram.com/panorama-general-1h7z2lgn3l9l4ow?live,21490321,15444350,0,0,1,0,0,21682766,15304646
Colombia,2023-01-09,36987412,36987412,0,https://infogram.com/panorama-general-1h7z2lgn3l9l4ow?live,21490321,15444350,0,0,1,0,0,21682766,15304646
Colombia,2023-01-10,36987412,36987412,0,https://infogram.com/panorama-general-1h7z2lgn3l9l4ow?live,21490321,15444350,0,0,1,0,0,21682766,15304646
Colombia,2023-01-11,36987412,36987412,0,https://infogram.com/panorama-general-1h7z2lgn3l9l4ow?live,21490321,15444350,0,0,1,0,0,21682766,15304646
Colombia,2023-01-12,36987412,36987412,0,https://infogram.com/panorama-general-1h7z2lgn3l9l4ow?live,21490321,15444350,0,0,1,0,0,21682766,15304646
Colombia,2023-01-13,36987412,36987412,0,https://infogram.com/panorama-general-1h7z2lgn3l9l4ow?live,21490321,15444350,0,0,1,0,0,21682766,15304646
Colombia,2023-01-14,36987412,36987412,0,https://infogram.com/panorama-general-1h7z2lgn3l9l4ow?live,21490321,15444350,0,0,1,0,0,21682766,15304646
Colombia,2023-01-15,36987412,36987412,0,https://infogram.com/panorama-general-1h7z2lgn3l9l4ow?live,21490321,15444350,0,0,1,0,0,21682766,15304646
Colombia,2023-01-16,36987412,36987412,0,https://infogram.com/panorama-general-1h7z2lgn3l9l4ow?live,21490321,15444350,0,0,1,0,0,21682766,15304646
Colombia,2023-01-17,36987412,36987412,0,https://infogram.com/panorama-general-1h7z2lgn3l9l4ow?live,21490321,15444350,0,0,1,0,0,21682766,15304646
Colombia,2023-01-18,36987412,36987412,0,https://infogram.com/panorama-general-1h7z2lgn3l9l4ow?live,21490321,15444350,0,0,1,0,0,21682766,15304646
Colombia,2023-01-19,37017104,37017104,29692,https://infogram.com/panorama-general-1h7z2lgn3l9l4ow?live,21490321,15444350,0,0,1,0,29692,21682766,15334338
Colombia,2023-01-20,37017104,37017104,0,https://infogram.com/panorama-general-1h7z2lgn3l9l4ow?live,21490321,15444350,0,0,1,0,0,21682766,15334338
Colombia,2023-01-21,37017104,37017104,0,https://infogram.com/panorama-general-1h7z2lgn3l9l4ow?live,21490321,15444350,0,0,1,0,0,21682766,15334338
Colombia,2023-01-22,37017104,37017104,0,https://infogram.com/panorama-general-1h7z2lgn3l9l4ow?live,21490321,15444350,0,0,1,0,0,21682766,15334338
Colombia,2023-01-23,37017104,37017104,0,https://infogram.com/panorama-general-1h7z2lgn3l9l4ow?live,21490321,15444350,0,0,1,0,0,21682766,15334338
Colombia,2023-01-24,37017104,37017104,0,https://infogram.com/panorama-general-1h7z2lgn3l9l4ow?live,21490321,15444350,0,0,1,0,0,21682766,15334338
Colombia,2023-01-25,37017104,37017104,0,https://infogram.com/panorama-general-1h7z2lgn3l9l4ow?live,21490321,15444350,0,0,1,0,0,21682766,15334338
Colombia,2023-01-26,37017104,37017104,0,https://infogram.com/panorama-general-1h7z2lgn3l9l4ow?live,21625481,15636347,135160,191997,0.586865021992499,0,0,21682766,15334338
Colombia,2023-01-27,37017104,37017104,0,https://infogram.com/panorama-general-1h7z2lgn3l9l4ow?live,21625481,15636347,0,0,0.586865021992499,0,0,21682766,15334338
Colombia,2023-01-28,37017104,37017104,0,https://infogram.com/panorama-general-1h7z2lgn3l9l4ow?live,21625481,15636347,0,0,0.586865021992499,0,0,21682766,15334338
Colombia,2023-01-29,37261828,37261828,244724,https://infogram.com/panorama-general-1h7z2lgn3l9l4ow?live,21625481,15636347,0,0,0.586865021992499,101104,143620,21783870,15477958
Colombia,2023-01-30,37261828,37261828,0,https://infogram.com/panorama-general-1h7z2lgn3l9l4ow?live,21625481,15636347,0,0,0.586865021992499,0,0,21783870,15477958
Colombia,2023-01-31,37261828,37261828,0,https://infogram.com/panorama-general-1h7z2lgn3l9l4ow?live,21625481,15636347,0,0,0.586865021992499,0,0,21783870,15477958
Colombia,2023-02-01,37261828,37261828,0,https://infogram.com/panorama-general-1h7z2lgn3l9l4ow?live,21625481,15636347,0,0,0.586865021992499,0,0,21783870,15477958
Colombia,2023-02-02,37289716,37289716,27888,https://infogram.com/panorama-general-1h7z2lgn3l9l4ow?live,21490321,15653023,-135160,16676,0.586865021992499,11522,16366,21795392,15494324
Colombia,2023-02-03,37289716,37289716,0,https://infogram.com/panorama-general-1h7z2lgn3l9l4ow?live,21490321,15653023,0,0,0.586865021992499,0,0,21795392,15494324
Colombia,2023-02-04,37289716,37289716,0,https://infogram.com/panorama-general-1h7z2lgn3l9l4ow?live,21490321,15653023,0,0,0.586865021992499,0,0,21795392,15494324
Colombia,2023-02-05,37289716,37289716,0,https://infogram.com/panorama-general-1h7z2lgn3l9l4ow?live,21490321,15653023,0,0,0.586865021992499,0,0,21795392,15494324
Colombia,2023-02-06,37289716,37289716,0,https://infogram.com/panorama-general-1h7z2lgn3l9l4ow?live,21490321,15653023,0,0,0.586865021992499,0,0,21795392,15494324
Colombia,2023-02-07,37289716,37289716,0,https://infogram.com/panorama-general-1h7z2lgn3l9l4ow?live,21490321,15653023,0,0,0.586865021992499,0,0,21795392,15494324
Colombia,2023-02-08,37289716,37289716,0,https://infogram.com/panorama-general-1h7z2lgn3l9l4ow?live,21648681,15669030,158360,16007,0.09180062741229705,0,0,21795392,15494324
Colombia,2023-02-09,37317711,37317711,27995,https://infogram.com/panorama-general-1h7z2lgn3l9l4ow?live,21648681,15669030,0,0,0.09180062741229705,25425,2570,21820817,15496894
Colombia,2023-02-10,37317711,37317711,0,https://infogram.com/panorama-general-1h7z2lgn3l9l4ow?live,21648681,15669030,0,0,0.09180062741229705,0,0,21820817,15496894
Colombia,2023-02-11,37317711,37317711,0,https://infogram.com/panorama-general-1h7z2lgn3l9l4ow?live,21648681,15669030,0,0,0.09180062741229705,0,0,21820817,15496894
Colombia,2023-02-12,37317711,37317711,0,https://infogram.com/panorama-general-1h7z2lgn3l9l4ow?live,21648681,15669030,0,0,0.09180062741229705,0,0,21820817,15496894
Colombia,2023-02-13,37317711,37317711,0,https://infogram.com/panorama-general-1h7z2lgn3l9l4ow?live,21648681,15669030,0,0,0.09180062741229705,0,0,21820817,15496894
Colombia,2023-02-14,37317711,37317711,0,https://infogram.com/panorama-general-1h7z2lgn3l9l4ow?live,21648681,15669030,0,0,0.09180062741229705,0,0,21820817,15496894
Denmark,2021-05-28,54031318,54031318,680387,https://www.sst.dk/en/english/corona-eng/status-of-the-epidemic/covid-19-updates-statistics-and-charts,32494298,21537020,149048,531339,0.7809364376450462,149048,531339,32494298,21537020
Denmark,2021-05-29,54031318,54031318,0,https://www.sst.dk/en/english/corona-eng/status-of-the-epidemic/covid-19-updates-statistics-and-charts,32494298,21537020,0,0,0.7809364376450462,0,0,32494298,21537020
Denmark,2021-05-30,54031318,54031318,0,https://www.sst.dk/en/english/corona-eng/status-of-the-epidemic/covid-19-updates-statistics-and-charts,32494298,21537020,0,0,0.7809364376450462,0,0,32494298,21537020
Denmark,2021-05-31,55581321,55581321,1550003,https://www.sst.dk/en/english/corona-eng/status-of-the-epidemic/covid-19-updates-statistics-and-charts,32952067,22629254,457769,1092234,0.7046657329050331,457769,1092234,32952067,22629254
Denmark,2021-06-01,56243424,56243424,662103,https://www.sst.dk/en/english/corona-eng/status-of-the-epidemic/covid-19-updates-statistics-and-charts,33083579,23159845,131512,530591,0.8013722940388429,131512,530591,33083579,23159845
Denmark,2021-06-02,56790923,56790923,547499,https://www.sst.dk/en/english/corona-eng/status-of-the-epidemic/covid-19-updates-statistics-and-charts,33218652,23572271,135073,412426,0.7532908735906367,135073,412426,33218652,23572271
Denmark,2021-06-03,57304092,57304092,513169,https://www.sst.dk/en/english/corona-eng/status-of-the-epidemic/covid-19-updates-statistics-and-charts,33345460,23958632,126808,386361,0.7528923220225696,126808,386361,33345460,23958632
Denmark,2021-06-04,57966838,57966838,662746,https://www.sst.dk/en/english/corona-eng/status-of-the-epidemic/covid-19-updates-statistics-and-charts,33506621,24460217,161161,501585,0.7568284078666638,161161,501585,33506621,24460217
Denmark,2021-06-05,57966838,57966838,0,https://www.sst.dk/en/english/corona-eng/status-of-the-epidemic/covid-19-updates-statistics-and-charts,33506621,24460217,0,0,0.7568284078666638,0,0,33506621,24460217
Denmark,2021-06-06,57966838,57966838,0,https://www.sst.dk/en/english/corona-eng/status-of-the-epidemic/covid-19-updates-statistics-and-charts,33506621,24460217,0,0,0.7568284078666638,0,0,33506621,24460217
Denmark,2021-06-07,57966838,57966838,0,https://www.sst.dk/en/english/corona-eng/status-of-the-epidemic/covid-19-updates-statistics-and-charts,33506621,24460217,0,0,0.7568284078666638,0,0,33506621,24460217
Denmark,2021-06-08,57966838,57966838,0,https://www.sst.dk/en/english/corona-eng/status-of-the-epidemic/covid-19-updates-statistics-and-charts,33506621,24460217,0,0,0.7568284078666638,0,0,33506621,24460217
Denmark,2021-06-09,60390217,60390217,2423379,https://www.sst.dk/en/english/corona-eng/status-of-the-epidemic/covid-19-updates-statistics-and-charts,33506621,24460217,0,0,0.7568284078666638,589297,1834082,34095918,26294299
Denmark,2021-06-10,60390217,60390217,0,https://www.sst.dk/en/english/corona-eng/status-of-the-epidemic/covid-19-updates-statistics-and-charts,33506621,24460217,0,0,0.7568284078666638,0,0,34095918,26294299
Denmark,2021-06-11,60390217,60390217,0,https://www.sst.dk/en/english/corona-eng/status-of-the-epidemic/covid-19-updates-statistics-and-charts,34367324,27123750,860703,2663533,0.75577600365015285,0,0,34095918,26294299
Denmark,2021-06-12,61491074,61491074,1100857,https://www.sst.dk/en/english/corona-eng/status-of-the-epidemic/covid-19-updates-statistics-and-charts,34367324,27123750,0,0,0.75577600365015285,268856,832001,34364774,27126300
Denmark,2021-06-13,61491074,61491074,0,https://www.sst.dk/en/english/corona-eng/status-of-the-epidemic/covid-19-updates-statistics-and-charts,34367324,27123750,0,0,0.75577600365015285,0,0,34364774,27126300
Denmark,2021-06-14,61491074,61491074,0,https://www.sst.dk/en/english/corona-eng/status-of-the-epidemic/covid-19-updates-statistics-and-charts,34367324,27123750,0,0,0.75577600365015285,0,0,34364774,27126300
Denmark,2021-06-15,63242649,63242649,1751575,https://www.sst.dk/en/english/corona-eng/status-of-the-epidemic/covid-19-updates-statistics-and-charts,34367324,27123750,0,0,0.75577600365015285,427777,1323798,34792551,28450098
Denmark,2021-06-16,63242649,63242649,0,https://www.sst.dk/en/english/corona-eng/status-of-the-epidemic/covid-19-updates-statistics-and-charts,34367324,27123750,0,0,0.75577600365015285,0,0,34792551,28450098
Denmark,2021-06-17,63242649,63242649,0,https://www.sst.dk/en/english/corona-eng/status-of-the-epidemic/covid-19-updates-statistics-and-charts,34367324,27123750,0,0,0.75577600365015285,0,0,34792551,28450098
Denmark,2021-06-18,64564997,64564997,1322348,https://www.sst.dk/en/english/corona-eng/status-of-the-epidemic/covid-19-updates-statistics-and-charts,34367324,27123750,0,0,0.75577600365015285,322949,999399,35115500,29449497
Denmark,2021-06-19,64564997,64564997,0,https://www.sst.dk/en/english/corona-eng/status-of-the-epidemic/covid-19-updates-statistics-and-charts,34367324,27123750,0,0,0.75577600365015285,0,0,35115500,29449497
Denmark,2021-06-20,64564997,64564997,0,https://www.sst.dk/en/english/corona-eng/status-of-the-epidemic/covid-19-updates-statistics-and-charts,34367324,27123750,0,0,0.75577600365015285,0,0,35115500,29449497
Denmark,2021-06-21,64564997,64564997,0,https://www.sst.dk/en/english/corona-eng/status-of-the-epidemic/covid-19-updates-statistics-and-charts,34367324,27123750,0,0,0.75577600365015285,0,0,35115500,29449497
Denmark,2021-06-22,64564997,64564997,0,https://www.sst.dk/en/english/corona-eng/status-of-the-epidemic/covid-19-updates-statistics-and-charts,34367324,27123750,0,0,0.75577600365015285,0,0,35115500,29449497
Denmark,2021-06-23,64564997,64564997,0,https://www.sst.dk/en/english/corona-eng/status-of-the-epidemic/covid-19-updates-statistics-and-charts,34367324,27123750,0,0,0.75577600365015285,0,0,35115500,29449497
Denmark,2021-06-24,64564997,64564997,0,https://www.sst.dk/en/english/corona-eng/status-of-the-epidemic/covid-19-updates-statistics-and-charts,34367324,27123750,0,0,0.75577600365015285,0,0,35115500,29449497
Denmark,2021-06-25,64564997,64564997,0,https://www.sst.dk/en/english/corona-eng/status-of-the-epidemic/covid-19-updates-statistics-and-charts,34367324,27123750,0,0,0.75577600365015285,0,0,35115500,29449497
Denmark,2021-06-26,64564997,64564997,0,https://www.sst.dk/en/english/corona-eng/status-of-the-epidemic/covid-19-updates-statistics-and-charts,34367324,27123750,0,0,0.75577600365015285,0,0,35115500,29449497
Denmark,2021-06-27,64564997,64564997,0,https://www.sst.dk/en/english/corona-eng/status-of-the-epidemic/covid-19-updates-statistics-and-charts,34367324,27123750,0,0,0.75577600365015285,0,0,35115500,29449497
Denmark,2021-06-28,64564997,64564997,0,https://www.sst.dk/en/english/corona-eng/status-of-the-epidemic/covid-19-updates-statistics-and-charts,34367324,27123750,0,0,0.75577600365015285,0,0,35115500,29449497
Denmark,2021-06-29,68352554,68352554,3787557,https://www.sst.dk/en/english/corona-eng/status-of-the-epidemic/covid-19-updates-statistics-and-charts,34367324,27123750,0,0,0.75577600365015285,925012,2862545,36040512,32312042
Denmark,2021-06-30,68626438,68626438,273884,https://www.sst.dk/en/english/corona-eng/status-of-the-epidemic/covid-19-updates-statistics-and-charts,34367324,27123750,0,0,0.75577600365015285,66889,206995,36107401,32519037
Denmark,2021-07-01,68936564,68936564,310126,https://www.sst.dk/en/english/corona-eng/status-of-the-epidemic/covid-19-updates-statistics-and-charts,34367324,27123750,0,0,0.75577600365015285,75740,234386,36183141,32753423
Denmark,2021-07-02,69269798,69269798,333234,https://www.sst.dk/en/english/corona-eng/status-of-the-epidemic/covid-19-updates-statistics-and-charts,34367324,27123750,0,0,0.75577600365015285,81384,251850,36264525,33005273
Denmark,2021-07-03,69269798,69269798,0,https://www.sst.dk/en/english/corona-eng/status-of-the-epidemic/covid-19-updates-statistics-and-charts,34367324,27123750,0,0,0.75577600365015285,0,0,36264525,33005273
Denmark,2021-07-04,70173771,70173771,903973,https://www.sst.dk/en/english/corona-eng/status-of-the-epidemic/covid-19-updates-statistics-and-charts,34367324,27123750,0,0,0.75577600365015285,220772,683201,36485297,33688474
Denmark,2021-07-05,70173771,70173771,0,https://www.sst.dk/en/english/corona-eng/status-of-the-epidemic/covid-19-updates-statistics-and-charts,36486509,33687262,2119185,6563512,0.7559300986778648,0,0,36485297,33688474
Denmark,2021-07-06,70459370,70459370,285599,https://www.sst.dk/en/english/corona-eng/status-of-the-epidemic/covid-19-updates-statistics-and-charts,36570384,33888986,83875,201724,0.7063189997163856,83875,201724,36569172,33890198
Denmark,2021-07-07,70738749,70738749,279379,https://www.sst.dk/en/english/corona-eng/status-of-the-epidemic/covid-19-updates-statistics-and-charts,36667410,34071339,97026,182353,0.6527083281134229,97026,182353,36666198,34072551
Denmark,2021-07-08,71023550,71023550,284801,https://www.sst.dk/en/english/corona-eng/status-of-the-epidemic/covid-19-updates-statistics-and-charts,36759079,34264471,91669,193132,0.678129641398731,91669,193132,36757867,34265683
Denmark,2021-07-09,71287411,71287411,263861,https://www.sst.dk/en/english/corona-eng/status-of-the-epidemic/covid-19-updates-statistics-and-charts,36859809,34427602,100730,163131,0.6182459704162419,100730,163131,36858597,34428814
Denmark,2021-07-10,71287411,71287411,0,https://www.sst.dk/en/english/corona-eng/status-of-the-epidemic/covid-19-updates-statistics-and-charts,36859809,34427602,0,0,0.6182459704162419,0,0,36858597,34428814
Denmark,2021-07-11,71287411,71287411,0,https://www.sst.dk/en/english/corona-eng/status-of-the-epidemic/covid-19-updates-statistics-and-charts,36859809,34427602,0,0,0.6182459704162419,0,0,36858597,34428814
Denmark,2021-07-12,72116053,72116053,828642,https://www.sst.dk/en/english/corona-eng/status-of-the-epidemic/covid-19-updates-statistics-and-charts,37155275,34960778,295466,533176,0.6434334730800515,295466,533176,37154063,34961990
Denmark,2021-07-13,72363056,72363056,247003,https://www.sst.dk/en/english/corona-eng/status-of-the-epidemic/covid-19-updates-statistics-and-charts,37238976,35124080,83701,163302,0.6611336704412497,83701,163302,37237764,35125292
Denmark,2021-07-14,72592425,72592425,229369,https://www.sst.dk/en/english/corona-eng/status-of-the-epidemic/covid-19-updates-statistics-and-charts,37322018,35270407,83042,146327,0.6379545622991774,83042,146327,37320806,35271619
Denmark,2021-07-15,72810136,72810136,217711,https://www.sst.dk/en/english/corona-eng/status-of-the-epidemic/covid-19-updates-statistics-and-charts,37403303,35406833,81285,136426,0.6266380660600521,81285,136426,37402091,35408045
Denmark,2021-07-16,73049472,73049472,239336,https://www.sst.dk/en/english/corona-eng/status-of-the-epidemic/covid-19-updates-statistics-and-charts,37491338,35558134,88035,151301,0.6321698365477822,88035,151301,37490126,35559346
Denmark,2021-07-17,73049472,73049472,0,https://www.sst.dk/en/english/corona-eng/status-of-the-epidemic/covid-19-updates-statistics-and-charts,37491338,35558134,0,0,0.6321698365477822,0,0,37490126,35559346
Denmark,2021-07-18,73049472,73049472,0,https://www.sst.dk/en/english/corona-eng/status-of-the-epidemic/covid-19-updates-statistics-and-charts,37491338,35558134,0,0,0.6321698365477822,0,0,37490126,35559346
Denmark,2021-07-19,73782742,73782742,733270,https://www.sst.dk/en/english/corona-eng/status-of-the-epidemic/covid-19-updates-statistics-and-charts,37772813,36009929,281475,451795,0.6161373027670571,281475,451795,37771601,36011141
Denmark,2021-07-20,74022609,74022609,239867,https://www.sst.dk/en/english/corona-eng/status-of-the-epidemic/covid-19-updates-statistics-and-charts,37857162,36165447,84349,155518,0.6483509611576416,84349,155518,37855950,36166659
Denmark,2021-07-21,74244457,74244457,221848,https://www.sst.dk/en/english/corona-eng/status-of-the-epidemic/covid-19-updates-statistics-and-charts,37933012,36311445,75850,145998,0.6580992391186758,75850,145998,37931800,36312657
Denmark,2021-07-22,74452907,74452907,208450,https://www.sst.dk/en/english/corona-eng/status-of-the-epidemic/covid-19-updates-statistics-and-charts,38004316,36448591,71304,137146,0.6579323578795875,71304,137146,38003104,36449803
Denmark,2021-07-23,74636200,74636200,183293,https://www.sst.dk/en/english/corona-eng/status-of-the-epidemic/covid-19-updates-statistics-and-charts,38078186,36558014,73870,109423,0.596984063766756,73870,109423,38076974,36559226
Denmark,2021-07-24,74636200,74636200,0,https://www.sst.dk/en/english/corona-eng/status-of-the-epidemic/covid-19-updates-statistics-and-charts,38078186,36558014,0,0,0.596984063766756,0,0,38076974,36559226
Denmark,2021-07-25,74636200,74636200,0,https://www.sst.dk/en/english/corona-eng/status-of-the-epidemic/covid-19-updates-statistics-and-charts,38078186,36558014,0,0,0.596984063766756,0,0,38076974,36559226
Denmark,2021-07-26,75270302,75270302,634102,https://www.sst.dk/en/english/corona-eng/status-of-the-epidemic/covid-19-updates-statistics-and-charts,38288367,36981935,210181,423921,0.6685375538951147,210181,423921,38287155,36983147
Denmark,2021-07-27,75449697,75449697,179395,https://www.sst.dk/en/english/corona-eng/status-of-the-epidemic/covid-19-updates-statistics-and-charts,38334689,37115008,46322,133073,0.7417876752417849,46322,133073,38333477,37116220
Denmark,2021-07-28,75645631,75645631,195934,https://www.sst.dk/en/english/corona-eng/status-of-the-epidemic/covid-19-updates-statistics-and-charts,38414984,37230647,80295,115639,0.5901936366327437,80295,115639,38413772,37231859
Denmark,2021-07-29,75817747,75817747,172116,https://www.sst.dk/en/english/corona-eng/status-of-the-epidemic/covid-19-updates-statistics-and-charts,38471352,37346395,56368,115748,0.6724999418996491,56368,115748,38470140,37347607
Denmark,2021-07-30,76015954,76015954,198207,https://www.sst.dk/en/english/corona-eng/status-of-the-epidemic/covid-19-updates-statistics-and-charts,38544678,37471276,73326,124881,0.6300534289909034,73326,124881,38543466,37472488
Denmark,2021-07-31,76015954,76015954,0,https://www.sst.dk/en/english/corona-eng/status-of-the-epidemic/covid-19-updates-statistics-and-charts,38544678,37471276,0,0,0.6300534289909034,0,0,38543466,37472488
Denmark,2021-08-01,76015954,76015954,0,https://www.sst.dk/en/english/corona-eng/status-of-the-epidemic/covid-19-updates-statistics-and-charts,38544678,37471276,0,0,0.6300534289909034,0,0,38543466,37472488
Denmark,2021-08-02,76573206,76573206,557252,https://www.sst.dk/en/english/corona-eng/status-of-the-epidemic/covid-19-updates-statistics-and-charts,38739573,37833633,194895,362357,0.6502569753002232,194895,362357,38738361,37834845
Denmark,2021-08-03,76724043,76724043,150837,https://www.sst.dk/en/english/corona-eng/status-of-the-epidemic/covid-19-updates-statistics-and-charts,38791426,37932617,51853,98984,0.6562315612217161,51853,98984,38790214,37933829
Denmark,2021-08-04,76867135,76867135,143092,https://www.sst.dk/en/english/corona-eng/status-of-the-epidemic/covid-19-updates-statistics-and-charts,38847576,38019559,56150,86942,0.6075951136331871,56150,86942,38846364,38020771
Denmark,2021-08-05,77002601,77002601,135466,https://www.sst.dk/en/english/corona-eng/status-of-the-epidemic/covid-19-updates-statistics-and-charts,38901210,38101391,53634,81832,0.6040777759733069,53634,81832,38899998,38102603
Denmark,2021-08-06,77154338,77154338,151737,https://www.sst.dk/en/english/corona-eng/status-of-the-epidemic/covid-19-updates-statistics-and-charts,38961307,38193031,60097,91640,0.6039397114744591,60097,91640,38960095,38194243
Denmark,2021-08-07,77154338,77154338,0,https://www.sst.dk/en/english/corona-eng/status-of-the-epidemic/covid-19-updates-statistics-and-charts,38961307,38193031,0,0,0.6039397114744591,0,0,38960095,38194243
Denmark,2021-08-08,77154338,77154338,0,https://www.sst.dk/en/english/corona-eng/status-of-the-epidemic/covid-19-updates-statistics-and-charts,38961307,38193031,0,0,0.6039397114744591,0,0,38960095,38194243
Denmark,2021-08-09,77666455,77666455,512117,https://www.sst.dk/en/english/corona-eng/status-of-the-epidemic/covid-19-updates-statistics-and-charts,39159198,38507257,197891,314226,0.6135824430745318,197891,314226,39157986,38508469
Denmark,2021-08-10,77666455,77666455,0,https://www.sst.dk/en/english/corona-eng/status-of-the-epidemic/covid-19-updates-statistics-and-charts,39159198,38507257,0,0,0.6135824430745318,0,0,39157986,38508469
Denmark,2021-08-11,77964528,77964528,298073,https://www.sst.dk/en/english/corona-eng/status-of-the-epidemic/covid-19-updates-statistics-and-charts,39281517,38683011,122319,175754,0.5896340829259946,122319,175754,39280305,38684223
Denmark,2021-08-12,78100144,78100144,135616,https://www.sst.dk/en/english/corona-eng/status-of-the-epidemic/covid-19-updates-statistics-and-charts,39338589,38761555,57072,78544,0.5791647003303445,57072,78544,39337377,38762767
Denmark,2021-08-13,78262897,78262897,162753,https://www.sst.dk/en/english/corona-eng/status-of-the-epidemic/covid-19-updates-statistics-and-charts,39401498,38861399,62909,99844,0.6134694905777467,62909,99844,39400286,38862611
Denmark,2021-08-14,78262897,78262897,0,https://www.sst.dk/en/english/corona-eng/status-of-the-epidemic/covid-19-updates-statistics-and-charts,39401498,38861399,0,0,0.6134694905777467,0,0,39400286,38862611
Denmark,2021-08-15,78262897,78262897,0,https://www.sst.dk/en/english/corona-eng/status-of-the-epidemic/covid-19-updates-statistics-and-charts,39401498,38861399,0,0,0.6134694905777467,0,0,39400286,38862611
Denmark,2021-08-16,78723381,78723381,460484,https://www.sst.dk/en/english/corona-eng/status-of-the-epidemic/covid-19-updates-statistics-and-charts,39584990,39138391,183492,276992,0.6015236142841011,183492,276992,39583778,39139603
Denmark,2021-08-17,78870933,78870933,147552,https://www.sst.dk/en/english/corona-eng/status-of-the-epidemic/covid-19-updates-statistics-and-charts,39640865,39230068,55875,91677,0.6213199414443722,55875,91677,39639653,39231280
Denmark,2021-08-18,79031383,79031383,160450,https://www.sst.dk/en/english/corona-eng/status-of-the-epidemic/covid-19-updates-statistics-and-charts,39715289,39316094,74424,86026,0.5361545652851356,74424,86026,39714077,39317306
Denmark,2021-08-19,79179355,79179355,147972,https://www.sst.dk/en/english/corona-eng/status-of-the-epidemic/covid-19-updates-statistics-and-charts,39784158,39395197,68869,79103,0.5345808666504474,68869,79103,39782946,39396409
Denmark,2021-08-20,79350988,79350988,171633,https://www.sst.dk/en/english/corona-eng/status-of-the-epidemic/covid-19-updates-statistics-and-charts,39856392,39494596,72234,99399,0.5791368792714687,72234,99399,39855180,39495808
Denmark,2021-08-21,79350988,79350988,0,https://www.sst.dk/en/english/corona-eng/status-of-the-epidemic/covid-19-updates-statistics-and-charts,39856392,39494596,0,0,0.5791368792714687,0,0,39855180,39495808
Denmark,2021-08-22,79350988,79350988,0,https://www.sst.dk/en/english/corona-eng/status-of-the-epidemic/covid-19-updates-statistics-and-charts,39856392,39494596,0,0,0.5791368792714687,0,0,39855180,39495808
Denmark,2021-08-23,79807831,79807831,456843,https://www.sst.dk/en/english/corona-eng/status-of-the-epidemic/covid-19-updates-statistics-and-charts,40046839,39760992,190447,266396,0.583123742729997,190447,266396,40045627,39762204
Denmark,2021-08-24,79986976,79986976,179145,https://www.sst.dk/en/english/corona-eng/status-of-the-epidemic/covid-19-updates-statistics-and-charts,40134379,39852597,87540,91605,0.5113455580674873,87540,91605,40133167,39853809
Denmark,2021-08-25,80150524,80150524,163548,https://www.sst.dk/en/english/corona-eng/status-of-the-epidemic/covid-19-updates-statistics-and-charts,40210699,39939825,76320,87228,0.5333480079242792,76320,87228,40209487,39941037
Denmark,2021-08-26,80150524,80150524,0,https://www.sst.dk/en/english/corona-eng/status-of-the-epidemic/covid-19-updates-statistics-and-charts,40210699,39939825,0,0,0.5333480079242792,0,0,40209487,39941037
Denmark,2021-08-27,80150524,80150524,0,https://www.sst.dk/en/english/corona-eng/status-of-the-epidemic/covid-19-updates-statistics-and-charts,40210699,39939825,0,0,0.5333480079242792,0,0,40209487,39941037
Denmark,2021-08-28,80150524,80150524,0,https://www.sst.dk/en/english/corona-eng/status-of-the-epidemic/covid-19-updates-statistics-and-charts,40210699,39939825,0,0,0.5333480079242792,0,0,40209487,39941037
Denmark,2021-08-29,80150524,80150524,0,https://www.sst.dk/en/english/corona-eng/status-of-the-epidemic/covid-19-updates-statistics-and-charts,40210699,39939825,0,0,0.5333480079242792,0,0,40209487,39941037
Denmark,2021-08-30,80150524,80150524,0,https://www.sst.dk/en/english/corona-eng/status-of-the-epidemic/covid-19-updates-statistics-and-charts,40210699,39939825,0,0,0.5333480079242792,0,0,40209487,39941037
Denmark,2021-08-31,80150524,80150524,0,https://www.sst.dk/en/english/corona-eng/status-of-the-epidemic/covid-19-updates-statistics-and-charts,40210699,39939825,0,0,0.5333480079242792,0,0,40209487,39941037
Denmark,2021-09-01,80150524,80150524,0,https://www.sst.dk/en/english/corona-eng/status-of-the-epidemic/covid-19-updates-statistics-and-charts,40210699,39939825,0,0,0.5333480079242792,0,0,40209487,39941037
Denmark,2021-09-02,80150524,80150524,0,https://www.sst.dk/en/english/corona-eng/status-of-the-epidemic/covid-19-updates-statistics-and-charts,40210699,39939825,0,0,0.5333480079242792,0,0,40209487,39941037
Denmark,2021-09-03,80150524,80150524,0,https://www.sst.dk/en/english/corona-eng/status-of-the-epidemic/covid-19-updates-statistics-and-charts,40210699,39939825,0,0,0.5333480079242792,0,0,40209487,39941037
Denmark,2021-09-04,80150524,80150524,0,https://www.sst.dk/en/english/corona-eng/status-of-the-epidemic/covid-19-updates-statistics-and-charts,40210699,39939825,0,0,0.5333480079242792,0,0,40209487,39941037
Denmark,2021-09-05,80150524,80150524,0,https://www.sst.dk/en/english/corona-eng/status-of-the-epidemic/covid-19-updates-statistics-and-charts,40210699,39939825,0,0,0.5333480079242792,0,0,40209487,39941037
Denmark,2021-09-06,80150524,80150524,0,https://www.sst.dk/en/english/corona-eng/status-of-the-epidemic/covid-19-updates-statistics-and-charts,40210699,39939825,0,0,0.5333480079242792,0,0,40209487,39941037
Denmark,2021-09-07,80150524,80150524,0,https://www.sst.dk/en/english/corona-eng/status-of-the-epidemic/covid-19-updates-statistics-and-charts,40210699,39939825,0,0,0.5333480079242792,0,0,40209487,39941037
Denmark,2021-09-08,80150524,80150524,0,https://www.sst.dk/en/english/corona-eng/status-of-the-epidemic/covid-19-updates-statistics-and-charts,40210699,39939825,0,0,0.5333480079242792,0,0,40209487,39941037
Denmark,2021-09-09,80150524,80150524,0,https://www.sst.dk/en/english/corona-eng/status-of-the-epidemic/covid-19-updates-statistics-and-charts,40210699,39939825,0,0,0.5333480079242792,0,0,40209487,39941037
Denmark,2021-09-10,80150524,80150524,0,https://www.sst.dk/en/english/corona-eng/status-of-the-epidemic/covid-19-updates-statistics-and-charts,40210699,39939825,0,0,0.5333480079242792,0,0,40209487,39941037
Denmark,2021-09-11,80150524,80150524,0,https://www.sst.dk/en/english/corona-eng/status-of-the-epidemic/covid-19-updates-statistics-and-charts,40210699,39939825,0,0,0.5333480079242792,0,0,40209487,39941037
Denmark,2021-09-12,80150524,80150524,0,https://www.sst.dk/en/english/corona-eng/status-of-the-epidemic/covid-19-updates-statistics-and-charts,40210699,39939825,0,0,0.5333480079242792,0,0,40209487,39941037
Denmark,2021-09-13,80150524,80150524,0,https://www.sst.dk/en/english/corona-eng/status-of-the-epidemic/covid-19-updates-statistics-and-charts,40210699,39939825,0,0,0.5333480079242792,0,0,40209487,39941037
Denmark,2021-09-14,80150524,80150524,0,https://www.sst.dk/en/english/corona-eng/status-of-the-epidemic/covid-19-updates-statistics-and-charts,40210699,39939825,0,0,0.5333480079242792,0,0,40209487,39941037
Denmark,2021-09-15,80150524,80150524,0,https://www.sst.dk/en/english/corona-eng/status-of-the-epidemic/covid-19-updates-statistics-and-charts,40210699,39939825,0,0,0.5333480079242792,0,0,40209487,39941037
Denmark,2021-09-16,80150524,80150524,0,https://www.sst.dk/en/english/corona-eng/status-of-the-epidemic/covid-19-updates-statistics-and-charts,40210699,39939825,0,0,0.5333480079242792,0,0,40209487,39941037
Denmark,2021-09-17,80150524,80150524,0,https://www.sst.dk/en/english/corona-eng/status-of-the-epidemic/covid-19-updates-statistics-and-charts,40210699,39939825,0,0,0.5333480079242792,0,0,40209487,39941037
Denmark,2021-09-18,80150524,80150524,0,https://www.sst.dk/en/english/corona-eng/status-of-the-epidemic/covid-19-updates-statistics-and-charts,40210699,39939825,0,0,0.5333480079242792,0,0,40209487,39941037
Denmark,2021-09-19,80150524,80150524,0,https://www.sst.dk/en/english/corona-eng/status-of-the-epidemic/covid-19-updates-statistics-and-charts,40210699,39939825,0,0,0.5333480079242792,0,0,40209487,39941037
Denmark,2021-09-20,80150524,80150524,0,https://www.sst.dk/en/english/corona-eng/status-of-the-epidemic/covid-19-updates-statistics-and-charts,40210699,39939825,0,0,0.5333480079242792,0,0,40209487,39941037
Denmark,2021-09-21,80150524,80150524,0,https://www.sst.dk/en/english/corona-eng/status-of-the-epidemic/covid-19-updates-statistics-and-charts,40210699,39939825,0,0,0.5333480079242792,0,0,40209487,39941037
Denmark,2021-09-22,80150524,80150524,0,https://www.sst.dk/en/english/corona-eng/status-of-the-epidemic/covid-19-updates-statistics-and-charts,40210699,39939825,0,0,0.5333480079242792,0,0,40209487,39941037
Denmark,2021-09-23,80150524,80150524,0,https://www.sst.dk/en/english/corona-eng/status-of-the-epidemic/covid-19-updates-statistics-and-charts,40210699,39939825,0,0,0.5333480079242792,0,0,40209487,39941037
Denmark,2021-09-24,80150524,80150524,0,https://www.sst.dk/en/english/corona-eng/status-of-the-epidemic/covid-19-updates-statistics-and-charts,40210699,39939825,0,0,0.5333480079242792,0,0,40209487,39941037
Denmark,2021-09-25,80150524,80150524,0,https://www.sst.dk/en/english/corona-eng/status-of-the-epidemic/covid-19-updates-statistics-and-charts,40210699,39939825,0,0,0.5333480079242792,0,0,40209487,39941037
Denmark,2021-09-26,80150524,80150524,0,https://www.sst.dk/en/english/corona-eng/status-of-the-epidemic/covid-19-updates-statistics-and-charts,40210699,39939825,0,0,0.5333480079242792,0,0,40209487,39941037
Denmark,2021-09-27,83437076,83437076,3286552,https://www.sst.dk/en/english/corona-eng/status-of-the-epidemic/covid-19-updates-statistics-and-charts,40210699,39939825,0,0,0.5333480079242792,1533676,1752876,41743163,41693913
Denmark,2021-09-28,83437076,83437076,0,https://www.sst.dk/en/english/corona-eng/status-of-the-epidemic/covid-19-updates-statistics-and-charts,41852632,41584444,1641933,1644619,0.5004086349462902,0,0,41743163,41693913
Denmark,2021-09-29,83583954,83583954,146878,https://www.sst.dk/en/english/corona-eng/status-of-the-epidemic/covid-19-updates-statistics-and-charts,41927792,41656162,75160,71718,0.48828279252168466,75160,71718,41818323,41765631
Denmark,2021-09-30,83642334,83642334,58380,https://www.sst.dk/en/english/corona-eng/status-of-the-epidemic/covid-19-updates-statistics-and-charts,41956958,41685376,29166,29214,0.5004110996916752,29166,29214,41847489,41794845
Denmark,2021-10-01,83728514,83728514,86180,https://www.sst.dk/en/english/corona-eng/status-of-the-epidemic/covid-19-updates-statistics-and-charts,42009048,41719466,52090,34090,0.39556741703411463,52090,34090,41899579,41828935
Denmark,2021-10-02,83728514,83728514,0,https://www.sst.dk/en/english/corona-eng/status-of-the-epidemic/covid-19-updates-statistics-and-charts,42009048,41719466,0,0,0.39556741703411463,0,0,41899579,41828935
Denmark,2021-10-03,83728514,83728514,0,https://www.sst.dk/en/english/corona-eng/status-of-the-epidemic/covid-19-updates-statistics-and-charts,42009048,41719466,0,0,0.39556741703411463,0,0,41899579,41828935
Denmark,2021-10-04,83887085,83887085,158571,https://www.sst.dk/en/english/corona-eng/status-of-the-epidemic/covid-19-updates-statistics-and-charts,42103760,41783325,94712,63859,0.4027155028346924,94712,63859,41994291,41892794
Denmark,2021-10-05,83955561,83955561,68476,https://www.sst.dk/en/english/corona-eng/status-of-the-epidemic/covid-19-updates-statistics-and-charts,42138428,41817133,34668,33808,0.4937204275950698,34668,33808,42028959,41926602
Denmark,2021-10-06,84025465,84025465,69904,https://www.sst.dk/en/english/corona-eng/status-of-the-epidemic/covid-19-updates-statistics-and-charts,42177944,41847521,39516,30388,0.4347104600595102,39516,30388,42068475,41956990
Denmark,2021-10-07,84097718,84097718,72253,https://www.sst.dk/en/english/corona-eng/status-of-the-epidemic/covid-19-updates-statistics-and-charts,42220386,41877332,42442,29811,0.4125918646976596,42442,29811,42110917,41986801
Denmark,2021-10-08,84172224,84172224,74506,https://www.sst.dk/en/english/corona-eng/status-of-the-epidemic/covid-19-updates-statistics-and-charts,42261258,41910966,40872,33634,0.4514267307330953,40872,33634,42151789,42020435
Denmark,2021-10-09,84172224,84172224,0,https://www.sst.dk/en/english/corona-eng/status-of-the-epidemic/covid-19-updates-statistics-and-charts,42261258,41910966,0,0,0.4514267307330953,0,0,42151789,42020435
Denmark,2021-10-10,84172224,84172224,0,https://www.sst.dk/en/english/corona-eng/status-of-the-epidemic/covid-19-updates-statistics-and-charts,42261258,41910966,0,0,0.4514267307330953,0,0,42151789,42020435
Denmark,2021-10-11,84172224,84172224,0,https://www.sst.dk/en/english/corona-eng/status-of-the-epidemic/covid-19-updates-statistics-and-charts,42261258,41910966,0,0,0.4514267307330953,0,0,42151789,42020435
Denmark,2021-10-12,84172224,84172224,0,https://www.sst.dk/en/english/corona-eng/status-of-the-epidemic/covid-19-updates-statistics-and-charts,42419422,41979836,158164,68870,0.30334663530572514,0,0,42151789,42020435
Denmark,2021-10-13,84399258,84399258,227034,https://www.sst.dk/en/english/corona-eng/status-of-the-epidemic/covid-19-updates-statistics-and-charts,42419422,41979836,0,0,0.30334663530572514,158164,68870,42309953,42089305
Denmark,2021-10-14,84399258,84399258,0,https://www.sst.dk/en/english/corona-eng/status-of-the-epidemic/covid-19-updates-statistics-and-charts,42419422,41979836,0,0,0.30334663530572514,0,0,42309953,42089305
Denmark,2021-10-15,84399258,84399258,0,https://www.sst.dk/en/english/corona-eng/status-of-the-epidemic/covid-19-updates-statistics-and-charts,42419422,41979836,0,0,0.30334663530572514,0,0,42309953,42089305
Denmark,2021-10-16,84399258,84399258,0,https://www.sst.dk/en/english/corona-eng/status-of-the-epidemic/covid-19-updates-statistics-and-charts,42419422,41979836,0,0,0.30334663530572514,0,0,42309953,42089305
Denmark,2021-10-17,84399258,84399258,0,https://www.sst.dk/en/english/corona-eng/status-of-the-epidemic/covid-19-updates-statistics-and-charts,42419422,41979836,0,0,0.30334663530572514,0,0,42309953,42089305
Denmark,2021-10-18,84399258,84399258,0,https://www.sst.dk/en/english/corona-eng/status-of-the-epidemic/covid-19-updates-statistics-and-charts,42419422,41979836,0,0,0.30334663530572514,0,0,42309953,42089305
Denmark,2021-10-19,84399258,84399258,0,https://www.sst.dk/en/english/corona-eng/status-of-the-epidemic/covid-19-updates-statistics-and-charts,42419422,41979836,0,0,0.30334663530572514,0,0,42309953,42089305
Denmark,2021-10-20,84399258,84399258,0,https://www.sst.dk/en/english/corona-eng/status-of-the-epidemic/covid-19-updates-statistics-and-charts,42419422,41979836,0,0,0.30334663530572514,0,0,42309953,42089305
Denmark,2021-10-21,84399258,84399258,0,https://www.sst.dk/en/english/corona-eng/status-of-the-epidemic/covid-19-updates-statistics-and-charts,42419422,41979836,0,0,0.30334663530572514,0,0,42309953,42089305
Denmark,2021-10-22,84399258,84399258,0,https://www.sst.dk/en/english/corona-eng/status-of-the-epidemic/covid-19-updates-statistics-and-charts,42419422,41979836,0,0,0.30334663530572514,0,0,42309953,42089305
Denmark,2021-10-23,84399258,84399258,0,https://www.sst.dk/en/english/corona-eng/status-of-the-epidemic/covid-19-updates-statistics-and-charts,42419422,41979836,0,0,0.30334663530572514,0,0,42309953,42089305
Denmark,2021-10-24,84399258,84399258,0,https://www.sst.dk/en/english/corona-eng/status-of-the-epidemic/covid-19-updates-statistics-and-charts,42419422,41979836,0,0,0.30334663530572514,0,0,42309953,42089305
Denmark,2021-10-25,84399258,84399258,0,https://www.sst.dk/en/english/corona-eng/status-of-the-epidemic/covid-19-updates-statistics-and-charts,42419422,41979836,0,0,0.30334663530572514,0,0,42309953,42089305
Denmark,2021-10-26,84399258,84399258,0,https://www.sst.dk/en/english/corona-eng/status-of-the-epidemic/covid-19-updates-statistics-and-charts,42419422,41979836,0,0,0.30334663530572514,0,0,42309953,42089305
Denmark,2021-10-27,84399258,84399258,0,https://www.sst.dk/en/english/corona-eng/status-of-the-epidemic/covid-19-updates-statistics-and-charts,42419422,41979836,0,0,0.30334663530572514,0,0,42309953,42089305
Denmark,2021-10-28,84399258,84399258,0,https://www.sst.dk/en/english/corona-eng/status-of-the-epidemic/covid-19-updates-statistics-and-charts,42419422,41979836,0,0,0.30334663530572514,0,0,42309953,42089305
Denmark,2021-10-29,84399258,84399258,0,https://www.sst.dk/en/english/corona-eng/status-of-the-epidemic/covid-19-updates-statistics-and-charts,42419422,41979836,0,0,0.30334663530572514,0,0,42309953,42089305
Denmark,2021-10-30,84399258,84399258,0,https://www.sst.dk/en/english/corona-eng/status-of-the-epidemic/covid-19-updates-statistics-and-charts,42419422,41979836,0,0,0.30334663530572514,0,0,42309953,42089305
Denmark,2021-10-31,84399258,84399258,0,https://www.sst.dk/en/english/corona-eng/status-of-the-epidemic/covid-19-updates-statistics-and-charts,42419422,41979836,0,0,0.30334663530572514,0,0,42309953,42089305
Denmark,2021-11-01,84399258,84399258,0,https://www.sst.dk/en/english/corona-eng/status-of-the-epidemic/covid-19-updates-statistics-and-charts,42419422,41979836,0,0,0.30334663530572514,0,0,42309953,42089305
Denmark,2021-11-02,84399258,84399258,0,https://www.sst.dk/en/english/corona-eng/status-of-the-epidemic/covid-19-updates-statistics-and-charts,42419422,41979836,0,0,0.30334663530572514,0,0,42309953,42089305
Denmark,2021-11-03,84399258,84399258,0,https://www.sst.dk/en/english/corona-eng/status-of-the-epidemic/covid-19-updates-statistics-and-charts,42419422,41979836,0,0,0.30334663530572514,0,0,42309953,42089305
Denmark,2021-11-04,84399258,84399258,0,https://www.sst.dk/en/english/corona-eng/status-of-the-epidemic/covid-19-updates-statistics-and-charts,42419422,41979836,0,0,0.30334663530572514,0,0,42309953,42089305
Denmark,2021-11-05,84399258,84399258,0,https://www.sst.dk/en/english/corona-eng/status-of-the-epidemic/covid-19-updates-statistics-and-charts,42419422,41979836,0,0,0.30334663530572514,0,0,42309953,42089305
Denmark,2021-11-06,84399258,84399258,0,https://www.sst.dk/en/english/corona-eng/status-of-the-epidemic/covid-19-updates-statistics-and-charts,42419422,41979836,0,0,0.30334663530572514,0,0,42309953,42089305
Denmark,2021-11-07,84399258,84399258,0,https://www.sst.dk/en/english/corona-eng/status-of-the-epidemic/covid-19-updates-statistics-and-charts,42419422,41979836,0,0,0.30334663530572514,0,0,42309953,42089305
Denmark,2021-11-08,84399258,84399258,0,https://www.sst.dk/en/english/corona-eng/status-of-the-epidemic/covid-19-updates-statistics-and-charts,42419422,41979836,0,0,0.30334663530572514,0,0,42309953,42089305
Denmark,2021-11-09,84399258,84399258,0,https://www.sst.dk/en/english/corona-eng/status-of-the-epidemic/covid-19-updates-statistics-and-charts,42419422,41979836,0,0,0.30334663530572514,0,0,42309953,42089305
Denmark,2021-11-10,84399258,84399258,0,https://www.sst.dk/en/english/corona-eng/status-of-the-epidemic/covid-19-updates-statistics-and-charts,42419422,41979836,0,0,0.30334663530572514,0,0,42309953,42089305
Denmark,2021-11-11,84399258,84399258,0,https://www.sst.dk/en/english/corona-eng/status-of-the-epidemic/covid-19-updates-statistics-and-charts,42419422,41979836,0,0,0.30334663530572514,0,0,42309953,42089305
Denmark,2021-11-12,84399258,84399258,0,https://www.sst.dk/en/english/corona-eng/status-of-the-epidemic/covid-19-updates-statistics-and-charts,42419422,41979836,0,0,0.30334663530572514,0,0,42309953,42089305
Denmark,2021-11-13,84399258,84399258,0,https://www.sst.dk/en/english/corona-eng/status-of-the-epidemic/covid-19-updates-statistics-and-charts,42419422,41979836,0,0,0.30334663530572514,0,0,42309953,42089305
Denmark,2021-11-14,84399258,84399258,0,https://www.sst.dk/en/english/corona-eng/status-of-the-epidemic/covid-19-updates-statistics-and-charts,42419422,41979836,0,0,0.30334663530572514,0,0,42309953,42089305
Denmark,2021-11-15,84399258,84399258,0,https://www.sst.dk/en/english/corona-eng/status-of-the-epidemic/covid-19-updates-statistics-and-charts,42419422,41979836,0,0,0.30334663530572514,0,0,42309953,42089305
Denmark,2021-11-16,84399258,84399258,0,https://www.sst.dk/en/english/corona-eng/status-of-the-epidemic/covid-19-updates-statistics-and-charts,42419422,41979836,0,0,0.30334663530572514,0,0,42309953,42089305
Denmark,2021-11-17,84399258,84399258,0,https://www.sst.dk/en/english/corona-eng/status-of-the-epidemic/covid-19-updates-statistics-and-charts,42419422,41979836,0,0,0.30334663530572514,0,0,42309953,42089305
Denmark,2021-11-18,84399258,84399258,0,https://www.sst.dk/en/english/corona-eng/status-of-the-epidemic/covid-19-updates-statistics-and-charts,42419422,41979836,0,0,0.30334663530572514,0,0,42309953,42089305
Denmark,2021-11-19,84399258,84399258,0,https://www.sst.dk/en/english/corona-eng/status-of-the-epidemic/covid-19-updates-statistics-and-charts,42419422,41979836,0,0,0.30334663530572514,0,0,42309953,42089305
Denmark,2021-11-20,84399258,84399258,0,https://www.sst.dk/en/english/corona-eng/status-of-the-epidemic/covid-19-updates-statistics-and-charts,42419422,41979836,0,0,0.30334663530572514,0,0,42309953,42089305
Denmark,2021-11-21,84399258,84399258,0,https://www.sst.dk/en/english/corona-eng/status-of-the-epidemic/covid-19-updates-statistics-and-charts,42419422,41979836,0,0,0.30334663530572514,0,0,42309953,42089305
Denmark,2021-11-22,84399258,84399258,0,https://www.sst.dk/en/english/corona-eng/status-of-the-epidemic/covid-19-updates-statistics-and-charts,42419422,41979836,0,0,0.30334663530572514,0,0,42309953,42089305
Denmark,2021-11-23,84399258,84399258,0,https://www.sst.dk/en/english/corona-eng/status-of-the-epidemic/covid-19-updates-statistics-and-charts,42419422,41979836,0,0,0.30334663530572514,0,0,42309953,42089305
Denmark,2021-11-24,84399258,84399258,0,https://www.sst.dk/en/english/corona-eng/status-of-the-epidemic/covid-19-updates-statistics-and-charts,42419422,41979836,0,0,0.30334663530572514,0,0,42309953,42089305
Denmark,2021-11-25,84399258,84399258,0,https://www.sst.dk/en/english/corona-eng/status-of-the-epidemic/covid-19-updates-statistics-and-charts,42419422,41979836,0,0,0.30334663530572514,0,0,42309953,42089305
Denmark,2021-11-26,84399258,84399258,0,https://www.sst.dk/en/english/corona-eng/status-of-the-epidemic/covid-19-updates-statistics-and-charts,42419422,41979836,0,0,0.30334663530572514,0,0,42309953,42089305
Denmark,2021-11-27,84399258,84399258,0,https://www.sst.dk/en/english/corona-eng/status-of-the-epidemic/covid-19-updates-statistics-and-charts,42419422,41979836,0,0,0.30334663530572514,0,0,42309953,42089305
Denmark,2021-11-28,84399258,84399258,0,https://www.sst.dk/en/english/corona-eng/status-of-the-epidemic/covid-19-updates-statistics-and-charts,42419422,41979836,0,0,0.30334663530572514,0,0,42309953,42089305
Denmark,2021-11-29,84399258,84399258,0,https://www.sst.dk/en/english/corona-eng/status-of-the-epidemic/covid-19-updates-statistics-and-charts,42419422,41979836,0,0,0.30334663530572514,0,0,42309953,42089305
Denmark,2021-11-30,84399258,84399258,0,https://www.sst.dk/en/english/corona-eng/status-of-the-epidemic/covid-19-updates-statistics-and-charts,42419422,41979836,0,0,0.30334663530572514,0,0,42309953,42089305
Denmark,2021-12-01,84399258,84399258,0,https://www.sst.dk/en/english/corona-eng/status-of-the-epidemic/covid-19-updates-statistics-and-charts,42419422,41979836,0,0,0.30334663530572514,0,0,42309953,42089305
Denmark,2021-12-02,84399258,84399258,0,https://www.sst.dk/en/english/corona-eng/status-of-the-epidemic/covid-19-updates-statistics-and-charts,42419422,41979836,0,0,0.30334663530572514,0,0,42309953,42089305
Denmark,2021-12-03,84399258,84399258,0,https://www.sst.dk/en/english/corona-eng/status-of-the-epidemic/covid-19-updates-statistics-and-charts,42419422,41979836,0,0,0.30334663530572514,0,0,42309953,42089305
Denmark,2021-12-04,84399258,84399258,0,https://www.sst.dk/en/english/corona-eng/status-of-the-epidemic/covid-19-updates-statistics-and-charts,42419422,41979836,0,0,0.30334663530572514,0,0,42309953,42089305
Denmark,2021-12-05,84399258,84399258,0,https://www.sst.dk/en/english/corona-eng/status-of-the-epidemic/covid-19-updates-statistics-and-charts,42419422,41979836,0,0,0.30334663530572514,0,0,42309953,42089305
Denmark,2021-12-06,84399258,84399258,0,https://www.sst.dk/en/english/corona-eng/status-of-the-epidemic/covid-19-updates-statistics-and-charts,42419422,41979836,0,0,0.30334663530572514,0,0,42309953,42089305
Denmark,2021-12-07,84399258,84399258,0,https://www.sst.dk/en/english/corona-eng/status-of-the-epidemic/covid-19-updates-statistics-and-charts,42419422,41979836,0,0,0.30334663530572514,0,0,42309953,42089305
Denmark,2021-12-08,84399258,84399258,0,https://www.sst.dk/en/english/corona-eng/status-of-the-epidemic/covid-19-updates-statistics-and-charts,42419422,41979836,0,0,0.30334663530572514,0,0,42309953,42089305
Denmark,2021-12-09,84399258,84399258,0,https://www.sst.dk/en/english/corona-eng/status-of-the-epidemic/covid-19-updates-statistics-and-charts,42419422,41979836,0,0,0.30334663530572514,0,0,42309953,42089305
Denmark,2021-12-10,84399258,84399258,0,https://www.sst.dk/en/english/corona-eng/status-of-the-epidemic/covid-19-updates-statistics-and-charts,42419422,41979836,0,0,0.30334663530572514,0,0,42309953,42089305
Denmark,2021-12-11,84399258,84399258,0,https://www.sst.dk/en/english/corona-eng/status-of-the-epidemic/covid-19-updates-statistics-and-charts,42419422,41979836,0,0,0.30334663530572514,0,0,42309953,42089305
Denmark,2021-12-12,84399258,84399258,0,https://www.sst.dk/en/english/corona-eng/status-of-the-epidemic/covid-19-updates-statistics-and-charts,42419422,41979836,0,0,0.30334663530572514,0,0,42309953,42089305
Denmark,2021-12-13,84399258,84399258,0,https://www.sst.dk/en/english/corona-eng/status-of-the-epidemic/covid-19-updates-statistics-and-charts,42419422,41979836,0,0,0.30334663530572514,0,0,42309953,42089305
Denmark,2021-12-14,84399258,84399258,0,https://www.sst.dk/en/english/corona-eng/status-of-the-epidemic/covid-19-updates-statistics-and-charts,42419422,41979836,0,0,0.30334663530572514,0,0,42309953,42089305
Denmark,2021-12-15,84399258,84399258,0,https://www.sst.dk/en/english/corona-eng/status-of-the-epidemic/covid-19-updates-statistics-and-charts,42419422,41979836,0,0,0.30334663530572514,0,0,42309953,42089305
Denmark,2021-12-16,84399258,84399258,0,https://www.sst.dk/en/english/corona-eng/status-of-the-epidemic/covid-19-updates-statistics-and-charts,42419422,41979836,0,0,0.30334663530572514,0,0,42309953,42089305
Denmark,2021-12-17,84399258,84399258,0,https://www.sst.dk/en/english/corona-eng/status-of-the-epidemic/covid-19-updates-statistics-and-charts,42419422,41979836,0,0,0.30334663530572514,0,0,42309953,42089305
Denmark,2021-12-18,84399258,84399258,0,https://www.sst.dk/en/english/corona-eng/status-of-the-epidemic/covid-19-updates-statistics-and-charts,42419422,41979836,0,0,0.30334663530572514,0,0,42309953,42089305
Denmark,2021-12-19,84399258,84399258,0,https://www.sst.dk/en/english/corona-eng/status-of-the-epidemic/covid-19-updates-statistics-and-charts,42419422,41979836,0,0,0.30334663530572514,0,0,42309953,42089305
Denmark,2021-12-20,84399258,84399258,0,https://www.sst.dk/en/english/corona-eng/status-of-the-epidemic/covid-19-updates-statistics-and-charts,42419422,41979836,0,0,0.30334663530572514,0,0,42309953,42089305
Denmark,2021-12-21,84399258,84399258,0,https://www.sst.dk/en/english/corona-eng/status-of-the-epidemic/covid-19-updates-statistics-and-charts,42419422,41979836,0,0,0.30334663530572514,0,0,42309953,42089305
Denmark,2021-12-22,84399258,84399258,0,https://www.sst.dk/en/english/corona-eng/status-of-the-epidemic/covid-19-updates-statistics-and-charts,42419422,41979836,0,0,0.30334663530572514,0,0,42309953,42089305
Denmark,2021-12-23,84399258,84399258,0,https://www.sst.dk/en/english/corona-eng/status-of-the-epidemic/covid-19-updates-statistics-and-charts,42419422,41979836,0,0,0.30334663530572514,0,0,42309953,42089305
Denmark,2021-12-24,84399258,84399258,0,https://www.sst.dk/en/english/corona-eng/status-of-the-epidemic/covid-19-updates-statistics-and-charts,42419422,41979836,0,0,0.30334663530572514,0,0,42309953,42089305
Denmark,2021-12-25,84399258,84399258,0,https://www.sst.dk/en/english/corona-eng/status-of-the-epidemic/covid-19-updates-statistics-and-charts,42419422,41979836,0,0,0.30334663530572514,0,0,42309953,42089305
Denmark,2021-12-26,84399258,84399258,0,https://www.sst.dk/en/english/corona-eng/status-of-the-epidemic/covid-19-updates-statistics-and-charts,42419422,41979836,0,0,0.30334663530572514,0,0,42309953,42089305
Denmark,2021-12-27,105287999,105287999,20888741,https://www.sst.dk/en/english/corona-eng/status-of-the-epidemic/covid-19-updates-statistics-and-charts,42419422,41979836,0,0,0.30334663530572514,14552212,6336529,56862165,48425834
Denmark,2021-12-28,105287999,105287999,0,https://www.sst.dk/en/english/corona-eng/status-of-the-epidemic/covid-19-updates-statistics-and-charts,42419422,41979836,0,0,0.30334663530572514,0,0,56862165,48425834
Denmark,2021-12-29,105287999,105287999,0,https://www.sst.dk/en/english/corona-eng/status-of-the-epidemic/covid-19-updates-statistics-and-charts,42419422,41979836,0,0,0.30334663530572514,0,0,56862165,48425834
Denmark,2021-12-30,106452714,106452714,1164715,https://www.sst.dk/en/english/corona-eng/status-of-the-epidemic/covid-19-updates-statistics-and-charts,42419422,41979836,0,0,0.30334663530572514,811403,353312,57673568,48779146
Denmark,2021-12-31,106452714,106452714,0,https://www.sst.dk/en/english/corona-eng/status-of-the-epidemic/covid-19-updates-statistics-and-charts,42419422,41979836,0,0,0.30334663530572514,0,0,57673568,48779146
Denmark,2022-01-01,106452714,106452714,0,https://www.sst.dk/en/english/corona-eng/status-of-the-epidemic/covid-19-updates-statistics-and-charts,42419422,41979836,0,0,0.30334663530572514,0,0,57673568,48779146
Denmark,2022-01-02,106452714,106452714,0,https://www.sst.dk/en/english/corona-eng/status-of-the-epidemic/covid-19-updates-statistics-and-charts,42419422,41979836,0,0,0.30334663530572514,0,0,57673568,48779146
Denmark,2022-01-03,106452714,106452714,0,https://www.sst.dk/en/english/corona-eng/status-of-the-epidemic/covid-19-updates-statistics-and-charts,42419422,41979836,0,0,0.30334663530572514,0,0,57673568,48779146
Denmark,2022-01-04,106452714,106452714,0,https://www.sst.dk/en/english/corona-eng/status-of-the-epidemic/covid-19-updates-statistics-and-charts,42419422,41979836,0,0,0.30334663530572514,0,0,57673568,48779146
Denmark,2022-01-05,106452714,106452714,0,https://www.sst.dk/en/english/corona-eng/status-of-the-epidemic/covid-19-updates-statistics-and-charts,42419422,41979836,0,0,0.30334663530572514,0,0,57673568,48779146
Denmark,2022-01-06,106452714,106452714,0,https://www.sst.dk/en/english/corona-eng/status-of-the-epidemic/covid-19-updates-statistics-and-charts,42419422,41979836,0,0,0.30334663530572514,0,0,57673568,48779146
Denmark,2022-01-07,106452714,106452714,0,https://www.sst.dk/en/english/corona-eng/status-of-the-epidemic/covid-19-updates-statistics-and-charts,42419422,41979836,0,0,0.30334663530572514,0,0,57673568,48779146
Denmark,2022-01-08,106452714,106452714,0,https://www.sst.dk/en/english/corona-eng/status-of-the-epidemic/covid-19-updates-statistics-and-charts,42419422,41979836,0,0,0.30334663530572514,0,0,57673568,48779146
Denmark,2022-01-09,106452714,106452714,0,https://www.sst.dk/en/english/corona-eng/status-of-the-epidemic/covid-19-updates-statistics-and-charts,42419422,41979836,0,0,0.30334663530572514,0,0,57673568,48779146
Denmark,2022-01-10,106452714,106452714,0,https://www.sst.dk/en/english/corona-eng/status-of-the-epidemic/covid-19-updates-statistics-and-charts,42419422,41979836,0,0,0.30334663530572514,0,0,57673568,48779146
Denmark,2022-01-11,106452714,106452714,0,https://www.sst.dk/en/english/corona-eng/status-of-the-epidemic/covid-19-updates-statistics-and-charts,42419422,41979836,0,0,0.30334663530572514,0,0,57673568,48779146
Denmark,2022-01-12,106452714,106452714,0,https://www.sst.dk/en/english/corona-eng/status-of-the-epidemic/covid-19-updates-statistics-and-charts,42419422,41979836,0,0,0.30334663530572514,0,0,57673568,48779146
Denmark,2022-01-13,106452714,106452714,0,https://www.sst.dk/en/english/corona-eng/status-of-the-epidemic/covid-19-updates-statistics-and-charts,42419422,41979836,0,0,0.30334663530572514,0,0,57673568,48779146
Denmark,2022-01-14,106452714,106452714,0,https://www.sst.dk/en/english/corona-eng/status-of-the-epidemic/covid-19-updates-statistics-and-charts,42419422,41979836,0,0,0.30334663530572514,0,0,57673568,48779146
Denmark,2022-01-15,106452714,106452714,0,https://www.sst.dk/en/english/corona-eng/status-of-the-epidemic/covid-19-updates-statistics-and-charts,42419422,41979836,0,0,0.30334663530572514,0,0,57673568,48779146
Denmark,2022-01-16,106452714,106452714,0,https://www.sst.dk/en/english/corona-eng/status-of-the-epidemic/covid-19-updates-statistics-and-charts,42419422,41979836,0,0,0.30334663530572514,0,0,57673568,48779146
Denmark,2022-01-17,106452714,106452714,0,https://www.sst.dk/en/english/corona-eng/status-of-the-epidemic/covid-19-updates-statistics-and-charts,42419422,41979836,0,0,0.30334663530572514,0,0,57673568,48779146
Denmark,2022-01-18,106452714,106452714,0,https://www.sst.dk/en/english/corona-eng/status-of-the-epidemic/covid-19-updates-statistics-and-charts,42419422,41979836,0,0,0.30334663530572514,0,0,57673568,48779146
Denmark,2022-01-19,106452714,106452714,0,https://www.sst.dk/en/english/corona-eng/status-of-the-epidemic/covid-19-updates-statistics-and-charts,42419422,41979836,0,0,0.30334663530572514,0,0,57673568,48779146
Denmark,2022-01-20,106452714,106452714,0,https://www.sst.dk/en/english/corona-eng/status-of-the-epidemic/covid-19-updates-statistics-and-charts,42419422,41979836,0,0,0.30334663530572514,0,0,57673568,48779146
Denmark,2022-01-21,106452714,106452714,0,https://www.sst.dk/en/english/corona-eng/status-of-the-epidemic/covid-19-updates-statistics-and-charts,42419422,41979836,0,0,0.30334663530572514,0,0,57673568,48779146
Denmark,2022-01-22,106452714,106452714,0,https://www.sst.dk/en/english/corona-eng/status-of-the-epidemic/covid-19-updates-statistics-and-charts,42419422,41979836,0,0,0.30334663530572514,0,0,57673568,48779146
Denmark,2022-01-23,106452714,106452714,0,https://www.sst.dk/en/english/corona-eng/status-of-the-epidemic/covid-19-updates-statistics-and-charts,42419422,41979836,0,0,0.30334663530572514,0,0,57673568,48779146
Denmark,2022-01-24,106452714,106452714,0,https://www.sst.dk/en/english/corona-eng/status-of-the-epidemic/covid-19-updates-statistics-and-charts,42419422,41979836,0,0,0.30334663530572514,0,0,57673568,48779146
Denmark,2022-01-25,106452714,106452714,0,https://www.sst.dk/en/english/corona-eng/status-of-the-epidemic/covid-19-updates-statistics-and-charts,42419422,41979836,0,0,0.30334663530572514,0,0,57673568,48779146
Denmark,2022-01-26,106452714,106452714,0,https://www.sst.dk/en/english/corona-eng/status-of-the-epidemic/covid-19-updates-statistics-and-charts,42419422,41979836,0,0,0.30334663530572514,0,0,57673568,48779146
Denmark,2022-01-27,106452714,106452714,0,https://www.sst.dk/en/english/corona-eng/status-of-the-epidemic/covid-19-updates-statistics-and-charts,42419422,41979836,0,0,0.30334663530572514,0,0,57673568,48779146
Denmark,2022-01-28,106452714,106452714,0,https://www.sst.dk/en/english/corona-eng/status-of-the-epidemic/covid-19-updates-statistics-and-charts,42419422,41979836,0,0,0.30334663530572514,0,0,57673568,48779146
Denmark,2022-01-29,106452714,106452714,0,https://www.sst.dk/en/english/corona-eng/status-of-the-epidemic/covid-19-updates-statistics-and-charts,42419422,41979836,0,0,0.30334663530572514,0,0,57673568,48779146
Denmark,2022-01-30,106452714,106452714,0,https://www.sst.dk/en/english/corona-eng/status-of-the-epidemic/covid-19-updates-statistics-and-charts,42419422,41979836,0,0,0.30334663530572514,0,0,57673568,48779146
Denmark,2022-01-31,106452714,106452714,0,https://www.sst.dk/en/english/corona-eng/status-of-the-epidemic/covid-19-updates-statistics-and-charts,42419422,41979836,0,0,0.30334663530572514,0,0,57673568,48779146
Denmark,2022-02-01,106452714,106452714,0,https://www.sst.dk/en/english/corona-eng/status-of-the-epidemic/covid-19-updates-statistics-and-charts,42419422,41979836,0,0,0.30334663530572514,0,0,57673568,48779146
Denmark,2022-02-02,106452714,106452714,0,https://www.sst.dk/en/english/corona-eng/status-of-the-epidemic/covid-19-updates-statistics-and-charts,42419422,41979836,0,0,0.30334663530572514,0,0,57673568,48779146
Denmark,2022-02-03,106452714,106452714,0,https://www.sst.dk/en/english/corona-eng/status-of-the-epidemic/covid-19-updates-statistics-and-charts,42419422,41979836,0,0,0.30334663530572514,0,0,57673568,48779146
Denmark,2022-02-04,106452714,106452714,0,https://www.sst.dk/en/english/corona-eng/status-of-the-epidemic/covid-19-updates-statistics-and-charts,42419422,41979836,0,0,0.30334663530572514,0,0,57673568,48779146
Denmark,2022-02-05,106452714,106452714,0,https://www.sst.dk/en/english/corona-eng/status-of-the-epidemic/covid-19-updates-statistics-and-charts,42419422,41979836,0,0,0.30334663530572514,0,0,57673568,48779146
Denmark,2022-02-06,106452714,106452714,0,https://www.sst.dk/en/english/corona-eng/status-of-the-epidemic/covid-19-updates-statistics-and-charts,42419422,41979836,0,0,0.30334663530572514,0,0,57673568,48779146
Denmark,2022-02-07,106452714,106452714,0,https://www.sst.dk/en/english/corona-eng/status-of-the-epidemic/covid-19-updates-statistics-and-charts,42419422,41979836,0,0,0.30334663530572514,0,0,57673568,48779146
Denmark,2022-02-08,106452714,106452714,0,https://www.sst.dk/en/english/corona-eng/status-of-the-epidemic/covid-19-updates-statistics-and-charts,42419422,41979836,0,0,0.30334663530572514,0,0,57673568,48779146
Denmark,2022-02-09,106452714,106452714,0,https://www.sst.dk/en/english/corona-eng/status-of-the-epidemic/covid-19-updates-statistics-and-charts,42419422,41979836,0,0,0.30334663530572514,0,0,57673568,48779146
Denmark,2022-02-10,106452714,106452714,0,https://www.sst.dk/en/english/corona-eng/status-of-the-epidemic/covid-19-updates-statistics-and-charts,42419422,41979836,0,0,0.30334663530572514,0,0,57673568,48779146
Denmark,2022-02-11,106452714,106452714,0,https://www.sst.dk/en/english/corona-eng/status-of-the-epidemic/covid-19-updates-statistics-and-charts,42419422,41979836,0,0,0.30334663530572514,0,0,57673568,48779146
Denmark,2022-02-12,106452714,106452714,0,https://www.sst.dk/en/english/corona-eng/status-of-the-epidemic/covid-19-updates-statistics-and-charts,42419422,41979836,0,0,0.30334663530572514,0,0,57673568,48779146
Denmark,2022-02-13,106452714,106452714,0,https://www.sst.dk/en/english/corona-eng/status-of-the-epidemic/covid-19-updates-statistics-and-charts,42419422,41979836,0,0,0.30334663530572514,0,0,57673568,48779146
Denmark,2022-02-14,106452714,106452714,0,https://www.sst.dk/en/english/corona-eng/status-of-the-epidemic/covid-19-updates-statistics-and-charts,42419422,41979836,0,0,0.30334663530572514,0,0,57673568,48779146
Denmark,2022-02-15,106452714,106452714,0,https://www.sst.dk/en/english/corona-eng/status-of-the-epidemic/covid-19-updates-statistics-and-charts,42419422,41979836,0,0,0.30334663530572514,0,0,57673568,48779146
Denmark,2022-02-16,106452714,106452714,0,https://www.sst.dk/en/english/corona-eng/status-of-the-epidemic/covid-19-updates-statistics-and-charts,42419422,41979836,0,0,0.30334663530572514,0,0,57673568,48779146
Denmark,2022-02-17,106452714,106452714,0,https://www.sst.dk/en/english/corona-eng/status-of-the-epidemic/covid-19-updates-statistics-and-charts,42419422,41979836,0,0,0.30334663530572514,0,0,57673568,48779146
Denmark,2022-02-18,106452714,106452714,0,https://www.sst.dk/en/english/corona-eng/status-of-the-epidemic/covid-19-updates-statistics-and-charts,42419422,41979836,0,0,0.30334663530572514,0,0,57673568,48779146
Denmark,2022-02-19,106452714,106452714,0,https://www.sst.dk/en/english/corona-eng/status-of-the-epidemic/covid-19-updates-statistics-and-charts,42419422,41979836,0,0,0.30334663530572514,0,0,57673568,48779146
Denmark,2022-02-20,106452714,106452714,0,https://www.sst.dk/en/english/corona-eng/status-of-the-epidemic/covid-19-updates-statistics-and-charts,42419422,41979836,0,0,0.30334663530572514,0,0,57673568,48779146
Denmark,2022-02-21,106452714,106452714,0,https://www.sst.dk/en/english/corona-eng/status-of-the-epidemic/covid-19-updates-statistics-and-charts,42419422,41979836,0,0,0.30334663530572514,0,0,57673568,48779146
Denmark,2022-02-22,106452714,106452714,0,https://www.sst.dk/en/english/corona-eng/status-of-the-epidemic/covid-19-updates-statistics-and-charts,42419422,41979836,0,0,0.30334663530572514,0,0,57673568,48779146
Denmark,2022-02-23,106452714,106452714,0,https://www.sst.dk/en/english/corona-eng/status-of-the-epidemic/covid-19-updates-statistics-and-charts,42419422,41979836,0,0,0.30334663530572514,0,0,57673568,48779146
Denmark,2022-02-24,106452714,106452714,0,https://www.sst.dk/en/english/corona-eng/status-of-the-epidemic/covid-19-updates-statistics-and-charts,42419422,41979836,0,0,0.30334663530572514,0,0,57673568,48779146
Denmark,2022-02-25,106452714,106452714,0,https://www.sst.dk/en/english/corona-eng/status-of-the-epidemic/covid-19-updates-statistics-and-charts,42419422,41979836,0,0,0.30334663530572514,0,0,57673568,48779146
Denmark,2022-02-26,106452714,106452714,0,https://www.sst.dk/en/english/corona-eng/status-of-the-epidemic/covid-19-updates-statistics-and-charts,42419422,41979836,0,0,0.30334663530572514,0,0,57673568,48779146
Denmark,2022-02-27,106452714,106452714,0,https://www.sst.dk/en/english/corona-eng/status-of-the-epidemic/covid-19-updates-statistics-and-charts,42419422,41979836,0,0,0.30334663530572514,0,0,57673568,48779146
Denmark,2022-02-28,106452714,106452714,0,https://www.sst.dk/en/english/corona-eng/status-of-the-epidemic/covid-19-updates-statistics-and-charts,42419422,41979836,0,0,0.30334663530572514,0,0,57673568,48779146
Denmark,2022-03-01,106452714,106452714,0,https://www.sst.dk/en/english/corona-eng/status-of-the-epidemic/covid-19-updates-statistics-and-charts,42419422,41979836,0,0,0.30334663530572514,0,0,57673568,48779146
Denmark,2022-03-02,106452714,106452714,0,https://www.sst.dk/en/english/corona-eng/status-of-the-epidemic/covid-19-updates-statistics-and-charts,42419422,41979836,0,0,0.30334663530572514,0,0,57673568,48779146
Denmark,2022-03-03,106452714,106452714,0,https://www.sst.dk/en/english/corona-eng/status-of-the-epidemic/covid-19-updates-statistics-and-charts,42419422,41979836,0,0,0.30334663530572514,0,0,57673568,48779146
Denmark,2022-03-04,106452714,106452714,0,https://www.sst.dk/en/english/corona-eng/status-of-the-epidemic/covid-19-updates-statistics-and-charts,42419422,41979836,0,0,0.30334663530572514,0,0,57673568,48779146
Denmark,2022-03-05,106452714,106452714,0,https://www.sst.dk/en/english/corona-eng/status-of-the-epidemic/covid-19-updates-statistics-and-charts,42419422,41979836,0,0,0.30334663530572514,0,0,57673568,48779146
Denmark,2022-03-06,106452714,106452714,0,https://www.sst.dk/en/english/corona-eng/status-of-the-epidemic/covid-19-updates-statistics-and-charts,42419422,41979836,0,0,0.30334663530572514,0,0,57673568,48779146
Denmark,2022-03-07,106452714,106452714,0,https://www.sst.dk/en/english/corona-eng/status-of-the-epidemic/covid-19-updates-statistics-and-charts,42419422,41979836,0,0,0.30334663530572514,0,0,57673568,48779146
Denmark,2022-03-08,106452714,106452714,0,https://www.sst.dk/en/english/corona-eng/status-of-the-epidemic/covid-19-updates-statistics-and-charts,42419422,41979836,0,0,0.30334663530572514,0,0,57673568,48779146
Denmark,2022-03-09,106452714,106452714,0,https://www.sst.dk/en/english/corona-eng/status-of-the-epidemic/covid-19-updates-statistics-and-charts,42419422,41979836,0,0,0.30334663530572514,0,0,57673568,48779146
Denmark,2022-03-10,106452714,106452714,0,https://www.sst.dk/en/english/corona-eng/status-of-the-epidemic/covid-19-updates-statistics-and-charts,42419422,41979836,0,0,0.30334663530572514,0,0,57673568,48779146
Denmark,2022-03-11,106452714,106452714,0,https://www.sst.dk/en/english/corona-eng/status-of-the-epidemic/covid-19-updates-statistics-and-charts,42419422,41979836,0,0,0.30334663530572514,0,0,57673568,48779146
Denmark,2022-03-12,106452714,106452714,0,https://www.sst.dk/en/english/corona-eng/status-of-the-epidemic/covid-19-updates-statistics-and-charts,42419422,41979836,0,0,0.30334663530572514,0,0,57673568,48779146
Denmark,2022-03-13,106452714,106452714,0,https://www.sst.dk/en/english/corona-eng/status-of-the-epidemic/covid-19-updates-statistics-and-charts,42419422,41979836,0,0,0.30334663530572514,0,0,57673568,48779146
Denmark,2022-03-14,106452714,106452714,0,https://www.sst.dk/en/english/corona-eng/status-of-the-epidemic/covid-19-updates-statistics-and-charts,42419422,41979836,0,0,0.30334663530572514,0,0,57673568,48779146
Denmark,2022-03-15,106452714,106452714,0,https://www.sst.dk/en/english/corona-eng/status-of-the-epidemic/covid-19-updates-statistics-and-charts,42419422,41979836,0,0,0.30334663530572514,0,0,57673568,48779146
Denmark,2022-03-16,106452714,106452714,0,https://www.sst.dk/en/english/corona-eng/status-of-the-epidemic/covid-19-updates-statistics-and-charts,42419422,41979836,0,0,0.30334663530572514,0,0,57673568,48779146
Denmark,2022-03-17,106452714,106452714,0,https://www.sst.dk/en/english/corona-eng/status-of-the-epidemic/covid-19-updates-statistics-and-charts,42419422,41979836,0,0,0.30334663530572514,0,0,57673568,48779146
Denmark,2022-03-18,126399266,126399266,19946552,https://www.sst.dk/en/english/corona-eng/status-of-the-epidemic/covid-19-updates-statistics-and-charts,65047470,61351796,22628048,19371960,0.4612370550024657,10746463,9200089,68420031,57979235
Denmark,2022-03-19,126399266,126399266,0,https://www.sst.dk/en/english/corona-eng/status-of-the-epidemic/covid-19-updates-statistics-and-charts,65047470,61351796,0,0,0.4612370550024657,0,0,68420031,57979235
Denmark,2022-03-20,126399266,126399266,0,https://www.sst.dk/en/english/corona-eng/status-of-the-epidemic/covid-19-updates-statistics-and-charts,65047470,61351796,0,0,0.4612370550024657,0,0,68420031,57979235
Denmark,2022-03-21,126399266,126399266,0,https://www.sst.dk/en/english/corona-eng/status-of-the-epidemic/covid-19-updates-statistics-and-charts,65047470,61351796,0,0,0.4612370550024657,0,0,68420031,57979235
Denmark,2022-03-22,126594468,126594468,195202,https://www.sst.dk/en/english/corona-eng/status-of-the-epidemic/covid-19-updates-statistics-and-charts,65237243,61357225,189773,5429,0.02781221503878034,189773,5429,68609804,57984664
Denmark,2022-03-23,126594468,126594468,0,https://www.sst.dk/en/english/corona-eng/status-of-the-epidemic/covid-19-updates-statistics-and-charts,65237243,61357225,0,0,0.02781221503878034,0,0,68609804,57984664
Denmark,2022-03-24,126636126,126636126,41658,https://www.sst.dk/en/english/corona-eng/status-of-the-epidemic/covid-19-updates-statistics-and-charts,65277613,61358513,40370,1288,0.030918431033655,40370,1288,68650174,57985952
Denmark,2022-03-25,126636126,126636126,0,https://www.sst.dk/en/english/corona-eng/status-of-the-epidemic/covid-19-updates-statistics-and-charts,65277613,61358513,0,0,0.030918431033655,0,0,68650174,57985952
Denmark,2022-03-26,126636126,126636126,0,https://www.sst.dk/en/english/corona-eng/status-of-the-epidemic/covid-19-updates-statistics-and-charts,65277613,61358513,0,0,0.030918431033655,0,0,68650174,57985952
Denmark,2022-03-27,126636126,126636126,0,https://www.sst.dk/en/english/corona-eng/status-of-the-epidemic/covid-19-updates-statistics-and-charts,65277613,61358513,0,0,0.030918431033655,0,0,68650174,57985952
Denmark,2022-03-28,126668057,126668057,31931,https://www.sst.dk/en/english/corona-eng/status-of-the-epidemic/covid-19-updates-statistics-and-charts,65308575,61359482,30962,969,0.030346685039616673,30962,969,68681136,57986921
Denmark,2022-03-29,126668057,126668057,0,https://www.sst.dk/en/english/corona-eng/status-of-the-epidemic/covid-19-updates-statistics-and-charts,65308575,61359482,0,0,0.030346685039616673,0,0,68681136,57986921
Denmark,2022-03-30,126783801,126783801,115744,https://www.sst.dk/en/english/corona-eng/status-of-the-epidemic/covid-19-updates-statistics-and-charts,65419736,61364065,111161,4583,0.039596004976499864,111161,4583,68792297,57991504
Denmark,2022-03-31,126783801,126783801,0,https://www.sst.dk/en/english/corona-eng/status-of-the-epidemic/covid-19-updates-statistics-and-charts,65419736,61364065,0,0,0.039596004976499864,0,0,68792297,57991504
Denmark,2022-04-01,126783801,126783801,0,https://www.sst.dk/en/english/corona-eng/status-of-the-epidemic/covid-19-updates-statistics-and-charts,65419736,61364065,0,0,0.039596004976499864,0,0,68792297,57991504
Denmark,2022-04-02,126783801,126783801,0,https://www.sst.dk/en/english/corona-eng/status-of-the-epidemic/covid-19-updates-statistics-and-charts,65419736,61364065,0,0,0.039596004976499864,0,0,68792297,57991504
Denmark,2022-04-03,126783801,126783801,0,https://www.sst.dk/en/english/corona-eng/status-of-the-epidemic/covid-19-updates-statistics-and-charts,65419736,61364065,0,0,0.039596004976499864,0,0,68792297,57991504
Denmark,2022-04-04,126783801,126783801,0,https://www.sst.dk/en/english/corona-eng/status-of-the-epidemic/covid-19-updates-statistics-and-charts,65419736,61364065,0,0,0.039596004976499864,0,0,68792297,57991504
Denmark,2022-04-05,126879654,126879654,95853,https://www.sst.dk/en/english/corona-eng/status-of-the-epidemic/covid-19-updates-statistics-and-charts,65510073,61369581,90337,5516,0.05754645133694303,90337,5516,68882634,57997020
Denmark,2022-04-06,126901505,126901505,21851,https://www.sst.dk/en/english/corona-eng/status-of-the-epidemic/covid-19-updates-statistics-and-charts,65530985,61370520,20912,939,0.042972861653928884,20912,939,68903546,57997959
Denmark,2022-04-07,126942420,126942420,40915,https://www.sst.dk/en/english/corona-eng/status-of-the-epidemic/covid-19-updates-statistics-and-charts,65549823,6171881,18838,-55198639,0.042972861653928884,39157,1758,68942703,57999717
Denmark,2022-04-08,126942420,126942420,0,https://www.sst.dk/en/english/corona-eng/status-of-the-epidemic/covid-19-updates-statistics-and-charts,65569051,61373369,19228,55201488,0.9996517973435911,0,0,68942703,57999717
Denmark,2022-04-09,126942420,126942420,0,https://www.sst.dk/en/english/corona-eng/status-of-the-epidemic/covid-19-updates-statistics-and-charts,65569051,61373369,0,0,0.9996517973435911,0,0,68942703,57999717
Denmark,2022-04-10,126942420,126942420,0,https://www.sst.dk/en/english/corona-eng/status-of-the-epidemic/covid-19-updates-statistics-and-charts,65569051,61373369,0,0,0.9996517973435911,0,0,68942703,57999717
Denmark,2022-04-11,126986509,126986509,44089,https://www.sst.dk/en/english/corona-eng/status-of-the-epidemic/covid-19-updates-statistics-and-charts,65609669,61376840,40618,3471,0.07872712014334642,40618,3471,68983321,58003188
Denmark,2022-04-12,127005063,127005063,18554,https://www.sst.dk/en/english/corona-eng/status-of-the-epidemic/covid-19-updates-statistics-and-charts,65627342,61377721,17673,881,0.047483022528834753,17673,881,69000994,58004069
Denmark,2022-04-13,127021135,127021135,16072,https://www.sst.dk/en/english/corona-eng/status-of-the-epidemic/covid-19-updates-statistics-and-charts,65642693,61378442,15351,721,0.04486062717770035,15351,721,69016345,58004790
Denmark,2022-04-14,127021135,127021135,0,https://www.sst.dk/en/english/corona-eng/status-of-the-epidemic/covid-19-updates-statistics-and-charts,65642693,61378442,0,0,0.04486062717770035,0,0,69016345,58004790
Denmark,2022-04-15,127021135,127021135,0,https://www.sst.dk/en/english/corona-eng/status-of-the-epidemic/covid-19-updates-statistics-and-charts,65642693,61378442,0,0,0.04486062717770035,0,0,69016345,58004790
Denmark,2022-04-16,127021135,127021135,0,https://www.sst.dk/en/english/corona-eng/status-of-the-epidemic/covid-19-updates-statistics-and-charts,65642693,61378442,0,0,0.04486062717770035,0,0,69016345,58004790
Denmark,2022-04-17,127021135,127021135,0,https://www.sst.dk/en/english/corona-eng/status-of-the-epidemic/covid-19-updates-statistics-and-charts,65642693,61378442,0,0,0.04486062717770035,0,0,69016345,58004790
Denmark,2022-04-18,127021135,127021135,0,https://www.sst.dk/en/english/corona-eng/status-of-the-epidemic/covid-19-updates-statistics-and-charts,65642693,61378442,0,0,0.04486062717770035,0,0,69016345,58004790
Denmark,2022-04-19,127083216,127083216,62081,https://www.sst.dk/en/english/corona-eng/status-of-the-epidemic/covid-19-updates-statistics-and-charts,65700876,61382340,58183,3898,0.0627889370338751,58183,3898,69074528,58008688
Denmark,2022-04-20,127100065,127100065,16849,https://www.sst.dk/en/english/corona-eng/status-of-the-epidemic/covid-19-updates-statistics-and-charts,65716921,61383144,16045,804,0.04771796545789068,16045,804,69090573,58009492
Denmark,2022-04-21,127114943,127114943,14878,https://www.sst.dk/en/english/corona-eng/status-of-the-epidemic/covid-19-updates-statistics-and-charts,65731212,61383731,14291,587,0.039454227718779405,14291,587,69104864,58010079
Denmark,2022-04-22,127128267,127128267,13324,https://www.sst.dk/en/english/corona-eng/status-of-the-epidemic/covid-19-updates-statistics-and-charts,65743873,61384394,12661,663,0.04975983188231762,12661,663,69117525,58010742
Denmark,2022-04-23,127128267,127128267,0,https://www.sst.dk/en/english/corona-eng/status-of-the-epidemic/covid-19-updates-statistics-and-charts,65743873,61384394,0,0,0.04975983188231762,0,0,69117525,58010742
Denmark,2022-04-24,127128267,127128267,0,https://www.sst.dk/en/english/corona-eng/status-of-the-epidemic/covid-19-updates-statistics-and-charts,65743873,61384394,0,0,0.04975983188231762,0,0,69117525,58010742
Denmark,2022-04-25,127159230,127159230,30963,https://www.sst.dk/en/english/corona-eng/status-of-the-epidemic/covid-19-updates-statistics-and-charts,65771836,61387394,27963,3000,0.09688983625617673,27963,3000,69145488,58013742
Denmark,2022-04-26,127172757,127172757,13527,https://www.sst.dk/en/english/corona-eng/status-of-the-epidemic/covid-19-updates-statistics-and-charts,65784500,61388257,12664,863,0.06379832926739114,12664,863,69158152,58014605
Denmark,2022-04-27,127172757,127172757,0,https://www.sst.dk/en/english/corona-eng/status-of-the-epidemic/covid-19-updates-statistics-and-charts,65784500,61388257,0,0,0.06379832926739114,0,0,69158152,58014605
Denmark,2022-04-28,127196800,127196800,24043,https://www.sst.dk/en/english/corona-eng/status-of-the-epidemic/covid-19-updates-statistics-and-charts,65807182,61389618,22682,1361,0.05660691261489831,22682,1361,69180834,58015966
Denmark,2022-04-29,127196800,127196800,0,https://www.sst.dk/en/english/corona-eng/status-of-the-epidemic/covid-19-updates-statistics-and-charts,65807182,61389618,0,0,0.05660691261489831,0,0,69180834,58015966
Denmark,2022-04-30,127196800,127196800,0,https://www.sst.dk/en/english/corona-eng/status-of-the-epidemic/covid-19-updates-statistics-and-charts,65807182,61389618,0,0,0.05660691261489831,0,0,69180834,58015966
Denmark,2022-05-01,127196800,127196800,0,https://www.sst.dk/en/english/corona-eng/status-of-the-epidemic/covid-19-updates-statistics-and-charts,65807182,61389618,0,0,0.05660691261489831,0,0,69180834,58015966
Denmark,2022-05-02,127233608,127233608,36808,https://www.sst.dk/en/english/corona-eng/status-of-the-epidemic/covid-19-updates-statistics-and-charts,65840340,61393268,33158,3650,0.0991632253857857,33158,3650,69213992,58019616
Denmark,2022-05-03,127244848,127244848,11240,https://www.sst.dk/en/english/corona-eng/status-of-the-epidemic/covid-19-updates-statistics-and-charts,65850880,61393968,10540,700,0.06227758007117438,10540,700,69224532,58020316
Denmark,2022-05-04,127244848,127244848,0,https://www.sst.dk/en/english/corona-eng/status-of-the-epidemic/covid-19-updates-statistics-and-charts,65850880,61393968,0,0,0.06227758007117438,0,0,69224532,58020316
Denmark,2022-05-05,127244848,127244848,0,https://www.sst.dk/en/english/corona-eng/status-of-the-epidemic/covid-19-updates-statistics-and-charts,65850880,61393968,0,0,0.06227758007117438,0,0,69224532,58020316
Denmark,2022-05-06,127272381,127272381,27533,https://www.sst.dk/en/english/corona-eng/status-of-the-epidemic/covid-19-updates-statistics-and-charts,65876380,61396001,25500,2033,0.0738386663276795,25500,2033,69250032,58022349
Denmark,2022-05-07,127272381,127272381,0,https://www.sst.dk/en/english/corona-eng/status-of-the-epidemic/covid-19-updates-statistics-and-charts,65876380,61396001,0,0,0.0738386663276795,0,0,69250032,58022349
Denmark,2022-05-08,127272381,127272381,0,https://www.sst.dk/en/english/corona-eng/status-of-the-epidemic/covid-19-updates-statistics-and-charts,65876380,61396001,0,0,0.0738386663276795,0,0,69250032,58022349
Denmark,2022-05-09,127295922,127295922,23541,https://www.sst.dk/en/english/corona-eng/status-of-the-epidemic/covid-19-updates-statistics-and-charts,65897024,61398898,20644,2897,0.12306189201818105,20644,2897,69270676,58025246
Denmark,2022-05-10,127306349,127306349,10427,https://www.sst.dk/en/english/corona-eng/status-of-the-epidemic/covid-19-updates-statistics-and-charts,65906569,61399780,9545,882,0.08458808861609284,9545,882,69280221,58026128
Denmark,2022-05-11,127306349,127306349,0,https://www.sst.dk/en/english/corona-eng/status-of-the-epidemic/covid-19-updates-statistics-and-charts,65906569,61399780,0,0,0.08458808861609284,0,0,69280221,58026128
Denmark,2022-05-12,127324433,127324433,18084,https://www.sst.dk/en/english/corona-eng/status-of-the-epidemic/covid-19-updates-statistics-and-charts,65923224,61401209,16655,1429,0.07902012829020129,16655,1429,69296876,58027557
Denmark,2022-05-13,127324433,127324433,0,https://www.sst.dk/en/english/corona-eng/status-of-the-epidemic/covid-19-updates-statistics-and-charts,65923224,61401209,0,0,0.07902012829020129,0,0,69296876,58027557
Denmark,2022-05-14,127324433,127324433,0,https://www.sst.dk/en/english/corona-eng/status-of-the-epidemic/covid-19-updates-statistics-and-charts,65923224,61401209,0,0,0.07902012829020129,0,0,69296876,58027557
Denmark,2022-05-15,127324433,127324433,0,https://www.sst.dk/en/english/corona-eng/status-of-the-epidemic/covid-19-updates-statistics-and-charts,65923224,61401209,0,0,0.07902012829020129,0,0,69296876,58027557
Denmark,2022-05-16,127352132,127352132,27699,https://www.sst.dk/en/english/corona-eng/status-of-the-epidemic/covid-19-updates-statistics-and-charts,65946102,61406030,22878,4821,0.17404960467886926,22878,4821,69319754,58032378
Denmark,2022-05-17,127352132,127352132,0,https://www.sst.dk/en/english/corona-eng/status-of-the-epidemic/covid-19-updates-statistics-and-charts,65946102,61406030,0,0,0.17404960467886926,0,0,69319754,58032378
Denmark,2022-05-18,127369645,127369645,17513,https://www.sst.dk/en/english/corona-eng/status-of-the-epidemic/covid-19-updates-statistics-and-charts,65961808,61407837,15706,1807,0.10318049448980757,15706,1807,69335460,58034185
Denmark,2022-05-19,127377418,127377418,7773,https://www.sst.dk/en/english/corona-eng/status-of-the-epidemic/covid-19-updates-statistics-and-charts,65968707,61408711,6899,874,0.11244049916377204,6899,874,69342359,58035059
Denmark,2022-05-20,127377418,127377418,0,https://www.sst.dk/en/english/corona-eng/status-of-the-epidemic/covid-19-updates-statistics-and-charts,65968707,61408711,0,0,0.11244049916377204,0,0,69342359,58035059
Denmark,2022-05-21,127377418,127377418,0,https://www.sst.dk/en/english/corona-eng/status-of-the-epidemic/covid-19-updates-statistics-and-charts,65968707,61408711,0,0,0.11244049916377204,0,0,69342359,58035059
Denmark,2022-05-22,127377418,127377418,0,https://www.sst.dk/en/english/corona-eng/status-of-the-epidemic/covid-19-updates-statistics-and-charts,65968707,61408711,0,0,0.11244049916377204,0,0,69342359,58035059
Denmark,2022-05-23,127377418,127377418,0,https://www.sst.dk/en/english/corona-eng/status-of-the-epidemic/covid-19-updates-statistics-and-charts,65968707,61408711,0,0,0.11244049916377204,0,0,69342359,58035059
Denmark,2022-05-24,127419881,127419881,42463,https://www.sst.dk/en/english/corona-eng/status-of-the-epidemic/covid-19-updates-statistics-and-charts,65968707,61408711,0,0,0.11244049916377204,37688,4775,69380047,58039834
Denmark,2022-05-25,127419881,127419881,0,https://www.sst.dk/en/english/corona-eng/status-of-the-epidemic/covid-19-updates-statistics-and-charts,65968707,61408711,0,0,0.11244049916377204,0,0,69380047,58039834
Denmark,2022-05-26,127419881,127419881,0,https://www.sst.dk/en/english/corona-eng/status-of-the-epidemic/covid-19-updates-statistics-and-charts,65968707,61408711,0,0,0.11244049916377204,0,0,69380047,58039834
Denmark,2022-05-27,127419881,127419881,0,https://www.sst.dk/en/english/corona-eng/status-of-the-epidemic/covid-19-updates-statistics-and-charts,65968707,61408711,0,0,0.11244049916377204,0,0,69380047,58039834
Denmark,2022-05-28,127419881,127419881,0,https://www.sst.dk/en/english/corona-eng/status-of-the-epidemic/covid-19-updates-statistics-and-charts,65968707,61408711,0,0,0.11244049916377204,0,0,69380047,58039834
Denmark,2022-05-29,127419881,127419881,0,https://www.sst.dk/en/english/corona-eng/status-of-the-epidemic/covid-19-updates-statistics-and-charts,65968707,61408711,0,0,0.11244049916377204,0,0,69380047,58039834
Denmark,2022-05-30,127454157,127454157,34276,https://www.sst.dk/en/english/corona-eng/status-of-the-epidemic/covid-19-updates-statistics-and-charts,65968707,61408711,0,0,0.11244049916377204,30422,3854,69410469,58043688
Denmark,2022-05-31,127454157,127454157,0,https://www.sst.dk/en/english/corona-eng/status-of-the-epidemic/covid-19-updates-statistics-and-charts,65968707,61408711,0,0,0.11244049916377204,0,0,69410469,58043688
Denmark,2022-06-01,127454157,127454157,0,https://www.sst.dk/en/english/corona-eng/status-of-the-epidemic/covid-19-updates-statistics-and-charts,65968707,61408711,0,0,0.11244049916377204,0,0,69410469,58043688
Denmark,2022-06-02,127454157,127454157,0,https://www.sst.dk/en/english/corona-eng/status-of-the-epidemic/covid-19-updates-statistics-and-charts,65968707,61408711,0,0,0.11244049916377204,0,0,69410469,58043688
Denmark,2022-06-03,127454157,127454157,0,https://www.sst.dk/en/english/corona-eng/status-of-the-epidemic/covid-19-updates-statistics-and-charts,65968707,61408711,0,0,0.11244049916377204,0,0,69410469,58043688
Denmark,2022-06-04,127454157,127454157,0,https://www.sst.dk/en/english/corona-eng/status-of-the-epidemic/covid-19-updates-statistics-and-charts,65968707,61408711,0,0,0.11244049916377204,0,0,69410469,58043688
Denmark,2022-06-05,127454157,127454157,0,https://www.sst.dk/en/english/corona-eng/status-of-the-epidemic/covid-19-updates-statistics-and-charts,65968707,61408711,0,0,0.11244049916377204,0,0,69410469,58043688
Denmark,2022-06-06,127454157,127454157,0,https://www.sst.dk/en/english/corona-eng/status-of-the-epidemic/covid-19-updates-statistics-and-charts,65968707,61408711,0,0,0.11244049916377204,0,0,69410469,58043688
Denmark,2022-06-07,127454157,127454157,0,https://www.sst.dk/en/english/corona-eng/status-of-the-epidemic/covid-19-updates-statistics-and-charts,65968707,61408711,0,0,0.11244049916377204,0,0,69410469,58043688
Denmark,2022-06-08,127454157,127454157,0,https://www.sst.dk/en/english/corona-eng/status-of-the-epidemic/covid-19-updates-statistics-and-charts,65968707,61408711,0,0,0.11244049916377204,0,0,69410469,58043688
Denmark,2022-06-09,127454157,127454157,0,https://www.sst.dk/en/english/corona-eng/status-of-the-epidemic/covid-19-updates-statistics-and-charts,65968707,61408711,0,0,0.11244049916377204,0,0,69410469,58043688
Denmark,2022-06-10,127454157,127454157,0,https://www.sst.dk/en/english/corona-eng/status-of-the-epidemic/covid-19-updates-statistics-and-charts,65968707,61408711,0,0,0.11244049916377204,0,0,69410469,58043688
Denmark,2022-06-11,127454157,127454157,0,https://www.sst.dk/en/english/corona-eng/status-of-the-epidemic/covid-19-updates-statistics-and-charts,65968707,61408711,0,0,0.11244049916377204,0,0,69410469,58043688
Denmark,2022-06-12,127507642,127507642,53485,https://www.sst.dk/en/english/corona-eng/status-of-the-epidemic/covid-19-updates-statistics-and-charts,65968707,61408711,0,0,0.11244049916377204,47471,6014,69457940,58049702
Denmark,2022-06-13,127507642,127507642,0,https://www.sst.dk/en/english/corona-eng/status-of-the-epidemic/covid-19-updates-statistics-and-charts,65968707,61408711,0,0,0.11244049916377204,0,0,69457940,58049702
Denmark,2022-06-14,127548638,127548638,40996,https://www.sst.dk/en/english/corona-eng/status-of-the-epidemic/covid-19-updates-statistics-and-charts,65968707,61408711,0,0,0.11244049916377204,36386,4610,69494326,58054312
Denmark,2022-06-15,127556361,127556361,7723,https://www.sst.dk/en/english/corona-eng/status-of-the-epidemic/covid-19-updates-statistics-and-charts,65968707,61408711,0,0,0.11244049916377204,6855,868,69501181,58055180
Denmark,2022-06-16,127556361,127556361,0,https://www.sst.dk/en/english/corona-eng/status-of-the-epidemic/covid-19-updates-statistics-and-charts,65968707,61408711,0,0,0.11244049916377204,0,0,69501181,58055180
Denmark,2022-06-17,127556361,127556361,0,https://www.sst.dk/en/english/corona-eng/status-of-the-epidemic/covid-19-updates-statistics-and-charts,66128821,61434595,160114,25884,0.13916278669663115,0,0,69501181,58055180
Denmark,2022-06-18,127563416,127563416,7055,https://www.sst.dk/en/english/corona-eng/status-of-the-epidemic/covid-19-updates-statistics-and-charts,66128821,61434595,0,0,0.13916278669663115,6073,982,69507254,58056162
Denmark,2022-06-19,127563416,127563416,0,https://www.sst.dk/en/english/corona-eng/status-of-the-epidemic/covid-19-updates-statistics-and-charts,66128821,61434595,0,0,0.13916278669663115,0,0,69507254,58056162
Denmark,2022-06-20,127581612,127581612,18196,https://www.sst.dk/en/english/corona-eng/status-of-the-epidemic/covid-19-updates-statistics-and-charts,66146183,61435429,17362,834,0.045834249285557266,17362,834,69524616,58056996
Denmark,2022-06-21,127581612,127581612,0,https://www.sst.dk/en/english/corona-eng/status-of-the-epidemic/covid-19-updates-statistics-and-charts,66146183,61435429,0,0,0.045834249285557266,0,0,69524616,58056996
Denmark,2022-06-22,127592552,127592552,10940,https://www.sst.dk/en/english/corona-eng/status-of-the-epidemic/covid-19-updates-statistics-and-charts,66156611,61435941,10428,512,0.04680073126142596,10428,512,69535044,58057508
Denmark,2022-06-23,127592552,127592552,0,https://www.sst.dk/en/english/corona-eng/status-of-the-epidemic/covid-19-updates-statistics-and-charts,66156611,61435941,0,0,0.04680073126142596,0,0,69535044,58057508
Denmark,2022-06-24,127597910,127597910,5358,https://www.sst.dk/en/english/corona-eng/status-of-the-epidemic/covid-19-updates-statistics-and-charts,66161148,61436762,4537,821,0.1532288167226577,4537,821,69539581,58058329
Denmark,2022-06-25,127597910,127597910,0,https://www.sst.dk/en/english/corona-eng/status-of-the-epidemic/covid-19-updates-statistics-and-charts,66161148,61436762,0,0,0.1532288167226577,0,0,69539581,58058329
Denmark,2022-06-26,127597910,127597910,0,https://www.sst.dk/en/english/corona-eng/status-of-the-epidemic/covid-19-updates-statistics-and-charts,66161148,61436762,0,0,0.1532288167226577,0,0,69539581,58058329
Denmark,2022-06-27,127638567,127638567,40657,https://www.sst.dk/en/english/corona-eng/status-of-the-epidemic/covid-19-updates-statistics-and-charts,66200944,61437623,39796,861,0.021177165063826647,39796,861,69579377,58059190
Denmark,2022-06-28,127638567,127638567,0,https://www.sst.dk/en/english/corona-eng/status-of-the-epidemic/covid-19-updates-statistics-and-charts,66200944,61437623,0,0,0.021177165063826647,0,0,69579377,58059190
Denmark,2022-06-29,127638567,127638567,0,https://www.sst.dk/en/english/corona-eng/status-of-the-epidemic/covid-19-updates-statistics-and-charts,66223838,61438268,22894,645,0.02740133395641276,0,0,69579377,58059190
Denmark,2022-06-30,127662106,127662106,23539,https://www.sst.dk/en/english/corona-eng/status-of-the-epidemic/covid-19-updates-statistics-and-charts,66223838,61438268,0,0,0.02740133395641276,22894,645,69602271,58059835
Denmark,2022-07-01,127662106,127662106,0,https://www.sst.dk/en/english/corona-eng/status-of-the-epidemic/covid-19-updates-statistics-and-charts,66223838,61438268,0,0,0.02740133395641276,0,0,69602271,58059835
Denmark,2022-07-02,127662106,127662106,0,https://www.sst.dk/en/english/corona-eng/status-of-the-epidemic/covid-19-updates-statistics-and-charts,66223838,61438268,0,0,0.02740133395641276,0,0,69602271,58059835
Denmark,2022-07-03,127662106,127662106,0,https://www.sst.dk/en/english/corona-eng/status-of-the-epidemic/covid-19-updates-statistics-and-charts,66223838,61438268,0,0,0.02740133395641276,0,0,69602271,58059835
Denmark,2022-07-04,127704991,127704991,42885,https://www.sst.dk/en/english/corona-eng/status-of-the-epidemic/covid-19-updates-statistics-and-charts,66265055,61439936,41217,1668,0.03889471843301854,41217,1668,69643488,58061503
Denmark,2022-07-05,127718284,127718284,13293,https://www.sst.dk/en/english/corona-eng/status-of-the-epidemic/covid-19-updates-statistics-and-charts,66277920,61440364,12865,428,0.03219739712630708,12865,428,69656353,58061931
Denmark,2022-07-06,127718284,127718284,0,https://www.sst.dk/en/english/corona-eng/status-of-the-epidemic/covid-19-updates-statistics-and-charts,66277920,61440364,0,0,0.03219739712630708,0,0,69656353,58061931
Denmark,2022-07-07,127718284,127718284,0,https://www.sst.dk/en/english/corona-eng/status-of-the-epidemic/covid-19-updates-statistics-and-charts,66277920,61440364,0,0,0.03219739712630708,0,0,69656353,58061931
Denmark,2022-07-08,127752435,127752435,34151,https://www.sst.dk/en/english/corona-eng/status-of-the-epidemic/covid-19-updates-statistics-and-charts,66310545,61441890,32625,1526,0.044683903838833416,32625,1526,69688978,58063457
Denmark,2022-07-09,127752435,127752435,0,https://www.sst.dk/en/english/corona-eng/status-of-the-epidemic/covid-19-updates-statistics-and-charts,66310545,61441890,0,0,0.044683903838833416,0,0,69688978,58063457
Denmark,2022-07-10,127752435,127752435,0,https://www.sst.dk/en/english/corona-eng/status-of-the-epidemic/covid-19-updates-statistics-and-charts,66310545,61441890,0,0,0.044683903838833416,0,0,69688978,58063457
Denmark,2022-07-11,127752435,127752435,0,https://www.sst.dk/en/english/corona-eng/status-of-the-epidemic/covid-19-updates-statistics-and-charts,66310545,61441890,0,0,0.044683903838833416,0,0,69688978,58063457
Denmark,2022-07-12,127792668,127792668,40233,https://www.sst.dk/en/english/corona-eng/status-of-the-epidemic/covid-19-updates-statistics-and-charts,66348639,61444029,38094,2139,0.05316531205726642,38094,2139,69727072,58065596
Denmark,2022-07-13,127804276,127804276,11608,https://www.sst.dk/en/english/corona-eng/status-of-the-epidemic/covid-19-updates-statistics-and-charts,66359853,61444423,11214,394,0.0339421088904204,11214,394,69738286,58065990
Denmark,2022-07-14,127816359,127816359,12083,https://www.sst.dk/en/english/corona-eng/status-of-the-epidemic/covid-19-updates-statistics-and-charts,66359853,61444423,0,0,0.0339421088904204,11673,410,69749959,58066400
Denmark,2022-07-15,127816359,127816359,0,https://www.sst.dk/en/english/corona-eng/status-of-the-epidemic/covid-19-updates-statistics-and-charts,66359853,61444423,0,0,0.0339421088904204,0,0,69749959,58066400
Denmark,2022-07-16,127816359,127816359,0,https://www.sst.dk/en/english/corona-eng/status-of-the-epidemic/covid-19-updates-statistics-and-charts,66359853,61444423,0,0,0.0339421088904204,0,0,69749959,58066400
Denmark,2022-07-17,127854498,127854498,38139,https://www.sst.dk/en/english/corona-eng/status-of-the-epidemic/covid-19-updates-statistics-and-charts,66359853,61444423,0,0,0.0339421088904204,36844,1295,69786803,58067695
Denmark,2022-07-18,127854498,127854498,0,https://www.sst.dk/en/english/corona-eng/status-of-the-epidemic/covid-19-updates-statistics-and-charts,66407155,61447343,47302,2920,0.05814185018517781,0,0,69786803,58067695
Denmark,2022-07-19,127867680,127867680,13182,https://www.sst.dk/en/english/corona-eng/status-of-the-epidemic/covid-19-updates-statistics-and-charts,66419960,61447720,12805,377,0.028599605522682446,12805,377,69799608,58068072
Denmark,2022-07-20,127878381,127878381,10701,https://www.sst.dk/en/english/corona-eng/status-of-the-epidemic/covid-19-updates-statistics-and-charts,66430258,61448123,10298,403,0.03766003177273152,10298,403,69809906,58068475
Denmark,2022-07-21,127888446,127888446,10065,https://www.sst.dk/en/english/corona-eng/status-of-the-epidemic/covid-19-updates-statistics-and-charts,66439828,61448618,9570,495,0.04918032786885246,9570,495,69819476,58068970
Denmark,2022-07-22,127897953,127897953,9507,https://www.sst.dk/en/english/corona-eng/status-of-the-epidemic/covid-19-updates-statistics-and-charts,66449012,61448941,9184,323,0.03397496581466288,9184,323,69828660,58069293
Denmark,2022-07-23,127897953,127897953,0,https://www.sst.dk/en/english/corona-eng/status-of-the-epidemic/covid-19-updates-statistics-and-charts,66449012,61448941,0,0,0.03397496581466288,0,0,69828660,58069293
Denmark,2022-07-24,127897953,127897953,0,https://www.sst.dk/en/english/corona-eng/status-of-the-epidemic/covid-19-updates-statistics-and-charts,66449012,61448941,0,0,0.03397496581466288,0,0,69828660,58069293
Denmark,2022-07-25,127921675,127921675,23722,https://www.sst.dk/en/english/corona-eng/status-of-the-epidemic/covid-19-updates-statistics-and-charts,66471860,61449815,22848,874,0.03684343647247281,22848,874,69851508,58070167
Denmark,2022-07-26,127932469,127932469,10794,https://www.sst.dk/en/english/corona-eng/status-of-the-epidemic/covid-19-updates-statistics-and-charts,66482317,61450152,10457,337,0.031221048730776357,10457,337,69861965,58070504
Denmark,2022-07-27,127941630,127941630,9161,https://www.sst.dk/en/english/corona-eng/status-of-the-epidemic/covid-19-updates-statistics-and-charts,66491365,61450265,9048,113,0.012334897936906451,9048,113,69871013,58070617
Denmark,2022-07-28,127950327,127950327,8697,https://www.sst.dk/en/english/corona-eng/status-of-the-epidemic/covid-19-updates-statistics-and-charts,66499902,61450425,8537,160,0.01839714844199149,8537,160,69879550,58070777
Denmark,2022-07-29,127958416,127958416,8089,https://www.sst.dk/en/english/corona-eng/status-of-the-epidemic/covid-19-updates-statistics-and-charts,66507778,61450638,7876,213,0.02633205587835332,7876,213,69887426,58070990
Denmark,2022-07-30,127958416,127958416,0,https://www.sst.dk/en/english/corona-eng/status-of-the-epidemic/covid-19-updates-statistics-and-charts,66507778,61450638,0,0,0.02633205587835332,0,0,69887426,58070990
Denmark,2022-07-31,127958416,127958416,0,https://www.sst.dk/en/english/corona-eng/status-of-the-epidemic/covid-19-updates-statistics-and-charts,66507778,61450638,0,0,0.02633205587835332,0,0,69887426,58070990
Denmark,2022-08-01,127978427,127978427,20011,https://www.sst.dk/en/english/corona-eng/status-of-the-epidemic/covid-19-updates-statistics-and-charts,66527022,61451405,19244,767,0.038328919094498023,19244,767,69906670,58071757
Denmark,2022-08-02,127987517,127987517,9090,https://www.sst.dk/en/english/corona-eng/status-of-the-epidemic/covid-19-updates-statistics-and-charts,66535977,61451540,8955,135,0.01485148514851485,8955,135,69915625,58071892
Denmark,2022-08-03,127995615,127995615,8098,https://www.sst.dk/en/english/corona-eng/status-of-the-epidemic/covid-19-updates-statistics-and-charts,66543961,61451654,7984,114,0.014077550012348727,7984,114,69923609,58072006
Denmark,2022-08-04,128003663,128003663,8048,https://www.sst.dk/en/english/corona-eng/status-of-the-epidemic/covid-19-updates-statistics-and-charts,66551936,61451727,7975,73,0.009070576540755467,7975,73,69931584,58072079
Denmark,2022-08-05,128010764,128010764,7101,https://www.sst.dk/en/english/corona-eng/status-of-the-epidemic/covid-19-updates-statistics-and-charts,66558877,61451887,6941,160,0.022532037741163215,6941,160,69938525,58072239
Denmark,2022-08-06,128010764,128010764,0,https://www.sst.dk/en/english/corona-eng/status-of-the-epidemic/covid-19-updates-statistics-and-charts,66558877,61451887,0,0,0.022532037741163215,0,0,69938525,58072239
Denmark,2022-08-07,128010764,128010764,0,https://www.sst.dk/en/english/corona-eng/status-of-the-epidemic/covid-19-updates-statistics-and-charts,66558877,61451887,0,0,0.022532037741163215,0,0,69938525,58072239
Denmark,2022-08-08,128028099,128028099,17335,https://www.sst.dk/en/english/corona-eng/status-of-the-epidemic/covid-19-updates-statistics-and-charts,66575505,61452594,16628,707,0.04078453994808191,16628,707,69955153,58072946
Denmark,2022-08-09,128036749,128036749,8650,https://www.sst.dk/en/english/corona-eng/status-of-the-epidemic/covid-19-updates-statistics-and-charts,66583776,61452973,8271,379,0.0438150289017341,8271,379,69963424,58073325
Denmark,2022-08-10,128045477,128045477,8728,https://www.sst.dk/en/english/corona-eng/status-of-the-epidemic/covid-19-updates-statistics-and-charts,66592072,61453405,8296,432,0.04949587534372136,8296,432,69971720,58073757
Denmark,2022-08-11,128053953,128053953,8476,https://www.sst.dk/en/english/corona-eng/status-of-the-epidemic/covid-19-updates-statistics-and-charts,66600435,61453518,8363,113,0.013331760264275601,8363,113,69980083,58073870
Denmark,2022-08-12,128061815,128061815,7862,https://www.sst.dk/en/english/corona-eng/status-of-the-epidemic/covid-19-updates-statistics-and-charts,66608141,61453674,7706,156,0.019842279318239633,7706,156,69987789,58074026
Denmark,2022-08-13,128061815,128061815,0,https://www.sst.dk/en/english/corona-eng/status-of-the-epidemic/covid-19-updates-statistics-and-charts,66608141,61453674,0,0,0.019842279318239633,0,0,69987789,58074026
Denmark,2022-08-14,128061815,128061815,0,https://www.sst.dk/en/english/corona-eng/status-of-the-epidemic/covid-19-updates-statistics-and-charts,66608141,61453674,0,0,0.019842279318239633,0,0,69987789,58074026
Denmark,2022-08-15,128080609,128080609,18794,https://www.sst.dk/en/english/corona-eng/status-of-the-epidemic/covid-19-updates-statistics-and-charts,66626212,61454397,18071,723,0.03846972438012131,18071,723,70005860,58074749
Denmark,2022-08-16,128090660,128090660,10051,https://www.sst.dk/en/english/corona-eng/status-of-the-epidemic/covid-19-updates-statistics-and-charts,66635918,61454742,9706,345,0.034324942791762014,9706,345,70015566,58075094
Denmark,2022-08-17,128099940,128099940,9280,https://www.sst.dk/en/english/corona-eng/status-of-the-epidemic/covid-19-updates-statistics-and-charts,66645021,61454919,9103,177,0.019073275862068965,9103,177,70024669,58075271
Denmark,2022-08-18,128108599,128108599,8659,https://www.sst.dk/en/english/corona-eng/status-of-the-epidemic/covid-19-updates-statistics-and-charts,66653546,61455053,8525,134,0.015475228086384109,8525,134,70033194,58075405
Denmark,2022-08-19,128117029,128117029,8430,https://www.sst.dk/en/english/corona-eng/status-of-the-epidemic/covid-19-updates-statistics-and-charts,66661860,61455169,8314,116,0.01376037959667853,8314,116,70041508,58075521
Denmark,2022-08-20,128117029,128117029,0,https://www.sst.dk/en/english/corona-eng/status-of-the-epidemic/covid-19-updates-statistics-and-charts,66661860,61455169,0,0,0.01376037959667853,0,0,70041508,58075521
Denmark,2022-08-21,128117029,128117029,0,https://www.sst.dk/en/english/corona-eng/status-of-the-epidemic/covid-19-updates-statistics-and-charts,66661860,61455169,0,0,0.01376037959667853,0,0,70041508,58075521
Denmark,2022-08-22,128135734,128135734,18705,https://www.sst.dk/en/english/corona-eng/status-of-the-epidemic/covid-19-updates-statistics-and-charts,66679500,61456234,17640,1065,0.05693664795509222,17640,1065,70059148,58076586
Denmark,2022-08-23,128135734,128135734,0,https://www.sst.dk/en/english/corona-eng/status-of-the-epidemic/covid-19-updates-statistics-and-charts,66679500,61456234,0,0,0.05693664795509222,0,0,70059148,58076586
Denmark,2022-08-24,128152167,128152167,16433,https://www.sst.dk/en/english/corona-eng/status-of-the-epidemic/covid-19-updates-statistics-and-charts,66695684,61456483,16184,249,0.015152437169110935,16184,249,70075332,58076835
Denmark,2022-08-25,128160713,128160713,8546,https://www.sst.dk/en/english/corona-eng/status-of-the-epidemic/covid-19-updates-statistics-and-charts,66704146,61456567,8462,84,0.009829159840861221,8462,84,70083794,58076919
Denmark,2022-08-26,128168362,128168362,7649,https://www.sst.dk/en/english/corona-eng/status-of-the-epidemic/covid-19-updates-statistics-and-charts,66711663,61456699,7517,132,0.01725715779840502,7517,132,70091311,58077051
Denmark,2022-08-27,128168362,128168362,0,https://www.sst.dk/en/english/corona-eng/status-of-the-epidemic/covid-19-updates-statistics-and-charts,66711663,61456699,0,0,0.01725715779840502,0,0,70091311,58077051
Denmark,2022-08-28,128168362,128168362,0,https://www.sst.dk/en/english/corona-eng/status-of-the-epidemic/covid-19-updates-statistics-and-charts,66711663,61456699,0,0,0.01725715779840502,0,0,70091311,58077051
Denmark,2022-08-29,128183993,128183993,15631,https://www.sst.dk/en/english/corona-eng/status-of-the-epidemic/covid-19-updates-statistics-and-charts,66726378,61457615,14715,916,0.05860149702514234,14715,916,70106026,58077967
Denmark,2022-08-30,128191650,128191650,7657,https://www.sst.dk/en/english/corona-eng/status-of-the-epidemic/covid-19-updates-statistics-and-charts,66733958,61457692,7580,77,0.01005615776413739,7580,77,70113606,58078044
Denmark,2022-08-31,128199509,128199509,7859,https://www.sst.dk/en/english/corona-eng/status-of-the-epidemic/covid-19-updates-statistics-and-charts,66741625,61457884,7667,192,0.02443058913347754,7667,192,70121273,58078236
Denmark,2022-09-01,128207430,128207430,7921,https://www.sst.dk/en/english/corona-eng/status-of-the-epidemic/covid-19-updates-statistics-and-charts,66749450,61457980,7825,96,0.012119681858351218,7825,96,70129098,58078332
Denmark,2022-09-02,128213105,128213105,5675,https://www.sst.dk/en/english/corona-eng/status-of-the-epidemic/covid-19-updates-statistics-and-charts,66755028,61458077,5578,97,0.01709251101321586,5578,97,70134676,58078429
Denmark,2022-09-03,128213105,128213105,0,https://www.sst.dk/en/english/corona-eng/status-of-the-epidemic/covid-19-updates-statistics-and-charts,66755028,61458077,0,0,0.01709251101321586,0,0,70134676,58078429
Denmark,2022-09-04,128213105,128213105,0,https://www.sst.dk/en/english/corona-eng/status-of-the-epidemic/covid-19-updates-statistics-and-charts,66755028,61458077,0,0,0.01709251101321586,0,0,70134676,58078429
Denmark,2022-09-05,128229292,128229292,16187,https://www.sst.dk/en/english/corona-eng/status-of-the-epidemic/covid-19-updates-statistics-and-charts,66770203,61459089,15175,1012,0.06251930561561747,15175,1012,70149851,58079441
Denmark,2022-09-06,128229292,128229292,0,https://www.sst.dk/en/english/corona-eng/status-of-the-epidemic/covid-19-updates-statistics-and-charts,66770203,61459089,0,0,0.06251930561561747,0,0,70149851,58079441
Denmark,2022-09-07,128244881,128244881,15589,https://www.sst.dk/en/english/corona-eng/status-of-the-epidemic/covid-19-updates-statistics-and-charts,66785704,61459177,15501,88,0.0056450060940406695,15501,88,70165352,58079529
Denmark,2022-09-08,128252647,128252647,7766,https://www.sst.dk/en/english/corona-eng/status-of-the-epidemic/covid-19-updates-statistics-and-charts,66793435,61459212,7731,35,0.004506824620139068,7731,35,70173083,58079564
Denmark,2022-09-09,128260192,128260192,7545,https://www.sst.dk/en/english/corona-eng/status-of-the-epidemic/covid-19-updates-statistics-and-charts,66800820,61459372,7385,160,0.021206096752816435,7385,160,70180468,58079724
Denmark,2022-09-10,128260192,128260192,0,https://www.sst.dk/en/english/corona-eng/status-of-the-epidemic/covid-19-updates-statistics-and-charts,66800820,61459372,0,0,0.021206096752816435,0,0,70180468,58079724
Denmark,2022-09-11,128260192,128260192,0,https://www.sst.dk/en/english/corona-eng/status-of-the-epidemic/covid-19-updates-statistics-and-charts,66800820,61459372,0,0,0.021206096752816435,0,0,70180468,58079724
Denmark,2022-09-12,128260192,128260192,0,https://www.sst.dk/en/english/corona-eng/status-of-the-epidemic/covid-19-updates-statistics-and-charts,66800820,61459372,0,0,0.021206096752816435,0,0,70180468,58079724
Denmark,2022-09-13,128274936,128274936,14744,https://www.sst.dk/en/english/corona-eng/status-of-the-epidemic/covid-19-updates-statistics-and-charts,66814821,61460115,14001,743,0.05039338035811177,14001,743,70194469,58080467
Denmark,2022-09-14,128274936,128274936,0,https://www.sst.dk/en/english/corona-eng/status-of-the-epidemic/covid-19-updates-statistics-and-charts,66814821,61460115,0,0,0.05039338035811177,0,0,70194469,58080467
Denmark,2022-09-15,128298951,128298951,24015,https://www.sst.dk/en/english/corona-eng/status-of-the-epidemic/covid-19-updates-statistics-and-charts,66838671,61460280,23850,165,0.006870705808869456,23850,165,70218319,58080632
Denmark,2022-09-16,128306100,128306100,7149,https://www.sst.dk/en/english/corona-eng/status-of-the-epidemic/covid-19-updates-statistics-and-charts,66845786,61460314,7115,34,0.004755909917470975,7115,34,70225434,58080666
Denmark,2022-09-17,128306100,128306100,0,https://www.sst.dk/en/english/corona-eng/status-of-the-epidemic/covid-19-updates-statistics-and-charts,66845786,61460314,0,0,0.004755909917470975,0,0,70225434,58080666
Denmark,2022-09-18,128306100,128306100,0,https://www.sst.dk/en/english/corona-eng/status-of-the-epidemic/covid-19-updates-statistics-and-charts,66845786,61460314,0,0,0.004755909917470975,0,0,70225434,58080666
Denmark,2022-09-19,128309973,128309973,3873,https://www.sst.dk/en/english/corona-eng/status-of-the-epidemic/covid-19-updates-statistics-and-charts,66849532,61460441,3746,127,0.03279111799638523,3746,127,70229180,58080793
Denmark,2022-09-20,128327172,128327172,17199,https://www.sst.dk/en/english/corona-eng/status-of-the-epidemic/covid-19-updates-statistics-and-charts,66866572,61460600,17040,159,0.009244723530437817,17040,159,70246220,58080952
Denmark,2022-09-21,128335252,128335252,8080,https://www.sst.dk/en/english/corona-eng/status-of-the-epidemic/covid-19-updates-statistics-and-charts,66874529,61460723,7957,123,0.015222772277227722,7957,123,70254177,58081075
Denmark,2022-09-22,128341748,128341748,6496,https://www.sst.dk/en/english/corona-eng/status-of-the-epidemic/covid-19-updates-statistics-and-charts,66880938,61460810,6409,87,0.013392857142857142,6409,87,70260586,58081162
Denmark,2022-09-23,128351467,128351467,9719,https://www.sst.dk/en/english/corona-eng/status-of-the-epidemic/covid-19-updates-statistics-and-charts,66890582,61460885,9644,75,0.007716843296635456,9644,75,70270230,58081237
Denmark,2022-09-24,128351467,128351467,0,https://www.sst.dk/en/english/corona-eng/status-of-the-epidemic/covid-19-updates-statistics-and-charts,66890582,61460885,0,0,0.007716843296635456,0,0,70270230,58081237
Denmark,2022-09-25,128351467,128351467,0,https://www.sst.dk/en/english/corona-eng/status-of-the-epidemic/covid-19-updates-statistics-and-charts,66890582,61460885,0,0,0.007716843296635456,0,0,70270230,58081237
Denmark,2022-09-26,128368078,128368078,16611,https://www.sst.dk/en/english/corona-eng/status-of-the-epidemic/covid-19-updates-statistics-and-charts,66907065,61461013,16483,128,0.007705737162121485,16483,128,70286713,58081365
Denmark,2022-09-27,128377310,128377310,9232,https://www.sst.dk/en/english/corona-eng/status-of-the-epidemic/covid-19-updates-statistics-and-charts,66916254,61461056,9189,43,0.004657712305025996,9189,43,70295902,58081408
Denmark,2022-09-28,128388014,128388014,10704,https://www.sst.dk/en/english/corona-eng/status-of-the-epidemic/covid-19-updates-statistics-and-charts,66926921,61461093,10667,37,0.0034566517189835574,10667,37,70306569,58081445
Denmark,2022-09-29,128397719,128397719,9705,https://www.sst.dk/en/english/corona-eng/status-of-the-epidemic/covid-19-updates-statistics-and-charts,66936572,61461147,9651,54,0.0055641421947449764,9651,54,70316220,58081499
Denmark,2022-09-30,128407148,128407148,9429,https://www.sst.dk/en/english/corona-eng/status-of-the-epidemic/covid-19-updates-statistics-and-charts,66945945,61461203,9373,56,0.005939123979213066,9373,56,70325593,58081555
Denmark,2022-10-01,128407148,128407148,0,https://www.sst.dk/en/english/corona-eng/status-of-the-epidemic/covid-19-updates-statistics-and-charts,66945945,61461203,0,0,0.005939123979213066,0,0,70325593,58081555
Denmark,2022-10-02,128407148,128407148,0,https://www.sst.dk/en/english/corona-eng/status-of-the-epidemic/covid-19-updates-statistics-and-charts,66945945,61461203,0,0,0.005939123979213066,0,0,70325593,58081555
Denmark,2022-10-03,128425027,128425027,17879,https://www.sst.dk/en/english/corona-eng/status-of-the-epidemic/covid-19-updates-statistics-and-charts,66963725,61461302,17780,99,0.0055372224397337655,17780,99,70343373,58081654
Denmark,2022-10-04,128425027,128425027,0,https://www.sst.dk/en/english/corona-eng/status-of-the-epidemic/covid-19-updates-statistics-and-charts,66963725,61461302,0,0,0.0055372224397337655,0,0,70343373,58081654
Denmark,2022-10-05,128445054,128445054,20027,https://www.sst.dk/en/english/corona-eng/status-of-the-epidemic/covid-19-updates-statistics-and-charts,66983567,61461487,19842,185,0.009237529335397213,19842,185,70363215,58081839
Denmark,2022-10-06,128454662,128454662,9608,https://www.sst.dk/en/english/corona-eng/status-of-the-epidemic/covid-19-updates-statistics-and-charts,66993062,61461600,9495,113,0.011761032472939217,9495,113,70372710,58081952
Denmark,2022-10-07,128462903,128462903,8241,https://www.sst.dk/en/english/corona-eng/status-of-the-epidemic/covid-19-updates-statistics-and-charts,67001243,61461660,8181,60,0.0072806698216235895,8181,60,70380891,58082012
Denmark,2022-10-08,128462903,128462903,0,https://www.sst.dk/en/english/corona-eng/status-of-the-epidemic/covid-19-updates-statistics-and-charts,67001243,61461660,0,0,0.0072806698216235895,0,0,70380891,58082012
Denmark,2022-10-09,128462903,128462903,0,https://www.sst.dk/en/english/corona-eng/status-of-the-epidemic/covid-19-updates-statistics-and-charts,67001243,61461660,0,0,0.0072806698216235895,0,0,70380891,58082012
Denmark,2022-10-10,128462903,128462903,0,https://www.sst.dk/en/english/corona-eng/status-of-the-epidemic/covid-19-updates-statistics-and-charts,67001243,61461660,0,0,0.0072806698216235895,0,0,70380891,58082012
Denmark,2022-10-11,128462903,128462903,0,https://www.sst.dk/en/english/corona-eng/status-of-the-epidemic/covid-19-updates-statistics-and-charts,67001243,61461660,0,0,0.0072806698216235895,0,0,70380891,58082012
Denmark,2022-10-12,128503559,128503559,40656,https://www.sst.dk/en/english/corona-eng/status-of-the-epidemic/covid-19-updates-statistics-and-charts,67041693,61461866,40450,206,0.005066902794175521,40450,206,70421341,58082218
Denmark,2022-10-13,128513205,128513205,9646,https://www.sst.dk/en/english/corona-eng/status-of-the-epidemic/covid-19-updates-statistics-and-charts,67051300,61461905,9607,39,0.004043126684636119,9607,39,70430948,58082257
Denmark,2022-10-14,128522038,128522038,8833,https://www.sst.dk/en/english/corona-eng/status-of-the-epidemic/covid-19-updates-statistics-and-charts,67060092,61461946,8792,41,0.004641684591871391,8792,41,70439740,58082298
Denmark,2022-10-15,128522038,128522038,0,https://www.sst.dk/en/english/corona-eng/status-of-the-epidemic/covid-19-updates-statistics-and-charts,67060092,61461946,0,0,0.004641684591871391,0,0,70439740,58082298
Denmark,2022-10-16,128522038,128522038,0,https://www.sst.dk/en/english/corona-eng/status-of-the-epidemic/covid-19-updates-statistics-and-charts,67060092,61461946,0,0,0.004641684591871391,0,0,70439740,58082298
Denmark,2022-10-17,128541575,128541575,19537,https://www.sst.dk/en/english/corona-eng/status-of-the-epidemic/covid-19-updates-statistics-and-charts,67079521,61462054,19429,108,0.0055279725648769,19429,108,70459169,58082406
Denmark,2022-10-18,128549994,128549994,8419,https://www.sst.dk/en/english/corona-eng/status-of-the-epidemic/covid-19-updates-statistics-and-charts,67087895,61462099,8374,45,0.005345052856633804,8374,45,70467543,58082451
Denmark,2022-10-19,128559086,128559086,9092,https://www.sst.dk/en/english/corona-eng/status-of-the-epidemic/covid-19-updates-statistics-and-charts,67096947,61462139,9052,40,0.004399472063352398,9052,40,70476595,58082491
Denmark,2022-10-20,128567005,128567005,7919,https://www.sst.dk/en/english/corona-eng/status-of-the-epidemic/covid-19-updates-statistics-and-charts,67104833,61462172,7886,33,0.004167192827377194,7886,33,70484481,58082524
Denmark,2022-10-21,128574209,128574209,7204,https://www.sst.dk/en/english/corona-eng/status-of-the-epidemic/covid-19-updates-statistics-and-charts,67112019,61462190,7186,18,0.002498611882287618,7186,18,70491667,58082542
Denmark,2022-10-22,128574209,128574209,0,https://www.sst.dk/en/english/corona-eng/status-of-the-epidemic/covid-19-updates-statistics-and-charts,67112019,61462190,0,0,0.002498611882287618,0,0,70491667,58082542
Denmark,2022-10-23,128574209,128574209,0,https://www.sst.dk/en/english/corona-eng/status-of-the-epidemic/covid-19-updates-statistics-and-charts,67112019,61462190,0,0,0.002498611882287618,0,0,70491667,58082542
Denmark,2022-10-24,128574209,128574209,0,https://www.sst.dk/en/english/corona-eng/status-of-the-epidemic/covid-19-updates-statistics-and-charts,67112019,61462190,0,0,0.002498611882287618,0,0,70491667,58082542
Denmark,2022-10-25,128600363,128600363,26154,https://www.sst.dk/en/english/corona-eng/status-of-the-epidemic/covid-19-updates-statistics-and-charts,67137981,61462382,25962,192,0.00734113328745125,25962,192,70517629,58082734
Denmark,2022-10-26,128600363,128600363,0,https://www.sst.dk/en/english/corona-eng/status-of-the-epidemic/covid-19-updates-statistics-and-charts,67137981,61462382,0,0,0.00734113328745125,0,0,70517629,58082734
Denmark,2022-10-27,128616570,128616570,16207,https://www.sst.dk/en/english/corona-eng/status-of-the-epidemic/covid-19-updates-statistics-and-charts,67154116,61462454,16135,72,0.004442524834947862,16135,72,70533764,58082806
Denmark,2022-10-28,128624195,128624195,7625,https://www.sst.dk/en/english/corona-eng/status-of-the-epidemic/covid-19-updates-statistics-and-charts,67161659,61462536,7543,82,0.010754098360655738,7543,82,70541307,58082888
Denmark,2022-10-29,128624195,128624195,0,https://www.sst.dk/en/english/corona-eng/status-of-the-epidemic/covid-19-updates-statistics-and-charts,67161659,61462536,0,0,0.010754098360655738,0,0,70541307,58082888
Denmark,2022-10-30,128624195,128624195,0,https://www.sst.dk/en/english/corona-eng/status-of-the-epidemic/covid-19-updates-statistics-and-charts,67161659,61462536,0,0,0.010754098360655738,0,0,70541307,58082888
Denmark,2022-10-31,128624195,128624195,0,https://www.sst.dk/en/english/corona-eng/status-of-the-epidemic/covid-19-updates-statistics-and-charts,67161659,61462536,0,0,0.010754098360655738,0,0,70541307,58082888
Denmark,2022-11-01,128647479,128647479,23284,https://www.sst.dk/en/english/corona-eng/status-of-the-epidemic/covid-19-updates-statistics-and-charts,67184775,61462704,23116,168,0.0072152551108057034,23116,168,70564423,58083056
Denmark,2022-11-02,128654848,128654848,7369,https://www.sst.dk/en/english/corona-eng/status-of-the-epidemic/covid-19-updates-statistics-and-charts,67192144,61462704,7369,0,0,7369,0,70571792,58083056
Denmark,2022-11-03,128661542,128661542,6694,https://www.sst.dk/en/english/corona-eng/status-of-the-epidemic/covid-19-updates-statistics-and-charts,67198766,61462776,6622,72,0.01075590080669256,6622,72,70578414,58083128
Denmark,2022-11-04,128667520,128667520,5978,https://www.sst.dk/en/english/corona-eng/status-of-the-epidemic/covid-19-updates-statistics-and-charts,67204676,61462844,5910,68,0.011375041820006692,5910,68,70584324,58083196
Denmark,2022-11-05,128667520,128667520,0,https://www.sst.dk/en/english/corona-eng/status-of-the-epidemic/covid-19-updates-statistics-and-charts,67204676,61462844,0,0,0.011375041820006692,0,0,70584324,58083196
Denmark,2022-11-06,128667520,128667520,0,https://www.sst.dk/en/english/corona-eng/status-of-the-epidemic/covid-19-updates-statistics-and-charts,67204676,61462844,0,0,0.011375041820006692,0,0,70584324,58083196
Denmark,2022-11-07,128680437,128680437,12917,https://www.sst.dk/en/english/corona-eng/status-of-the-epidemic/covid-19-updates-statistics-and-charts,67217546,61462891,12870,47,0.003638615777657351,12870,47,70597194,58083243
Denmark,2022-11-08,128688022,128688022,7585,https://www.sst.dk/en/english/corona-eng/status-of-the-epidemic/covid-19-updates-statistics-and-charts,67225086,61462936,7540,45,0.005932762030323006,7540,45,70604734,58083288
Denmark,2022-11-09,128694782,128694782,6760,https://www.sst.dk/en/english/corona-eng/status-of-the-epidemic/covid-19-updates-statistics-and-charts,67231816,61462966,6730,30,0.004437869822485207,6730,30,70611464,58083318
Denmark,2022-11-10,128702934,128702934,8152,https://www.sst.dk/en/english/corona-eng/status-of-the-epidemic/covid-19-updates-statistics-and-charts,67239949,61462985,8133,19,0.0023307163886162907,8133,19,70619597,58083337
Denmark,2022-11-11,128708583,128708583,5649,https://www.sst.dk/en/english/corona-eng/status-of-the-epidemic/covid-19-updates-statistics-and-charts,67245579,61463004,5630,19,0.0033634271552487167,5630,19,70625227,58083356
Denmark,2022-11-12,128708583,128708583,0,https://www.sst.dk/en/english/corona-eng/status-of-the-epidemic/covid-19-updates-statistics-and-charts,67245579,61463004,0,0,0.0033634271552487167,0,0,70625227,58083356
Denmark,2022-11-13,128708583,128708583,0,https://www.sst.dk/en/english/corona-eng/status-of-the-epidemic/covid-19-updates-statistics-and-charts,67245579,61463004,0,0,0.0033634271552487167,0,0,70625227,58083356
Denmark,2022-11-14,128708583,128708583,0,https://www.sst.dk/en/english/corona-eng/status-of-the-epidemic/covid-19-updates-statistics-and-charts,67245579,61463004,0,0,0.0033634271552487167,0,0,70625227,58083356
Denmark,2022-11-15,128708583,128708583,0,https://www.sst.dk/en/english/corona-eng/status-of-the-epidemic/covid-19-updates-statistics-and-charts,67245579,61463004,0,0,0.0033634271552487167,0,0,70625227,58083356
Denmark,2022-11-16,128735375,128735375,26792,https://www.sst.dk/en/english/corona-eng/status-of-the-epidemic/covid-19-updates-statistics-and-charts,67272254,61463121,26675,117,0.004366975216482532,26675,117,70651902,58083473
Denmark,2022-11-17,128742207,128742207,6832,https://www.sst.dk/en/english/corona-eng/status-of-the-epidemic/covid-19-updates-statistics-and-charts,67279027,61463180,6773,59,0.00863583138173302,6773,59,70658675,58083532
Denmark,2022-11-18,128747914,128747914,5707,https://www.sst.dk/en/english/corona-eng/status-of-the-epidemic/covid-19-updates-statistics-and-charts,67284711,61463203,5684,23,0.0040301384264937795,5684,23,70664359,58083555
Denmark,2022-11-19,128747914,128747914,0,https://www.sst.dk/en/english/corona-eng/status-of-the-epidemic/covid-19-updates-statistics-and-charts,67284711,61463203,0,0,0.0040301384264937795,0,0,70664359,58083555
Denmark,2022-11-20,128747914,128747914,0,https://www.sst.dk/en/english/corona-eng/status-of-the-epidemic/covid-19-updates-statistics-and-charts,67284711,61463203,0,0,0.0040301384264937795,0,0,70664359,58083555
Denmark,2022-11-21,128747914,128747914,0,https://www.sst.dk/en/english/corona-eng/status-of-the-epidemic/covid-19-updates-statistics-and-charts,67284711,61463203,0,0,0.0040301384264937795,0,0,70664359,58083555
Denmark,2022-11-22,128766536,128766536,18622,https://www.sst.dk/en/english/corona-eng/status-of-the-epidemic/covid-19-updates-statistics-and-charts,67303210,61463326,18499,123,0.006605090752872946,18499,123,70682858,58083678
Denmark,2022-11-23,128773236,128773236,6700,https://www.sst.dk/en/english/corona-eng/status-of-the-epidemic/covid-19-updates-statistics-and-charts,67309889,61463347,6679,21,0.003134328358208955,6679,21,70689537,58083699
Denmark,2022-11-24,128779544,128779544,6308,https://www.sst.dk/en/english/corona-eng/status-of-the-epidemic/covid-19-updates-statistics-and-charts,67316173,61463371,6284,24,0.003804692454026633,6284,24,70695821,58083723
Denmark,2022-11-25,128785585,128785585,6041,https://www.sst.dk/en/english/corona-eng/status-of-the-epidemic/covid-19-updates-statistics-and-charts,67322186,61463399,6013,28,0.004634994206257242,6013,28,70701834,58083751
Denmark,2022-11-26,128785585,128785585,0,https://www.sst.dk/en/english/corona-eng/status-of-the-epidemic/covid-19-updates-statistics-and-charts,67322186,61463399,0,0,0.004634994206257242,0,0,70701834,58083751
Denmark,2022-11-27,128785585,128785585,0,https://www.sst.dk/en/english/corona-eng/status-of-the-epidemic/covid-19-updates-statistics-and-charts,67322186,61463399,0,0,0.004634994206257242,0,0,70701834,58083751
Denmark,2022-11-28,128798644,128798644,13059,https://www.sst.dk/en/english/corona-eng/status-of-the-epidemic/covid-19-updates-statistics-and-charts,67335166,61463478,12980,79,0.006049467799984685,12980,79,70714814,58083830
Denmark,2022-11-29,128806452,128806452,7808,https://www.sst.dk/en/english/corona-eng/status-of-the-epidemic/covid-19-updates-statistics-and-charts,67342912,61463540,7746,62,0.007940573770491803,7746,62,70722560,58083892
Denmark,2022-11-30,128813985,128813985,7533,https://www.sst.dk/en/english/corona-eng/status-of-the-epidemic/covid-19-updates-statistics-and-charts,67350417,61463568,7505,28,0.0037169786273728925,7505,28,70730065,58083920
Denmark,2022-12-01,128821813,128821813,7828,https://www.sst.dk/en/english/corona-eng/status-of-the-epidemic/covid-19-updates-statistics-and-charts,67358230,61463583,7813,15,0.0019161982626469086,7813,15,70737878,58083935
Denmark,2022-12-02,128828312,128828312,6499,https://www.sst.dk/en/english/corona-eng/status-of-the-epidemic/covid-19-updates-statistics-and-charts,67364710,61463602,6480,19,0.002923526696414833,6480,19,70744358,58083954
Denmark,2022-12-03,128828312,128828312,0,https://www.sst.dk/en/english/corona-eng/status-of-the-epidemic/covid-19-updates-statistics-and-charts,67364710,61463602,0,0,0.002923526696414833,0,0,70744358,58083954
Denmark,2022-12-04,128828312,128828312,0,https://www.sst.dk/en/english/corona-eng/status-of-the-epidemic/covid-19-updates-statistics-and-charts,67364710,61463602,0,0,0.002923526696414833,0,0,70744358,58083954
Denmark,2022-12-05,128845073,128845073,16761,https://www.sst.dk/en/english/corona-eng/status-of-the-epidemic/covid-19-updates-statistics-and-charts,67381147,61463926,16437,324,0.019330588867012707,16437,324,70760795,58084278
Denmark,2022-12-06,128853831,128853831,8758,https://www.sst.dk/en/english/corona-eng/status-of-the-epidemic/covid-19-updates-statistics-and-charts,67389855,61463976,8708,50,0.005709065996802923,8708,50,70769503,58084328
Denmark,2022-12-07,128853831,128853831,0,https://www.sst.dk/en/english/corona-eng/status-of-the-epidemic/covid-19-updates-statistics-and-charts,67389855,61463976,0,0,0.005709065996802923,0,0,70769503,58084328
Denmark,2022-12-08,128872193,128872193,18362,https://www.sst.dk/en/english/corona-eng/status-of-the-epidemic/covid-19-updates-statistics-and-charts,67408177,61464016,18322,40,0.0021784119376974187,18322,40,70787825,58084368
Denmark,2022-12-09,128882535,128882535,10342,https://www.sst.dk/en/english/corona-eng/status-of-the-epidemic/covid-19-updates-statistics-and-charts,67418488,61464047,10311,31,0.0029974859795010634,10311,31,70798136,58084399
Denmark,2022-12-10,128882535,128882535,0,https://www.sst.dk/en/english/corona-eng/status-of-the-epidemic/covid-19-updates-statistics-and-charts,67418488,61464047,0,0,0.0029974859795010634,0,0,70798136,58084399
Denmark,2022-12-11,128882535,128882535,0,https://www.sst.dk/en/english/corona-eng/status-of-the-epidemic/covid-19-updates-statistics-and-charts,67418488,61464047,0,0,0.0029974859795010634,0,0,70798136,58084399
Denmark,2022-12-12,128896197,128896197,13662,https://www.sst.dk/en/english/corona-eng/status-of-the-epidemic/covid-19-updates-statistics-and-charts,67432085,61464112,13597,65,0.004757722149026497,13597,65,70811733,58084464
Denmark,2022-12-13,128902930,128902930,6733,https://www.sst.dk/en/english/corona-eng/status-of-the-epidemic/covid-19-updates-statistics-and-charts,67438770,61464160,6685,48,0.007129065795336403,6685,48,70818418,58084512
Denmark,2022-12-14,128909340,128909340,6410,https://www.sst.dk/en/english/corona-eng/status-of-the-epidemic/covid-19-updates-statistics-and-charts,67445169,61464171,6399,11,0.0017160686427457098,6399,11,70824817,58084523
Denmark,2022-12-15,128916582,128916582,7242,https://www.sst.dk/en/english/corona-eng/status-of-the-epidemic/covid-19-updates-statistics-and-charts,67452397,61464185,7228,14,0.0019331676332504833,7228,14,70832045,58084537
Denmark,2022-12-16,128923120,128923120,6538,https://www.sst.dk/en/english/corona-eng/status-of-the-epidemic/covid-19-updates-statistics-and-charts,67458918,61464202,6521,17,0.0026001835423676966,6521,17,70838566,58084554
Denmark,2022-12-17,128923120,128923120,0,https://www.sst.dk/en/english/corona-eng/status-of-the-epidemic/covid-19-updates-statistics-and-charts,67458918,61464202,0,0,0.0026001835423676966,0,0,70838566,58084554
Denmark,2022-12-18,128923120,128923120,0,https://www.sst.dk/en/english/corona-eng/status-of-the-epidemic/covid-19-updates-statistics-and-charts,67458918,61464202,0,0,0.0026001835423676966,0,0,70838566,58084554
Denmark,2022-12-19,128923120,128923120,0,https://www.sst.dk/en/english/corona-eng/status-of-the-epidemic/covid-19-updates-statistics-and-charts,67458918,61464202,0,0,0.0026001835423676966,0,0,70838566,58084554
Denmark,2022-12-20,128923120,128923120,0,https://www.sst.dk/en/english/corona-eng/status-of-the-epidemic/covid-19-updates-statistics-and-charts,67458918,61464202,0,0,0.0026001835423676966,0,0,70838566,58084554
Denmark,2022-12-21,128923120,128923120,0,https://www.sst.dk/en/english/corona-eng/status-of-the-epidemic/covid-19-updates-statistics-and-charts,67458918,61464202,0,0,0.0026001835423676966,0,0,70838566,58084554
Denmark,2022-12-22,128955000,128955000,31880,https://www.sst.dk/en/english/corona-eng/status-of-the-epidemic/covid-19-updates-statistics-and-charts,67490643,61464357,31725,155,0.00486198243412798,31725,155,70870291,58084709
Denmark,2022-12-23,128974186,128974186,19186,https://www.sst.dk/en/english/corona-eng/status-of-the-epidemic/covid-19-updates-statistics-and-charts,67509781,61464405,19138,48,0.002501824246846659,19138,48,70889429,58084757
Denmark,2022-12-24,128974186,128974186,0,https://www.sst.dk/en/english/corona-eng/status-of-the-epidemic/covid-19-updates-statistics-and-charts,67509781,61464405,0,0,0.002501824246846659,0,0,70889429,58084757
Denmark,2022-12-25,128974186,128974186,0,https://www.sst.dk/en/english/corona-eng/status-of-the-epidemic/covid-19-updates-statistics-and-charts,67509781,61464405,0,0,0.002501824246846659,0,0,70889429,58084757
Denmark,2022-12-26,128974186,128974186,0,https://www.sst.dk/en/english/corona-eng/status-of-the-epidemic/covid-19-updates-statistics-and-charts,67509781,61464405,0,0,0.002501824246846659,0,0,70889429,58084757
Denmark,2022-12-27,128993169,128993169,18983,https://www.sst.dk/en/english/corona-eng/status-of-the-epidemic/covid-19-updates-statistics-and-charts,67528705,61464464,18924,59,0.003108044039403677,18924,59,70908353,58084816
Denmark,2022-12-28,129001826,129001826,8657,https://www.sst.dk/en/english/corona-eng/status-of-the-epidemic/covid-19-updates-statistics-and-charts,67537345,61464481,8640,17,0.001963728774402218,8640,17,70916993,58084833
Denmark,2022-12-29,129001826,129001826,0,https://www.sst.dk/en/english/corona-eng/status-of-the-epidemic/covid-19-updates-statistics-and-charts,67537345,61464481,0,0,0.001963728774402218,0,0,70916993,58084833
Denmark,2022-12-30,129001826,129001826,0,https://www.sst.dk/en/english/corona-eng/status-of-the-epidemic/covid-19-updates-statistics-and-charts,67537345,61464481,0,0,0.001963728774402218,0,0,70916993,58084833
Denmark,2022-12-31,129001826,129001826,0,https://www.sst.dk/en/english/corona-eng/status-of-the-epidemic/covid-19-updates-statistics-and-charts,67537345,61464481,0,0,0.001963728774402218,0,0,70916993,58084833
Denmark,2023-01-01,129001826,129001826,0,https://www.sst.dk/en/english/corona-eng/status-of-the-epidemic/covid-19-updates-statistics-and-charts,67537345,61464481,0,0,0.001963728774402218,0,0,70916993,58084833
Denmark,2023-01-02,129001826,129001826,0,https://www.sst.dk/en/english/corona-eng/status-of-the-epidemic/covid-19-updates-statistics-and-charts,67565521,61464533,28176,52,0.0018421425534929858,0,0,70916993,58084833
Denmark,2023-01-03,129039270,129039270,37444,https://www.sst.dk/en/english/corona-eng/status-of-the-epidemic/covid-19-updates-statistics-and-charts,67574697,61464573,9176,40,0.004340277777777778,37281,163,70954274,58084996
Denmark,2023-01-04,129039270,129039270,0,https://www.sst.dk/en/english/corona-eng/status-of-the-epidemic/covid-19-updates-statistics-and-charts,67574697,61464573,0,0,0.004340277777777778,0,0,70954274,58084996
Denmark,2023-01-05,129054030,129054030,14760,https://www.sst.dk/en/english/corona-eng/status-of-the-epidemic/covid-19-updates-statistics-and-charts,67589408,61464622,14711,49,0.0033197831978319784,14711,49,70968985,58085045
Denmark,2023-01-06,129060758,129060758,6728,https://www.sst.dk/en/english/corona-eng/status-of-the-epidemic/covid-19-updates-statistics-and-charts,67596118,61464640,6710,18,0.00267538644470868,6710,18,70975695,58085063
Denmark,2023-01-07,129060758,129060758,0,https://www.sst.dk/en/english/corona-eng/status-of-the-epidemic/covid-19-updates-statistics-and-charts,67596118,61464640,0,0,0.00267538644470868,0,0,70975695,58085063
Denmark,2023-01-08,129060758,129060758,0,https://www.sst.dk/en/english/corona-eng/status-of-the-epidemic/covid-19-updates-statistics-and-charts,67596118,61464640,0,0,0.00267538644470868,0,0,70975695,58085063
Denmark,2023-01-09,129060758,129060758,0,https://www.sst.dk/en/english/corona-eng/status-of-the-epidemic/covid-19-updates-statistics-and-charts,67596118,61464640,0,0,0.00267538644470868,0,0,70975695,58085063
Denmark,2023-01-10,129079953,129079953,19195,https://www.sst.dk/en/english/corona-eng/status-of-the-epidemic/covid-19-updates-statistics-and-charts,67615243,61464710,19125,70,0.0036467830164105238,19125,70,70994820,58085133
Denmark,2023-01-11,129085101,129085101,5148,https://www.sst.dk/en/english/corona-eng/status-of-the-epidemic/covid-19-updates-statistics-and-charts,67620377,61464724,5134,14,0.0027195027195027195,5134,14,70999954,58085147
Denmark,2023-01-12,129089926,129089926,4825,https://www.sst.dk/en/english/corona-eng/status-of-the-epidemic/covid-19-updates-statistics-and-charts,67625188,61464738,4811,14,0.002901554404145078,4811,14,71004765,58085161
Denmark,2023-01-13,129094301,129094301,4375,https://www.sst.dk/en/english/corona-eng/status-of-the-epidemic/covid-19-updates-statistics-and-charts,67629551,61464750,4363,12,0.002742857142857143,4363,12,71009128,58085173
Denmark,2023-01-14,129094301,129094301,0,https://www.sst.dk/en/english/corona-eng/status-of-the-epidemic/covid-19-updates-statistics-and-charts,67629551,61464750,0,0,0.002742857142857143,0,0,71009128,58085173
Denmark,2023-01-15,129094301,129094301,0,https://www.sst.dk/en/english/corona-eng/status-of-the-epidemic/covid-19-updates-statistics-and-charts,67629551,61464750,0,0,0.002742857142857143,0,0,71009128,58085173
Denmark,2023-01-16,129094301,129094301,0,https://www.sst.dk/en/english/corona-eng/status-of-the-epidemic/covid-19-updates-statistics-and-charts,67629551,61464750,0,0,0.002742857142857143,0,0,71009128,58085173
Denmark,2023-01-17,129094301,129094301,0,https://www.sst.dk/en/english/corona-eng/status-of-the-epidemic/covid-19-updates-statistics-and-charts,67629551,61464750,0,0,0.002742857142857143,0,0,71009128,58085173
Denmark,2023-01-18,129094301,129094301,0,https://www.sst.dk/en/english/corona-eng/status-of-the-epidemic/covid-19-updates-statistics-and-charts,67629551,61464750,0,0,0.002742857142857143,0,0,71009128,58085173
Denmark,2023-01-19,129114125,129114125,19824,https://www.sst.dk/en/english/corona-eng/status-of-the-epidemic/covid-19-updates-statistics-and-charts,67649329,61464796,19778,46,0.002320419693301049,19778,46,71028906,58085219
Denmark,2023-01-20,129117516,129117516,3391,https://www.sst.dk/en/english/corona-eng/status-of-the-epidemic/covid-19-updates-statistics-and-charts,67652698,61464818,3369,22,0.006487761722205839,3369,22,71032275,58085241
Denmark,2023-01-21,129117516,129117516,0,https://www.sst.dk/en/english/corona-eng/status-of-the-epidemic/covid-19-updates-statistics-and-charts,67652698,61464818,0,0,0.006487761722205839,0,0,71032275,58085241
Denmark,2023-01-22,129117516,129117516,0,https://www.sst.dk/en/english/corona-eng/status-of-the-epidemic/covid-19-updates-statistics-and-charts,67652698,61464818,0,0,0.006487761722205839,0,0,71032275,58085241
Denmark,2023-01-23,129123133,129123133,5617,https://www.sst.dk/en/english/corona-eng/status-of-the-epidemic/covid-19-updates-statistics-and-charts,67658295,61464838,5597,20,0.0035606195478013174,5597,20,71037872,58085261
Denmark,2023-01-24,129126503,129126503,3370,https://www.sst.dk/en/english/corona-eng/status-of-the-epidemic/covid-19-updates-statistics-and-charts,67661653,61464850,3358,12,0.0035608308605341245,3358,12,71041230,58085273
Denmark,2023-01-25,129129640,129129640,3137,https://www.sst.dk/en/english/corona-eng/status-of-the-epidemic/covid-19-updates-statistics-and-charts,67664762,61464878,3109,28,0.008925725215173734,3109,28,71044339,58085301
Denmark,2023-01-26,129129640,129129640,0,https://www.sst.dk/en/english/corona-eng/status-of-the-epidemic/covid-19-updates-statistics-and-charts,67664762,61464878,0,0,0.008925725215173734,0,0,71044339,58085301
Denmark,2023-01-27,129135783,129135783,6143,https://www.sst.dk/en/english/corona-eng/status-of-the-epidemic/covid-19-updates-statistics-and-charts,67670884,61464899,6122,21,0.0034185251505778934,6122,21,71050461,58085322
Denmark,2023-01-28,129135783,129135783,0,https://www.sst.dk/en/english/corona-eng/status-of-the-epidemic/covid-19-updates-statistics-and-charts,67670884,61464899,0,0,0.0034185251505778934,0,0,71050461,58085322
Denmark,2023-01-29,129135783,129135783,0,https://www.sst.dk/en/english/corona-eng/status-of-the-epidemic/covid-19-updates-statistics-and-charts,67670884,61464899,0,0,0.0034185251505778934,0,0,71050461,58085322
Denmark,2023-01-30,129135783,129135783,0,https://www.sst.dk/en/english/corona-eng/status-of-the-epidemic/covid-19-updates-statistics-and-charts,67670884,61464899,0,0,0.0034185251505778934,0,0,71050461,58085322
Denmark,2023-01-31,129144754,129144754,8971,https://www.sst.dk/en/english/corona-eng/status-of-the-epidemic/covid-19-updates-statistics-and-charts,67679826,61464928,8942,29,0.0032326385018392597,8942,29,71059403,58085351
Denmark,2023-02-01,129147644,129147644,2890,https://www.sst.dk/en/english/corona-eng/status-of-the-epidemic/covid-19-updates-statistics-and-charts,67682707,61464937,2881,9,0.0031141868512110727,2881,9,71062284,58085360
Denmark,2023-02-02,129147644,129147644,0,https://www.sst.dk/en/english/corona-eng/status-of-the-epidemic/covid-19-updates-statistics-and-charts,67682707,61464937,0,0,0.0031141868512110727,0,0,71062284,58085360
Denmark,2023-02-03,129152682,129152682,5038,https://www.sst.dk/en/english/corona-eng/status-of-the-epidemic/covid-19-updates-statistics-and-charts,67687730,61464952,5023,15,0.0029773719730051607,5023,15,71067307,58085375
Denmark,2023-02-04,129152682,129152682,0,https://www.sst.dk/en/english/corona-eng/status-of-the-epidemic/covid-19-updates-statistics-and-charts,67687730,61464952,0,0,0.0029773719730051607,0,0,71067307,58085375
Denmark,2023-02-05,129152682,129152682,0,https://www.sst.dk/en/english/corona-eng/status-of-the-epidemic/covid-19-updates-statistics-and-charts,67687730,61464952,0,0,0.0029773719730051607,0,0,71067307,58085375
Denmark,2023-02-06,129157739,129157739,5057,https://www.sst.dk/en/english/corona-eng/status-of-the-epidemic/covid-19-updates-statistics-and-charts,67692763,61464976,5033,24,0.004745896776745106,5033,24,71072340,58085399
Denmark,2023-02-07,129160154,129160154,2415,https://www.sst.dk/en/english/corona-eng/status-of-the-epidemic/covid-19-updates-statistics-and-charts,67695171,61464983,2408,7,0.002898550724637681,2408,7,71074748,58085406
Denmark,2023-02-08,129160154,129160154,0,https://www.sst.dk/en/english/corona-eng/status-of-the-epidemic/covid-19-updates-statistics-and-charts,67695171,61464983,0,0,0.002898550724637681,0,0,71074748,58085406
Denmark,2023-02-09,129165072,129165072,4918,https://www.sst.dk/en/english/corona-eng/status-of-the-epidemic/covid-19-updates-statistics-and-charts,67700084,61464988,4913,5,0.0010166734444896298,4913,5,71079661,58085411
Denmark,2023-02-10,129167479,129167479,2407,https://www.sst.dk/en/english/corona-eng/status-of-the-epidemic/covid-19-updates-statistics-and-charts,67702484,61464995,2400,7,0.0029081844619858743,2400,7,71082061,58085418
Denmark,2023-02-11,129167479,129167479,0,https://www.sst.dk/en/english/corona-eng/status-of-the-epidemic/covid-19-updates-statistics-and-charts,67702484,61464995,0,0,0.0029081844619858743,0,0,71082061,58085418
Denmark,2023-02-12,129167479,129167479,0,https://www.sst.dk/en/english/corona-eng/status-of-the-epidemic/covid-19-updates-statistics-and-charts,67702484,61464995,0,0,0.0029081844619858743,0,0,71082061,58085418
Denmark,2023-02-13,129167479,129167479,0,https://www.sst.dk/en/english/corona-eng/status-of-the-epidemic/covid-19-updates-statistics-and-charts,67702484,61464995,0,0,0.0029081844619858743,0,0,71082061,58085418
Denmark,2023-02-14,129174451,129174451,6972,https://www.sst.dk/en/english/corona-eng/status-of-the-epidemic/covid-19-updates-statistics-and-charts,67709424,61465027,6940,32,0.004589787722317842,6940,32,71089001,58085450
Indonesia,2021-05-28,16483519,16483519,110682,https://data.covid19.go.id/public/index.html,14496867,1986652,53372,57310,0.5177897038362155,53372,57310,14496867,1986652
Indonesia,2021-05-29,16589465,16589465,105946,https://data.covid19.go.id/public/index.html,14550421,2039044,53554,52392,0.49451607422649274,53554,52392,14550421,2039044
Indonesia,2021-05-30,16660482,16660482,71017,https://data.covid19.go.id/public/index.html,14590381,2070101,39960,31057,0.437317825309433,39960,31057,14590381,2070101
Indonesia,2021-05-31,16728343,16728343,67861,https://data.covid19.go.id/public/index.html,14623238,2105105,32857,35004,0.5158191008090066,32857,35004,14623238,2105105
Indonesia,2021-06-01,16804288,16804288,75945,https://data.covid19.go.id/public/index.html,14662830,2141458,39592,36353,0.4786753571663704,39592,36353,14662830,2141458
Indonesia,2021-06-02,16869118,16869118,64830,https://data.covid19.go.id/public/index.html,14692548,2176570,29718,35112,0.5416011105969458,29718,35112,14692548,2176570
Indonesia,2021-06-03,16964318,16964318,95200,https://data.covid19.go.id/public/index.html,14752636,2211682,60088,35112,0.3688235294117647,60088,35112,14752636,2211682
Indonesia,2021-06-04,16964318,16964318,0,https://data.covid19.go.id/public/index.html,14752636,2211682,0,0,0.3688235294117647,0,0,14752636,2211682
Indonesia,2021-06-05,17171338,17171338,207020,https://data.covid19.go.id/public/index.html,14867470,2303868,114834,92186,0.445299971017293,114834,92186,14867470,2303868
Indonesia,2021-06-06,17235561,17235561,64223,https://data.covid19.go.id/public/index.html,14905006,2330555,37536,26687,0.41553649004250814,37536,26687,14905006,2330555
Indonesia,2021-06-07,17299617,17299617,64056,https://data.covid19.go.id/public/index.html,14938098,2361519,33092,30964,0.4833895341576121,33092,30964,14938098,2361519
Indonesia,2021-06-08,17401548,17401548,101931,https://data.covid19.go.id/public/index.html,14993704,2407844,55606,46325,0.4544741050318353,55606,46325,14993704,2407844
Indonesia,2021-06-09,17509373,17509373,107825,https://data.covid19.go.id/public/index.html,15055117,2454256,61413,46412,0.4304382100626014,61413,46412,15055117,2454256
Indonesia,2021-06-10,17619996,17619996,110623,https://data.covid19.go.id/public/index.html,15119217,2500779,64100,46523,0.4205544959004909,64100,46523,15119217,2500779
Indonesia,2021-06-11,17735758,17735758,115762,https://data.covid19.go.id/public/index.html,15181737,2554021,62520,53242,0.459926400718716,62520,53242,15181737,2554021
Indonesia,2021-06-12,17833717,17833717,97959,https://data.covid19.go.id/public/index.html,15237192,2596525,55455,42504,0.4338958135546504,55455,42504,15237192,2596525
Indonesia,2021-06-13,17904185,17904185,70468,https://data.covid19.go.id/public/index.html,15282617,2621568,45425,25043,0.35538116591928254,45425,25043,15282617,2621568
Indonesia,2021-06-14,17973499,17973499,69314,https://data.covid19.go.id/public/index.html,15319220,2654279,36603,32711,0.4719248636639063,36603,32711,15319220,2654279
Indonesia,2021-06-15,16704989,17973499,0,https://data.covid19.go.id/public/index.html,14565682,2139307,-753538,-514972,0.40596605466255686,0,0,15319220,2654279
Indonesia,2021-06-16,18174981,18174981,201482,https://data.covid19.go.id/public/index.html,15452879,2722102,887197,582795,0.3964613412862111,121602,79880,15440822,2734159
Indonesia,2021-06-17,18305810,18305810,130829,https://data.covid19.go.id/public/index.html,15528844,2776966,75965,54864,0.4193565646760275,75965,54864,15516787,2789023
Indonesia,2021-06-18,18438025,18438025,132215,https://data.covid19.go.id/public/index.html,15606477,2831548,77633,54582,0.4128275914230609,77633,54582,15594420,2843605
Indonesia,2021-06-19,18560435,18560435,122410,https://data.covid19.go.id/public/index.html,15679613,2880822,73136,49274,0.4025324728371865,73136,49274,15667556,2892879
Indonesia,2021-06-20,18649618,18649618,89183,https://data.covid19.go.id/public/index.html,15735333,2914285,55720,33463,0.37521724992431293,55720,33463,15723276,2926342
Indonesia,2021-06-21,18734036,18734036,84418,https://data.covid19.go.id/public/index.html,15783090,2950946,47757,36661,0.43427941908123857,47757,36661,15771033,2963003
Indonesia,2021-06-22,18864666,18864666,130630,https://data.covid19.go.id/public/index.html,15859150,3005516,76060,54570,0.41774477531960497,76060,54570,15847093,3017573
Indonesia,2021-06-23,19005853,19005853,141187,https://data.covid19.go.id/public/index.html,15947439,3058414,88289,52898,0.374666222810882,88289,52898,15935382,3070471
Indonesia,2021-06-24,19142749,19142749,136896,https://data.covid19.go.id/public/index.html,16030869,3111880,83430,53466,0.3905592566619916,83430,53466,16018812,3123937
Indonesia,2021-06-25,19283664,19283664,140915,https://data.covid19.go.id/public/index.html,16118700,3164964,87831,53084,0.3767093638008729,87831,53084,16106643,3177021
Indonesia,2021-06-26,19419298,19419298,135634,https://data.covid19.go.id/public/index.html,16203773,3215525,85073,50561,0.37277526283970097,85073,50561,16191716,3227582
Indonesia,2021-06-27,19518202,19518202,98904,https://data.covid19.go.id/public/index.html,16267011,3251191,63238,35666,0.36061231092776835,63238,35666,16254954,3263248
Indonesia,2021-06-28,19616389,19616389,98187,https://data.covid19.go.id/public/index.html,16326119,3290270,59108,39079,0.39800584598775807,59108,39079,16314062,3302327
Indonesia,2021-06-29,19760346,19760346,143957,https://data.covid19.go.id/public/index.html,16412932,3347414,86813,57144,0.39695186757156653,86813,57144,16400875,3359471
Indonesia,2021-06-30,19903077,19903077,142731,https://data.covid19.go.id/public/index.html,16497987,3405090,85055,57676,0.4040888104196005,85055,57676,16485930,3417147
Indonesia,2021-07-01,20058268,20058268,155191,https://data.covid19.go.id/public/index.html,16596629,3461639,98642,56549,0.36438324387367826,98642,56549,16584572,3473696
Indonesia,2021-07-02,20211876,20211876,153608,https://data.covid19.go.id/public/index.html,16690268,3521608,93639,59969,0.39040284360189575,93639,59969,16678211,3533665
Indonesia,2021-07-03,20369103,20369103,157227,https://data.covid19.go.id/public/index.html,16794048,3575055,103780,53447,0.3399352528509734,103780,53447,16781991,3587112
Indonesia,2021-07-04,20489937,20489937,120834,https://data.covid19.go.id/public/index.html,16875347,3614590,81299,39535,0.32718440174123176,81299,39535,16863290,3626647
Indonesia,2021-07-05,20600052,20600052,110115,https://data.covid19.go.id/public/index.html,16947492,3652560,72145,37970,0.34482132316214864,72145,37970,16935435,3664617
Indonesia,2021-07-06,20783105,20783105,183053,https://data.covid19.go.id/public/index.html,17066516,3716589,119024,64029,0.34978394235549265,119024,64029,17054459,3728646
Indonesia,2021-07-07,20982248,20982248,199143,https://data.covid19.go.id/public/index.html,17200095,3782153,133579,65564,0.3292307537799471,133579,65564,17188038,3794210
Indonesia,2021-07-08,21182629,21182629,200381,https://data.covid19.go.id/public/index.html,17334669,3847960,134574,65807,0.32840938013085075,134574,65807,17322612,3860017
Indonesia,2021-07-09,21402544,21402544,219915,https://data.covid19.go.id/public/index.html,17487494,3915050,152825,67090,0.30507241434190485,152825,67090,17475437,3927107
Indonesia,2021-07-10,21597103,21597103,194559,https://data.covid19.go.id/public/index.html,17610356,3986747,122862,71697,0.36851032334664546,122862,71697,17598299,3998804
Indonesia,2021-07-11,21756322,21756322,159219,https://data.covid19.go.id/public/index.html,17711786,4044536,101430,57789,0.3629529139110282,101430,57789,17699729,4056593
Indonesia,2021-07-12,21906066,21906066,149744,https://data.covid19.go.id/public/index.html,17810718,4095348,98932,50812,0.3393257826690886,98932,50812,17798661,4107405
Indonesia,2021-07-13,22133149,22133149,227083,https://data.covid19.go.id/public/index.html,17962084,4171065,151366,75717,0.3334331499936147,151366,75717,17950027,4183122
Indonesia,2021-07-14,22373873,22373873,240724,https://data.covid19.go.id/public/index.html,18129868,4244005,167784,72940,0.30300260879679636,167784,72940,18117811,4256062
Indonesia,2021-07-15,22622932,22622932,249059,https://data.covid19.go.id/public/index.html,18300359,4322573,170491,78568,0.3154593891407257,170491,78568,18288302,4334630
Indonesia,2021-07-16,22881464,22881464,258532,https://data.covid19.go.id/public/index.html,18466229,4415235,165870,92662,0.3584159794532205,165870,92662,18454172,4427292
Indonesia,2021-07-17,23132856,23132856,251392,https://data.covid19.go.id/public/index.html,18618081,4514775,151852,99540,0.39595532077393075,151852,99540,18606024,4526832
Indonesia,2021-07-18,23325774,23325774,192918,https://data.covid19.go.id/public/index.html,18744047,4581727,125966,66952,0.3470490052768534,125966,66952,18731990,4593784
Indonesia,2021-07-19,23486979,23486979,161205,https://data.covid19.go.id/public/index.html,18836867,4650112,92820,68385,0.4242114078347446,92820,68385,18824810,4662169
Indonesia,2021-07-20,23666254,23666254,179275,https://data.covid19.go.id/public/index.html,18959730,4706524,122863,56412,0.31466741040301216,122863,56412,18947673,4718581
Indonesia,2021-07-21,23819584,23819584,153330,https://data.covid19.go.id/public/index.html,19052340,4767244,92610,60720,0.3960086088828018,92610,60720,19040283,4779301
Indonesia,2021-07-22,24114054,24114054,294470,https://data.covid19.go.id/public/index.html,19212660,4901394,160320,134150,0.455564234047611,160320,134150,19200603,4913451
Indonesia,2021-07-23,24388300,24388300,274246,https://data.covid19.go.id/public/index.html,19372685,5015615,160025,114221,0.416491033597573,160025,114221,19360628,5027672
Indonesia,2021-07-24,24640996,24640996,252696,https://data.covid19.go.id/public/index.html,19517126,5123870,144441,108255,0.42840013296609364,144441,108255,19505069,5135927
Indonesia,2021-07-25,24814468,24814468,173472,https://data.covid19.go.id/public/index.html,19626739,5187729,109613,63859,0.3681228094447519,109613,63859,19614682,5199786
Indonesia,2021-07-26,24975057,24975057,160589,https://data.covid19.go.id/public/index.html,19705766,5269291,79027,81562,0.5078928195580021,79027,81562,19693709,5281348
Indonesia,2021-07-27,25245491,25245491,270434,https://data.covid19.go.id/public/index.html,19847285,5398206,141519,128915,0.4766967171287634,141519,128915,19835228,5410263
Indonesia,2021-07-28,25523300,25523300,277809,https://data.covid19.go.id/public/index.html,19998984,5524316,151699,126110,0.4539449765846319,151699,126110,19986927,5536373
Indonesia,2021-07-29,25786254,25786254,262954,https://data.covid19.go.id/public/index.html,20138274,5647980,139290,123664,0.4702875788160667,139290,123664,20126217,5660037
Indonesia,2021-07-30,26038438,26038438,252184,https://data.covid19.go.id/public/index.html,20270905,5767533,132631,119553,0.4740705199378232,132631,119553,20258848,5779590
Indonesia,2021-07-31,26280203,26280203,241765,https://data.covid19.go.id/public/index.html,20399603,5880600,128698,113067,0.4676731536822948,128698,113067,20387546,5892657
Indonesia,2021-08-01,26458578,26458578,178375,https://data.covid19.go.id/public/index.html,20497668,5960910,98065,80310,0.4502312543798178,98065,80310,20485611,5972967
Indonesia,2021-08-02,26609794,26609794,151216,https://data.covid19.go.id/public/index.html,20568323,6041471,70655,80561,0.5327544704264099,70655,80561,20556266,6053528
Indonesia,2021-08-03,26858020,26858020,248226,https://data.covid19.go.id/public/index.html,20693960,6164060,125637,122589,0.49386043363708876,125637,122589,20681903,6176117
Indonesia,2021-08-04,27100348,27100348,242328,https://data.covid19.go.id/public/index.html,20822509,6277839,128549,113779,0.4695247763362055,128549,113779,20810452,6289896
Indonesia,2021-08-05,27348904,27348904,248556,https://data.covid19.go.id/public/index.html,20951340,6397564,128831,119725,0.48168219636621123,128831,119725,20939283,6409621
Indonesia,2021-08-06,27586460,27586460,237556,https://data.covid19.go.id/public/index.html,21074562,6511898,123222,114334,0.48129283200592704,123222,114334,21062505,6523955
Indonesia,2021-08-07,27822427,27822427,235967,https://data.covid19.go.id/public/index.html,21194105,6628322,119543,116424,0.4933910250162099,119543,116424,21182048,6640379
Indonesia,2021-08-08,27989191,27989191,166764,https://data.covid19.go.id/public/index.html,21284138,6705053,90033,76731,0.46011729150176295,90033,76731,21272081,6717110
Indonesia,2021-08-09,28134393,28134393,145202,https://data.covid19.go.id/public/index.html,21349294,6785099,65156,80046,0.551273398438038,65156,80046,21337237,6797156
Indonesia,2021-08-10,28134393,28134393,0,https://data.covid19.go.id/public/index.html,21349294,6785099,0,0,0.551273398438038,0,0,21337237,6797156
Indonesia,2021-08-11,28586360,28586360,451967,https://data.covid19.go.id/public/index.html,21588910,6997450,239616,212351,0.46983739963315907,239616,212351,21576853,7009507
Indonesia,2021-08-12,28740077,28740077,153717,https://data.covid19.go.id/public/index.html,21663300,7076777,74390,79327,0.5160587313049305,74390,79327,21651243,7088834
Indonesia,2021-08-13,28966108,28966108,226031,https://data.covid19.go.id/public/index.html,21778501,7187607,115201,110830,0.4903309723002597,115201,110830,21766444,7199664
Indonesia,2021-08-14,29188690,29188690,222582,https://data.covid19.go.id/public/index.html,21891198,7297492,112697,109885,0.4936832268557206,112697,109885,21879141,7309549
Indonesia,2021-08-15,29347868,29347868,159178,https://data.covid19.go.id/public/index.html,21976134,7371734,84936,74242,0.46640867456558066,84936,74242,21964077,7383791
Indonesia,2021-08-16,29476878,29476878,129010,https://data.covid19.go.id/public/index.html,22031409,7445469,55275,73735,0.5715448414851562,55275,73735,22019352,7457526
Indonesia,2021-08-17,29659094,29659094,182216,https://data.covid19.go.id/public/index.html,22129280,7529814,97871,84345,0.4628847082583308,97871,84345,22117223,7541871
Indonesia,2021-08-18,29796276,29796276,137182,https://data.covid19.go.id/public/index.html,22192363,7603913,63083,74099,0.5401510402239361,63083,74099,22180306,7615970
Indonesia,2021-08-19,30010686,30010686,214410,https://data.covid19.go.id/public/index.html,22295526,7715160,103163,111247,0.5188517326617229,103163,111247,22283469,7727217
Indonesia,2021-08-20,30010686,30010686,0,https://data.covid19.go.id/public/index.html,22295526,7715160,0,0,0.5188517326617229,0,0,22283469,7727217
Indonesia,2021-08-21,30010686,30010686,0,https://data.covid19.go.id/public/index.html,22492196,7921224,196670,206064,0.5116627848654447,0,0,22283469,7727217
Indonesia,2021-08-22,30561830,30561830,551144,https://data.covid19.go.id/public/index.html,22568938,7992892,76742,71668,0.4829054645913348,284994,266150,22568463,7993367
Indonesia,2021-08-23,30684567,30684567,122737,https://data.covid19.go.id/public/index.html,22618857,8065710,49919,72818,0.5932848285358123,49919,72818,22618382,8066185
Indonesia,2021-08-24,30870419,30870419,185852,https://data.covid19.go.id/public/index.html,22713301,8157118,94444,91408,0.4918322105761574,94444,91408,22712826,8157593
Indonesia,2021-08-25,31119684,31119684,249265,https://data.covid19.go.id/public/index.html,22810376,8309308,97075,152190,0.6105550317934728,97075,152190,22809901,8309783
Indonesia,2021-08-26,31325458,31325458,205774,https://data.covid19.go.id/public/index.html,22900603,8424855,90227,115547,0.5615238076724951,90227,115547,22900128,8425330
Indonesia,2021-08-27,31509573,31509573,184115,https://data.covid19.go.id/public/index.html,22988922,8520651,88319,95796,0.5203052440051055,88319,95796,22988447,8521126
Indonesia,2021-08-28,31691247,31691247,181674,https://data.covid19.go.id/public/index.html,23074075,8617172,85153,96521,0.5312868104406795,85153,96521,23073600,8617647
Indonesia,2021-08-29,31845407,31845407,154160,https://data.covid19.go.id/public/index.html,23144992,8700415,70917,83243,0.5399779449922159,70917,83243,23144517,8700890
Indonesia,2021-08-30,31970830,31970830,125423,https://data.covid19.go.id/public/index.html,23190932,8779898,45940,79483,0.6337194932348931,45940,79483,23190457,8780373
Indonesia,2021-08-31,32195072,32195072,224242,https://data.covid19.go.id/public/index.html,23286944,8908128,96012,128230,0.5718375683413455,96012,128230,23286469,8908603
Indonesia,2021-09-01,32415133,32415133,220061,https://data.covid19.go.id/public/index.html,23376319,9038814,89375,130686,0.5938626108215449,89375,130686,23375844,9039289
Indonesia,2021-09-02,32415133,32415133,0,https://data.covid19.go.id/public/index.html,23376319,9038814,0,0,0.5938626108215449,0,0,23375844,9039289
Indonesia,2021-09-03,32833137,32833137,418004,https://data.covid19.go.id/public/index.html,23541905,9291232,165586,252418,0.6038650347843562,165586,252418,23541430,9291707
Indonesia,2021-09-04,33043568,33043568,210431,https://data.covid19.go.id/public/index.html,23626973,9416595,85068,125363,0.5957439730838137,85068,125363,23626498,9417070
Indonesia,2021-09-05,33215453,33215453,171885,https://data.covid19.go.id/public/index.html,23700088,9515365,73115,98770,0.574628385257585,73115,98770,23699613,9515840
Indonesia,2021-09-06,33368395,33368395,152942,https://data.covid19.go.id/public/index.html,23744725,9623670,44637,108305,0.7081442638385793,44637,108305,23744250,9624145
Indonesia,2021-09-07,33620034,33620034,251639,https://data.covid19.go.id/public/index.html,23834769,9785265,90044,161595,0.6421699339132646,90044,161595,23834294,9785740
Indonesia,2021-09-08,33852336,33852336,232302,https://data.covid19.go.id/public/index.html,23919674,9932662,84905,147397,0.6345059448476552,84905,147397,23919199,9933137
Indonesia,2021-09-09,34083614,34083614,231278,https://data.covid19.go.id/public/index.html,24001695,10081919,82021,149257,0.6453575350876435,82021,149257,24001220,10082394
Indonesia,2021-09-10,34319295,34319295,235681,https://data.covid19.go.id/public/index.html,24086033,10233262,84338,151343,0.6421518917519868,84338,151343,24085558,10233737
Indonesia,2021-09-11,34550865,34550865,231570,https://data.covid19.go.id/public/index.html,24173185,10377680,87152,144418,0.6236472772811676,87152,144418,24172710,10378155
Indonesia,2021-09-12,34748917,34748917,198052,https://data.covid19.go.id/public/index.html,24251448,10497469,78263,119789,0.6048361036495465,78263,119789,24250973,10497944
Indonesia,2021-09-13,34926151,34926151,177234,https://data.covid19.go.id/public/index.html,24297429,10628722,45981,131253,0.7405633230644233,45981,131253,24296954,10629197
Indonesia,2021-09-14,35204831,35204831,278680,https://data.covid19.go.id/public/index.html,24382949,10821882,85520,193160,0.6931247308741209,85520,193160,24382474,10822357
Indonesia,2021-09-15,35437272,35437272,232441,https://data.covid19.go.id/public/index.html,24469032,10968240,86083,146358,0.6296565580082688,86083,146358,24468557,10968715
Indonesia,2021-09-16,35536402,35536402,99130,https://data.covid19.go.id/public/index.html,24551856,10984546,82824,16306,0.1644910723292646,82824,16306,24551381,10985021
Indonesia,2021-09-17,35924694,35924694,388292,https://data.covid19.go.id/public/index.html,24631921,11292773,80065,308227,0.7938020870890979,80065,308227,24631446,11293248
Indonesia,2021-09-18,36200788,36200788,276094,https://data.covid19.go.id/public/index.html,24715125,11485663,83204,192890,0.6986388693705767,83204,192890,24714650,11486138
Indonesia,2021-09-19,36393201,36393201,192413,https://data.covid19.go.id/public/index.html,24789036,11604165,73911,118502,0.6158731478642295,73911,118502,24788561,11604640
Indonesia,2021-09-20,36595996,36595996,202795,https://data.covid19.go.id/public/index.html,24834712,11761284,45676,157119,0.7747676224758993,45676,157119,24834237,11761759
Indonesia,2021-09-21,36844653,36844653,248657,https://data.covid19.go.id/public/index.html,24916694,11927959,81982,166675,0.6703008561995037,81982,166675,24916219,11928434
Indonesia,2021-09-22,37100816,37100816,256163,https://data.covid19.go.id/public/index.html,24999553,12101263,82859,173304,0.6765379855794943,82859,173304,24999078,12101738
Indonesia,2021-09-23,37348941,37348941,248125,https://data.covid19.go.id/public/index.html,25075478,12273463,75925,172200,0.6940050377833753,75925,172200,25075003,12273938
Indonesia,2021-09-24,37601537,37601537,252596,https://data.covid19.go.id/public/index.html,25153527,12448010,78049,174547,0.6910125259307353,78049,174547,25153052,12448485
Indonesia,2021-09-25,37859340,37859340,257803,https://data.covid19.go.id/public/index.html,25234620,12624720,81093,176710,0.6854458637021291,81093,176710,25234145,12625195
Indonesia,2021-09-26,38076424,38076424,217084,https://data.covid19.go.id/public/index.html,25310450,12765974,75830,141254,0.6506882128576956,75830,141254,25309975,12766449
Indonesia,2021-09-27,38291015,38291015,214591,https://data.covid19.go.id/public/index.html,25356473,12934542,46023,168568,0.7855315460573836,46023,168568,25355998,12935017
Indonesia,2021-09-28,38566783,38566783,275768,https://data.covid19.go.id/public/index.html,25435980,13130803,79507,196261,0.7116888108845116,79507,196261,25435505,13131278
Indonesia,2021-09-29,38845350,38845350,278567,https://data.covid19.go.id/public/index.html,25520502,13324848,84522,194045,0.6965828687532981,84522,194045,25520027,13325323
Indonesia,2021-09-30,39121485,39121485,276135,https://data.covid19.go.id/public/index.html,25601325,13520160,80823,195312,0.7073062089195502,80823,195312,25600850,13520635
Indonesia,2021-10-01,39372853,39372853,251368,https://data.covid19.go.id/public/index.html,25681386,13691467,80061,171307,0.6814988383565131,80061,171307,25680911,13691942
Indonesia,2021-10-02,39609506,39609506,236653,https://data.covid19.go.id/public/index.html,25765163,13844343,83777,152876,0.6459922333543204,83777,152876,25764688,13844818
Indonesia,2021-10-03,39847564,39847564,238058,https://data.covid19.go.id/public/index.html,25848079,13999485,82916,155142,0.6516983256181267,82916,155142,25847604,13999960
Indonesia,2021-10-04,40059078,40059078,211514,https://data.covid19.go.id/public/index.html,25902430,14156648,54351,157163,0.7430382858817856,54351,157163,25901955,14157123
Indonesia,2021-10-05,40314564,40314564,255486,https://data.covid19.go.id/public/index.html,25988951,14325613,86521,168965,0.6613473928121306,86521,168965,25988476,14326088
Indonesia,2021-10-06,40589003,40589003,274439,https://data.covid19.go.id/public/index.html,26079683,14509320,90732,183707,0.6693910122103637,90732,183707,26079208,14509795
Indonesia,2021-10-07,40848558,40848558,259555,https://data.covid19.go.id/public/index.html,26163981,14684577,84298,175257,0.6752210514149217,84298,175257,26163506,14685052
Indonesia,2021-10-08,41116704,41116704,268146,https://data.covid19.go.id/public/index.html,26250511,14866193,86530,181616,0.677302663474376,86530,181616,26250036,14866668
Indonesia,2021-10-09,41383754,41383754,267050,https://data.covid19.go.id/public/index.html,26338371,15045383,87860,179190,0.6709979404605879,87860,179190,26337896,15045858
Indonesia,2021-10-10,41603403,41603403,219649,https://data.covid19.go.id/public/index.html,26419453,15183950,81082,138567,0.6308565028750416,81082,138567,26418978,15184425
Indonesia,2021-10-11,41828486,41828486,225083,https://data.covid19.go.id/public/index.html,26472413,15356073,52960,172123,0.7647090184509714,52960,172123,26471938,15356548
Indonesia,2021-10-12,42104849,42104849,276363,https://data.covid19.go.id/public/index.html,26561777,15543072,89364,186999,0.6766426764798471,89364,186999,26561302,15543547
Indonesia,2021-10-13,42366580,42366580,261731,https://data.covid19.go.id/public/index.html,26647726,15718854,85949,175782,0.6716132212080342,85949,175782,26647251,15719329
Indonesia,2021-10-14,42625525,42625525,258945,https://data.covid19.go.id/public/index.html,26734602,15890923,86876,172069,0.6645001834366371,86876,172069,26734127,15891398
Indonesia,2021-10-15,42892863,42892863,267338,https://data.covid19.go.id/public/index.html,26826441,16066422,91839,175499,0.6564685903238597,91839,175499,26825966,16066897
Indonesia,2021-10-16,43163674,43163674,270811,https://data.covid19.go.id/public/index.html,26919279,16244395,92838,177973,0.6571852694314485,92838,177973,26918804,16244870
Indonesia,2021-10-17,43387603,43387603,223929,https://data.covid19.go.id/public/index.html,27002693,16384910,83414,140515,0.627498001598721,83414,140515,27002218,16385385
Indonesia,2021-10-18,43602816,43602816,215213,https://data.covid19.go.id/public/index.html,27056217,16546599,53524,161689,0.7512975517278231,53524,161689,27055742,16547074
Indonesia,2021-10-19,43863159,43863159,260343,https://data.covid19.go.id/public/index.html,27137262,16725897,81045,179298,0.6886991392125005,81045,179298,27136787,16726372
Indonesia,2021-10-20,44111272,44111272,248113,https://data.covid19.go.id/public/index.html,27238717,16872555,101455,146658,0.5910935742988074,101455,146658,27238242,16873030
Indonesia,2021-10-21,44329671,44329671,218399,https://data.covid19.go.id/public/index.html,27314065,17015606,75348,143051,0.6549984203224374,75348,143051,27313590,17016081
Indonesia,2021-10-22,44580411,44580411,250740,https://data.covid19.go.id/public/index.html,27410872,17169539,96807,153933,0.6139148121560182,96807,153933,27410397,17170014
Indonesia,2021-10-23,44830998,44830998,250587,https://data.covid19.go.id/public/index.html,27515362,17315636,104490,146097,0.5830190712207737,104490,146097,27514887,17316111
Indonesia,2021-10-24,45045743,45045743,214745,https://data.covid19.go.id/public/index.html,27620573,17425170,105211,109534,0.5100654264360055,105211,109534,27620098,17425645
Indonesia,2021-10-25,45261565,45261565,215822,https://data.covid19.go.id/public/index.html,27691781,17569784,71208,144614,0.6700614395196041,71208,144614,27691306,17570259
Indonesia,2021-10-26,45520629,45520629,259064,https://data.covid19.go.id/public/index.html,27794838,17725791,103057,156007,0.6021948244449248,103057,156007,27794363,17726266
Indonesia,2021-10-27,45781080,45781080,260451,https://data.covid19.go.id/public/index.html,27903698,17877382,108860,151591,0.5820327048081981,108860,151591,27903223,17877857
Indonesia,2021-10-28,46040621,46040621,259541,https://data.covid19.go.id/public/index.html,28012264,18028357,108566,150975,0.5817000011558867,108566,150975,28011789,18028832
Indonesia,2021-10-29,46285013,46285013,244392,https://data.covid19.go.id/public/index.html,28117645,18167368,105381,139011,0.5688033978198959,105381,139011,28117170,18167843
Indonesia,2021-10-30,46524399,46524399,239386,https://data.covid19.go.id/public/index.html,28228848,18295551,111203,128183,0.5354657331673531,111203,128183,28228373,18296026
Indonesia,2021-10-31,46726472,46726472,202073,https://data.covid19.go.id/public/index.html,28332613,18393859,103765,98308,0.48649745389042576,103765,98308,28332138,18394334
Indonesia,2021-11-01,46930288,46930288,203816,https://data.covid19.go.id/public/index.html,28404375,18525913,71762,132054,0.6479079169446952,71762,132054,28403900,18526388
Indonesia,2021-11-02,47185852,47185852,255564,https://data.covid19.go.id/public/index.html,28510213,18675639,105838,149726,0.5858649888090655,105838,149726,28509738,18676114
Indonesia,2021-11-03,47438975,47438975,253123,https://data.covid19.go.id/public/index.html,28613659,18825316,103446,149677,0.5913212153775043,103446,149677,28613184,18825791
Indonesia,2021-11-04,47688215,47688215,249240,https://data.covid19.go.id/public/index.html,28694399,18993816,80740,168500,0.6760552078318087,80740,168500,28693924,18994291
Indonesia,2021-11-05,47904816,47904816,216601,https://data.covid19.go.id/public/index.html,28765095,19139721,70696,145905,0.6736118485140881,70696,145905,28764620,19140196
Indonesia,2021-11-06,48160848,48160848,256032,https://data.covid19.go.id/public/index.html,28829858,19330990,64763,191269,0.747051149856268,64763,191269,28829383,19331465
Indonesia,2021-11-07,48380805,48380805,219957,https://data.covid19.go.id/public/index.html,28887696,19493109,57838,162119,0.7370486049546048,57838,162119,28887221,19493584
Indonesia,2021-11-08,48569402,48569402,188597,https://data.covid19.go.id/public/index.html,28925490,19643912,37794,150803,0.7996044475786995,37794,150803,28925015,19644387
Indonesia,2021-11-09,48817417,48817417,248015,https://data.covid19.go.id/public/index.html,28989220,19828197,63730,184285,0.743039735499869,63730,184285,28988745,19828672
Indonesia,2021-11-10,49117017,49117017,299600,https://data.covid19.go.id/public/index.html,29053383,20063634,64163,235437,0.7858377837116155,64163,235437,29052908,20064109
Indonesia,2021-11-11,49379045,49379045,262028,https://data.covid19.go.id/public/index.html,29115546,20263499,62163,199865,0.7627619949013082,62163,199865,29115071,20263974
Indonesia,2021-11-12,49638862,49638862,259817,https://data.covid19.go.id/public/index.html,29170178,20468684,54632,205185,0.7897289245892302,54632,205185,29169703,20469159
Indonesia,2021-11-13,49905837,49905837,266975,https://data.covid19.go.id/public/index.html,29229565,20676272,59387,207588,0.7775559509317351,59387,207588,29229090,20676747
Indonesia,2021-11-14,50139036,50139036,233199,https://data.covid19.go.id/public/index.html,29282113,20856923,52548,180651,0.7746645568806041,52548,180651,29281638,20857398
Indonesia,2021-11-15,50382458,50382458,243422,https://data.covid19.go.id/public/index.html,29317490,21064968,35377,208045,0.8546680250757943,35377,208045,29317015,21065443
Indonesia,2021-11-16,50661473,50661473,279015,https://data.covid19.go.id/public/index.html,29378853,21282620,61363,217652,0.7800727559450209,61363,217652,29378378,21283095
Indonesia,2021-11-17,50940689,50940689,279216,https://data.covid19.go.id/public/index.html,29443668,21497021,64815,214401,0.767867887227093,64815,214401,29443193,21497496
Indonesia,2021-11-18,51210917,51210917,270228,https://data.covid19.go.id/public/index.html,29499578,21711339,55910,214318,0.793100640940243,55910,214318,29499103,21711814
Indonesia,2021-11-19,51483621,51483621,272704,https://data.covid19.go.id/public/index.html,29553780,21929841,54202,218502,0.8012423726824689,54202,218502,29553305,21930316
Indonesia,2021-11-20,51758593,51758593,274972,https://data.covid19.go.id/public/index.html,29607101,22151492,53321,221651,0.8060857105450737,53321,221651,29606626,22151967
Indonesia,2021-11-21,51997773,51997773,239180,https://data.covid19.go.id/public/index.html,29654030,22343743,46929,192251,0.8037921230872147,46929,192251,29653555,22344218
Indonesia,2021-11-22,52249638,52249638,251865,https://data.covid19.go.id/public/index.html,29692043,22557595,38013,213852,0.8490739086415342,38013,213852,29691568,22558070
Indonesia,2021-11-23,52531079,52531079,281441,https://data.covid19.go.id/public/index.html,29749802,22781277,57759,223682,0.7947740378978188,57759,223682,29749327,22781752
Indonesia,2021-11-24,52819945,52819945,288866,https://data.covid19.go.id/public/index.html,29808540,23011405,58738,230128,0.7966600430649505,58738,230128,29808065,23011880
Indonesia,2021-11-25,53105367,53105367,285422,https://data.covid19.go.id/public/index.html,29863834,23241533,55294,230128,0.806272817091885,55294,230128,29863359,23242008
Indonesia,2021-11-26,53393987,53393987,288620,https://data.covid19.go.id/public/index.html,29921314,23472673,57480,231140,0.8008454022590257,57480,231140,29920839,23473148
Indonesia,2021-11-27,53681387,53681387,287400,https://data.covid19.go.id/public/index.html,29975173,23706214,53859,233541,0.8125991649269311,53859,233541,29974698,23706689
Indonesia,2021-11-28,53926386,53926386,244999,https://data.covid19.go.id/public/index.html,30021399,23904987,46226,198773,0.8113216788639953,46226,198773,30020924,23905462
Indonesia,2021-11-29,54160249,54160249,233863,https://data.covid19.go.id/public/index.html,30056489,24103760,35090,198773,0.8499548881182573,35090,198773,30056014,24104235
Indonesia,2021-11-30,54454474,54454474,294225,https://data.covid19.go.id/public/index.html,30111920,24342554,55431,238794,0.8116033647718582,55431,238794,30111445,24343029
Indonesia,2021-12-01,54746617,54746617,292143,https://data.covid19.go.id/public/index.html,30167518,24579099,55598,236545,0.8096890906165816,55598,236545,30167043,24579574
Indonesia,2021-12-02,55038077,55038077,291460,https://data.covid19.go.id/public/index.html,30222991,24815086,55473,235987,0.8096719961572771,55473,235987,30222516,24815561
Indonesia,2021-12-03,55321140,55321140,283063,https://data.covid19.go.id/public/index.html,30275395,25045745,52404,230659,0.8148680682392259,52404,230659,30274920,25046220
Indonesia,2021-12-04,55613822,55613822,292682,https://data.covid19.go.id/public/index.html,30327281,25286541,51886,240796,0.8227222719538612,51886,240796,30326806,25287016
Indonesia,2021-12-05,55863036,55863036,249214,https://data.covid19.go.id/public/index.html,30372990,25490046,45709,203505,0.8165873506303819,45709,203505,30372515,25490521
Indonesia,2021-12-06,56152356,56152356,289320,https://data.covid19.go.id/public/index.html,30405269,25747087,32279,257041,0.8884314945389189,32279,257041,30404794,25747562
Indonesia,2021-12-07,56528234,56528234,375878,https://data.covid19.go.id/public/index.html,30455710,26072524,50441,325437,0.8658048622159318,50441,325437,30455235,26072999
Indonesia,2021-12-08,56906431,56906431,378197,https://data.covid19.go.id/public/index.html,30508170,26398261,52460,325737,0.8612892222836247,52460,325737,30507695,26398736
Indonesia,2021-12-09,57266941,57266941,360510,https://data.covid19.go.id/public/index.html,30559346,26707595,51176,309334,0.8580455465867799,51176,309334,30558871,26708070
Indonesia,2021-12-10,57596611,57596611,329670,https://data.covid19.go.id/public/index.html,30610686,26985925,51340,278330,0.8442685109351776,51340,278330,30610211,26986400
Indonesia,2021-12-11,57900609,57900609,303998,https://data.covid19.go.id/public/index.html,30661388,27239221,50702,253296,0.8332160080000526,50702,253296,30660913,27239696
Indonesia,2021-12-12,58162340,58162340,261731,https://data.covid19.go.id/public/index.html,30707252,27455088,45864,215867,0.824766649728156,45864,215867,30706777,27455563
Indonesia,2021-12-13,58431254,58431254,268914,https://data.covid19.go.id/public/index.html,30740162,27691092,32910,236004,0.8776188669983712,32910,236004,30739687,27691567
Indonesia,2021-12-14,58730148,58730148,298894,https://data.covid19.go.id/public/index.html,30792751,27937397,52589,246305,0.8240546815928055,52589,246305,30792276,27937872
Indonesia,2021-12-15,59039281,59039281,309133,https://data.covid19.go.id/public/index.html,30843988,28195293,51237,257896,0.8342558057535107,51237,257896,30843513,28195768
Indonesia,2021-12-16,59343891,59343891,304610,https://data.covid19.go.id/public/index.html,30898701,28445190,54713,249897,0.8203834411214339,54713,249897,30898226,28445665
Indonesia,2021-12-17,59652804,59652804,308913,https://data.covid19.go.id/public/index.html,30953256,28699548,54555,254358,0.8233968787328471,54555,254358,30952781,28700023
Indonesia,2021-12-18,59964823,59964823,312019,https://data.covid19.go.id/public/index.html,31006424,28958399,53168,258851,0.829600120505482,53168,258851,31005949,28958874
Indonesia,2021-12-19,60204039,60204039,239216,https://data.covid19.go.id/public/index.html,31052970,29151069,46546,192670,0.8054227141997191,46546,192670,31052495,29151544
Indonesia,2021-12-20,60470151,60470151,266112,https://data.covid19.go.id/public/index.html,31088160,29381991,35190,230922,0.8677624458874459,35190,230922,31087685,29382466
Indonesia,2021-12-21,60784337,60784337,314186,https://data.covid19.go.id/public/index.html,31143691,29640646,55531,258655,0.8232543779799227,55531,258655,31143216,29641121
Indonesia,2021-12-22,61083259,61083259,298922,https://data.covid19.go.id/public/index.html,31197567,29885692,53876,245046,0.8197656913843745,53876,245046,31197092,29886167
Indonesia,2021-12-23,61372344,61372344,289085,https://data.covid19.go.id/public/index.html,31248417,30123927,50850,238235,0.8241001781482955,50850,238235,31247942,30124402
Indonesia,2021-12-24,61632313,61632313,259969,https://data.covid19.go.id/public/index.html,31293715,30338598,45298,214671,0.8257561478483973,45298,214671,31293240,30339073
Indonesia,2021-12-25,61840900,61840900,208587,https://data.covid19.go.id/public/index.html,31336809,30504091,43094,165493,0.793400355726867,43094,165493,31336334,30504566
Indonesia,2021-12-26,61840900,61840900,0,https://data.covid19.go.id/public/index.html,31336809,30504091,0,0,0.793400355726867,0,0,31336334,30504566
Indonesia,2021-12-27,62247607,62247607,406707,https://data.covid19.go.id/public/index.html,31396889,30850718,60080,346627,0.8522769463028667,60080,346627,31396414,30851193
Indonesia,2021-12-28,62494654,62494654,247047,https://data.covid19.go.id/public/index.html,31442874,31051780,45985,201062,0.8138613300303181,45985,201062,31442399,31052255
Indonesia,2021-12-29,62726434,62726434,231780,https://data.covid19.go.id/public/index.html,31484527,31241907,41653,190127,0.8202907929933557,41653,190127,31484052,31242382
Indonesia,2021-12-30,62956193,62956193,229759,https://data.covid19.go.id/public/index.html,31522064,31434129,37537,192222,0.8366244630242994,37537,192222,31521589,31434604
Indonesia,2021-12-31,63166543,63166543,210350,https://data.covid19.go.id/public/index.html,31558897,31607646,36833,173517,0.8248966009032564,36833,173517,31558422,31608121
Indonesia,2022-01-01,63343702,63343702,177159,https://data.covid19.go.id/public/index.html,31595574,31748128,36677,140482,0.7929712856812242,36677,140482,31595099,31748603
Indonesia,2022-01-02,63545184,63545184,201482,https://data.covid19.go.id/public/index.html,31624148,31921036,28574,172908,0.8581808796815596,28574,172908,31623673,31921511
Indonesia,2022-01-03,63829597,63829597,284413,https://data.covid19.go.id/public/index.html,31656828,32172769,32680,251733,0.8850966727962505,32680,251733,31656353,32173244
Indonesia,2022-01-04,64137224,64137224,307627,https://data.covid19.go.id/public/index.html,31708822,32428402,51994,255633,0.8309836262746768,51994,255633,31708347,32428877
Indonesia,2022-01-05,64422368,64422368,285144,https://data.covid19.go.id/public/index.html,31761384,32660984,52562,232582,0.8156650674746795,52562,232582,31760909,32661459
Indonesia,2022-01-06,64697095,64697095,274727,https://data.covid19.go.id/public/index.html,31806635,32890460,45251,229476,0.8352873943951632,45251,229476,31806160,32890935
Indonesia,2022-01-07,64980357,64980357,283262,https://data.covid19.go.id/public/index.html,31855721,33124636,49086,234176,0.8267116662312629,49086,234176,31855246,33125111
Indonesia,2022-01-08,65259045,65259045,278688,https://data.covid19.go.id/public/index.html,31907717,33351328,51996,226692,0.8134257664485015,51996,226692,31907242,33351803
Indonesia,2022-01-09,65514927,65514927,255882,https://data.covid19.go.id/public/index.html,31952944,33561983,45227,210655,0.8232505608053712,45227,210655,31952469,33562458
Indonesia,2022-01-10,65774472,65774472,259545,https://data.covid19.go.id/public/index.html,31986914,33787558,33970,225575,0.8691171087865303,33970,225575,31986439,33788033
Indonesia,2022-01-11,66062939,66062939,288467,https://data.covid19.go.id/public/index.html,32035574,34027365,48660,239807,0.8313151937656647,48660,239807,32035099,34027840
Indonesia,2022-01-12,66336745,66336745,273806,https://data.covid19.go.id/public/index.html,32081149,34255596,45575,228231,0.833550031774322,45575,228231,32080674,34256071
Indonesia,2022-01-13,66615011,66615011,278266,https://data.covid19.go.id/public/index.html,32131554,34483457,50405,227861,0.8188603710119094,50405,227861,32131079,34483932
Indonesia,2022-01-14,66895574,66895574,280563,https://data.covid19.go.id/public/index.html,32182253,34713321,50699,229864,0.8192954880009125,50699,229864,32181778,34713796
Indonesia,2022-01-15,67173430,67173430,277856,https://data.covid19.go.id/public/index.html,32231089,34942341,48836,229020,0.8242398940458366,48836,229020,32230614,34942816
Indonesia,2022-01-16,67424918,67424918,251488,https://data.covid19.go.id/public/index.html,32277113,35147805,46024,205464,0.816993256139458,46024,205464,32276638,35148280
Indonesia,2022-01-17,67694431,67694431,269513,https://data.covid19.go.id/public/index.html,32310147,35384284,33034,236479,0.8774307732836635,33034,236479,32309672,35384759
Indonesia,2022-01-18,67973358,67973358,278927,https://data.covid19.go.id/public/index.html,32360414,35612944,50267,228660,0.8197843880298429,50267,228660,32359939,35613419
Indonesia,2022-01-19,68201218,68201218,227860,https://data.covid19.go.id/public/index.html,32414093,35787125,53679,174181,0.7644211357851313,53679,174181,32413618,35787600
Indonesia,2022-01-20,68527332,68527332,326114,https://data.covid19.go.id/public/index.html,32469897,36057435,55804,270310,0.8288819247257094,55804,270310,32469422,36057910
Indonesia,2022-01-21,68819737,68819737,292405,https://data.covid19.go.id/public/index.html,32525423,36294314,55526,236879,0.8101058463432568,55526,236879,32524948,36294789
Indonesia,2022-01-22,69100898,69100898,281161,https://data.covid19.go.id/public/index.html,32582688,36518210,57265,223896,0.7963266598141279,57265,223896,32582213,36518685
Indonesia,2022-01-23,69352805,69352805,251907,https://data.covid19.go.id/public/index.html,32635451,36717354,52763,199144,0.7905457172686745,52763,199144,32634976,36717829
Indonesia,2022-01-24,69611597,69611597,258792,https://data.covid19.go.id/public/index.html,32680432,36931165,44981,213811,0.8261885993384649,44981,213811,32679957,36931640
Indonesia,2022-01-25,69871272,69871272,259675,https://data.covid19.go.id/public/index.html,32747827,37123445,67395,192280,0.7404640415904497,67395,192280,32747352,37123920
Indonesia,2022-01-26,70220313,70220313,349041,https://data.covid19.go.id/public/index.html,32822882,37397431,75055,273986,0.7849679550539908,75055,273986,32822407,37397906
Indonesia,2022-01-27,70567046,70567046,346733,https://data.covid19.go.id/public/index.html,32905033,37662013,82151,264582,0.7630712969345289,82151,264582,32904558,37662488
Indonesia,2022-01-28,70939930,70939930,372884,https://data.covid19.go.id/public/index.html,32988819,37951111,83786,289098,0.7753027751257764,83786,289098,32988344,37951586
Indonesia,2022-01-29,71323331,71323331,383401,https://data.covid19.go.id/public/index.html,33084221,38239110,95402,287999,0.7511691414472054,95402,287999,33083746,38239585
Indonesia,2022-01-30,71637728,71637728,314397,https://data.covid19.go.id/public/index.html,33169891,38467837,85670,228727,0.7275101225520599,85670,228727,33169416,38468312
Indonesia,2022-01-31,71637728,71637728,0,https://data.covid19.go.id/public/index.html,33169891,38467837,0,0,0.7275101225520599,0,0,33169416,38468312
Indonesia,2022-02-01,71637728,71637728,0,https://data.covid19.go.id/public/index.html,33169891,38467837,0,0,0.7275101225520599,0,0,33169416,38468312
Indonesia,2022-02-02,71637728,71637728,0,https://data.covid19.go.id/public/index.html,33169891,38467837,0,0,0.7275101225520599,0,0,33169416,38468312
Indonesia,2022-02-03,71637728,71637728,0,https://data.covid19.go.id/public/index.html,33169891,38467837,0,0,0.7275101225520599,0,0,33169416,38468312
Indonesia,2022-02-04,71637728,71637728,0,https://data.covid19.go.id/public/index.html,33169891,38467837,0,0,0.7275101225520599,0,0,33169416,38468312
Indonesia,2022-02-05,71637728,71637728,0,https://data.covid19.go.id/public/index.html,33169891,38467837,0,0,0.7275101225520599,0,0,33169416,38468312
Indonesia,2022-02-06,71637728,71637728,0,https://data.covid19.go.id/public/index.html,34024875,40561282,854984,2093445,0.7100204888772971,0,0,33169416,38468312
Indonesia,2022-02-07,74586157,74586157,2948429,https://data.covid19.go.id/public/index.html,34024875,40561282,0,0,0.7100204888772971,854984,2093445,34024400,40561757
Indonesia,2022-02-08,75280587,75280587,694430,https://data.covid19.go.id/public/index.html,34282553,40998034,257678,436752,0.6289359618680068,257678,436752,34282078,40998509
Indonesia,2022-02-09,75685093,75685093,404506,https://data.covid19.go.id/public/index.html,34454637,41230456,172084,232422,0.5745823300519646,172084,232422,34454162,41230931
Indonesia,2022-02-10,76071156,76071156,386063,https://data.covid19.go.id/public/index.html,34608498,41462658,153861,232202,0.601461419509251,153861,232202,34608023,41463133
Indonesia,2022-02-11,76434721,76434721,363565,https://data.covid19.go.id/public/index.html,34748931,41685790,140433,223132,0.6137334451886183,140433,223132,34748456,41686265
Indonesia,2022-02-12,76964762,76964762,530041,https://data.covid19.go.id/public/index.html,34951163,42013599,202232,327809,0.6184597040606292,202232,327809,34950688,42014074
Indonesia,2022-02-13,77415802,77415802,451040,https://data.covid19.go.id/public/index.html,35119333,42296469,168170,282870,0.6271505853139411,168170,282870,35118858,42296944
Indonesia,2022-02-14,77856000,77856000,440198,https://data.covid19.go.id/public/index.html,35238842,42617158,119509,320689,0.7285108065007111,119509,320689,35238367,42617633
Indonesia,2022-02-15,78438828,78438828,582828,https://data.covid19.go.id/public/index.html,35418869,43019959,180027,402801,0.6911147027939633,180027,402801,35418394,43020434
Indonesia,2022-02-16,79004878,79004878,566050,https://data.covid19.go.id/public/index.html,35613424,43391454,194555,371495,0.6562936136383711,194555,371495,35612949,43391929
Indonesia,2022-02-17,79577733,79577733,572855,https://data.covid19.go.id/public/index.html,35817968,43759765,204544,368311,0.6429393127405714,204544,368311,35817493,43760240
Indonesia,2022-02-18,80079360,80079360,501627,https://data.covid19.go.id/public/index.html,36009814,44069546,191846,309781,0.61755248421636,191846,309781,36009339,44070021
Indonesia,2022-02-19,80569140,80569140,489780,https://data.covid19.go.id/public/index.html,36186495,44382645,176681,313099,0.6392645677651191,176681,313099,36186020,44383120
Indonesia,2022-02-20,81003675,81003675,434535,https://data.covid19.go.id/public/index.html,36354102,44649573,167607,266928,0.6142842348717594,167607,266928,36353627,44650048
Indonesia,2022-02-21,81396235,81396235,392560,https://data.covid19.go.id/public/index.html,36467061,44929174,112959,279601,0.7122503566333809,112959,279601,36466586,44929649
Indonesia,2022-02-22,81933316,81933316,537081,https://data.covid19.go.id/public/index.html,36646579,45286737,179518,357563,0.665752465642985,179518,357563,36646104,45287212
Indonesia,2022-02-23,82452848,82452848,519532,https://data.covid19.go.id/public/index.html,36823640,45629208,177061,342471,0.6591913491373005,177061,342471,36823165,45629683
Indonesia,2022-02-24,82958238,82958238,505390,https://data.covid19.go.id/public/index.html,36990185,45968053,166545,338845,0.6704624151645264,166545,338845,36989710,45968528
Indonesia,2022-02-25,83442770,83442770,484532,https://data.covid19.go.id/public/index.html,37148527,46294243,158342,326190,0.673206310419126,158342,326190,37148052,46294718
Indonesia,2022-02-26,83933900,83933900,491130,https://data.covid19.go.id/public/index.html,37299568,46634332,151041,340089,0.6924622808625007,151041,340089,37299093,46634807
Indonesia,2022-02-27,84304512,84304512,370612,https://data.covid19.go.id/public/index.html,37429838,46874674,130270,240342,0.6485003183922808,130270,240342,37429363,46875149
Indonesia,2022-02-28,84580727,84580727,276215,https://data.covid19.go.id/public/index.html,37519370,47061357,89532,186683,0.67586119508354,89532,186683,37518895,47061832
Indonesia,2022-03-01,85019478,85019478,438751,https://data.covid19.go.id/public/index.html,37619932,47399546,100562,338189,0.7707993827934295,100562,338189,37619457,47400021
Indonesia,2022-03-02,85620930,85620930,601452,https://data.covid19.go.id/public/index.html,37767541,47853389,147609,453843,0.7545789190159813,147609,453843,37767066,47853864
Indonesia,2022-03-03,86008226,86008226,387296,https://data.covid19.go.id/public/index.html,37905042,48103184,137501,249795,0.6449718045112782,137501,249795,37904567,48103659
Indonesia,2022-03-04,86349857,86349857,341631,https://data.covid19.go.id/public/index.html,37991707,48358150,86665,254966,0.7463198597316988,86665,254966,37991232,48358625
Indonesia,2022-03-05,86750007,86750007,400150,https://data.covid19.go.id/public/index.html,38109985,48640022,118278,281872,0.7044158440584781,118278,281872,38109510,48640497
Indonesia,2022-03-06,87107018,87107018,357011,https://data.covid19.go.id/public/index.html,38219451,48887567,109466,247545,0.6933819966331569,109466,247545,38218976,48888042
Indonesia,2022-03-07,87481657,87481657,374639,https://data.covid19.go.id/public/index.html,38295839,49185818,76388,298251,0.7961023812256599,76388,298251,38295364,49186293
Indonesia,2022-03-08,87892223,87892223,410566,https://data.covid19.go.id/public/index.html,38412716,49479507,116877,293689,0.7153271337616851,116877,293689,38412241,49479982
Indonesia,2022-03-09,88218970,88218970,326747,https://data.covid19.go.id/public/index.html,38521110,49697860,108394,218353,0.668263212822153,108394,218353,38520635,49698335
Indonesia,2022-03-10,88476967,88476967,257997,https://data.covid19.go.id/public/index.html,38611618,49865349,90508,167489,0.6491897192603014,90508,167489,38611143,49865824
Indonesia,2022-03-11,88699468,88699468,222501,https://data.covid19.go.id/public/index.html,38689331,50010137,77713,144788,0.6507296596419792,77713,144788,38688856,50010612
Indonesia,2022-03-12,88910570,88910570,211102,https://data.covid19.go.id/public/index.html,38760049,50150521,70718,140384,0.6650055423444591,70718,140384,38759574,50150996
Indonesia,2022-03-13,89081410,89081410,170840,https://data.covid19.go.id/public/index.html,38825342,50256068,65293,105547,0.6178119878248653,65293,105547,38824867,50256543
Indonesia,2022-03-14,89276639,89276639,195229,https://data.covid19.go.id/public/index.html,38874830,50401809,49488,145741,0.7465130692673732,49488,145741,38874355,50402284
Indonesia,2022-03-15,89512643,89512643,236004,https://data.covid19.go.id/public/index.html,38950560,50562083,75730,160274,0.6791156082100304,75730,160274,38950085,50562558
Indonesia,2022-03-16,89718792,89718792,206149,https://data.covid19.go.id/public/index.html,39016025,50702767,65465,140684,0.6824384304556413,65465,140684,39015550,50703242
Indonesia,2022-03-17,89912818,89912818,194026,https://data.covid19.go.id/public/index.html,39077659,50835159,61634,132392,0.6823415418552152,61634,132392,39077184,50835634
Indonesia,2022-03-18,90088638,90088638,175820,https://data.covid19.go.id/public/index.html,39132984,50955654,55325,120495,0.6853315891252417,55325,120495,39132509,50956129
Indonesia,2022-03-19,90243295,90243295,154657,https://data.covid19.go.id/public/index.html,39185228,51058067,52244,102413,0.6621944043916538,52244,102413,39184753,51058542
Indonesia,2022-03-20,90365359,90365359,122064,https://data.covid19.go.id/public/index.html,39232986,51132373,47758,74306,0.6087462314851225,47758,74306,39232511,51132848
Indonesia,2022-03-21,90519968,90519968,154609,https://data.covid19.go.id/public/index.html,39267530,51252438,34544,120065,0.7765718683905852,34544,120065,39267055,51252913
Indonesia,2022-03-22,90709336,90709336,189368,https://data.covid19.go.id/public/index.html,39322336,51387000,54806,134562,0.7105846816780026,54806,134562,39321861,51387475
Indonesia,2022-03-23,90875762,90875762,166426,https://data.covid19.go.id/public/index.html,39372214,51503548,49878,116548,0.7002992320911396,49878,116548,39371739,51504023
Indonesia,2022-03-24,91035716,91035716,159954,https://data.covid19.go.id/public/index.html,39420227,51615489,48013,111941,0.6998324518299011,48013,111941,39419752,51615964
Indonesia,2022-03-25,91035716,91035716,0,https://data.covid19.go.id/public/index.html,39420227,51615489,0,0,0.6998324518299011,0,0,39419752,51615964
Indonesia,2022-03-26,91035716,91035716,0,https://data.covid19.go.id/public/index.html,39420227,51615489,0,0,0.6998324518299011,0,0,39419752,51615964
Indonesia,2022-03-27,91035716,91035716,0,https://data.covid19.go.id/public/index.html,39420227,51615489,0,0,0.6998324518299011,0,0,39419752,51615964
Indonesia,2022-03-28,91535100,91535100,499384,https://data.covid19.go.id/public/index.html,39568406,51966694,148179,351205,0.7032764365698541,148179,351205,39567931,51967169
Indonesia,2022-03-29,91693202,91693202,158102,https://data.covid19.go.id/public/index.html,39610286,52082916,41880,116222,0.735107715272419,41880,116222,39609811,52083391
Indonesia,2022-03-30,91827562,91827562,134360,https://data.covid19.go.id/public/index.html,39650848,52176714,40562,93798,0.6981095564155999,40562,93798,39650373,52177189
Indonesia,2022-03-31,91960955,91960955,133393,https://data.covid19.go.id/public/index.html,39690973,52269982,40125,93268,0.6991971092935911,40125,93268,39690498,52270457
Indonesia,2022-04-01,92077404,92077404,116449,https://data.covid19.go.id/public/index.html,39726317,52351087,35344,81105,0.6964851565921563,35344,81105,39725842,52351562
Indonesia,2022-04-02,92077404,92077404,0,https://data.covid19.go.id/public/index.html,39726317,52351087,0,0,0.6964851565921563,0,0,39725842,52351562
Indonesia,2022-04-03,92077404,92077404,0,https://data.covid19.go.id/public/index.html,39726317,52351087,0,0,0.6964851565921563,0,0,39725842,52351562
Indonesia,2022-04-04,92077404,92077404,0,https://data.covid19.go.id/public/index.html,39726317,52351087,0,0,0.6964851565921563,0,0,39725842,52351562
Indonesia,2022-04-05,92541687,92541687,464283,https://data.covid19.go.id/public/index.html,39853330,52688357,127013,337270,0.7264319391405673,127013,337270,39852855,52688832
Indonesia,2022-04-06,92687409,92687409,145722,https://data.covid19.go.id/public/index.html,39887511,52799898,34181,111541,0.7654369278489178,34181,111541,39887036,52800373
Indonesia,2022-04-07,92817150,92817150,129741,https://data.covid19.go.id/public/index.html,39917097,52900053,29586,100155,0.7719610608828358,29586,100155,39916622,52900528
Indonesia,2022-04-08,92947569,92947569,130419,https://data.covid19.go.id/public/index.html,39945735,53001834,28638,101781,0.7804154302670623,28638,101781,39945260,53002309
Indonesia,2022-04-09,93069375,93069375,121806,https://data.covid19.go.id/public/index.html,39971630,53097745,25895,95911,0.7874078452621381,25895,95911,39971155,53098220
Indonesia,2022-04-10,93171527,93171527,102152,https://data.covid19.go.id/public/index.html,39997074,53174453,25444,76708,0.7509201973529642,25444,76708,39996599,53174928
Indonesia,2022-04-11,93301127,93301127,129600,https://data.covid19.go.id/public/index.html,40018413,53282714,21339,108261,0.8353472222222222,21339,108261,40017938,53283189
Indonesia,2022-04-12,93452538,93452538,151411,https://data.covid19.go.id/public/index.html,40049913,53402625,31500,119911,0.7919569912357755,31500,119911,40049438,53403100
Indonesia,2022-04-13,93593555,93593555,141017,https://data.covid19.go.id/public/index.html,40078490,53515065,28577,112440,0.7973506740322088,28577,112440,40078015,53515540
Indonesia,2022-04-14,93725462,93725462,131907,https://data.covid19.go.id/public/index.html,40105426,53620036,26936,104971,0.7957955226030461,26936,104971,40104951,53620511
Indonesia,2022-04-15,93833067,93833067,107605,https://data.covid19.go.id/public/index.html,40129937,53703130,24511,83094,0.7722131871195577,24511,83094,40129462,53703605
Indonesia,2022-04-16,93931526,93931526,98459,https://data.covid19.go.id/public/index.html,40148631,53782895,18694,79765,0.8101341675215065,18694,79765,40148156,53783370
Indonesia,2022-04-17,94034583,94034583,103057,https://data.covid19.go.id/public/index.html,40173211,53861372,24580,78477,0.7614912136002406,24580,78477,40172736,53861847
Indonesia,2022-04-18,94216598,94216598,182015,https://data.covid19.go.id/public/index.html,40155558,54061040,-17653,199668,0.7614912136002406,43412,138603,40216148,54000450
Indonesia,2022-04-19,94216598,94216598,0,https://data.covid19.go.id/public/index.html,40155558,54061040,0,0,0.7614912136002406,0,0,40216148,54000450
Indonesia,2022-04-20,94216598,94216598,0,https://data.covid19.go.id/public/index.html,40155558,54061040,0,0,0.7614912136002406,0,0,40216148,54000450
Indonesia,2022-04-21,94216598,94216598,0,https://data.covid19.go.id/public/index.html,40155558,54061040,0,0,0.7614912136002406,0,0,40216148,54000450
Indonesia,2022-04-22,94695148,94695148,478550,https://data.covid19.go.id/public/index.html,40299561,54395587,144003,334547,0.6990847351373942,144003,334547,40360151,54334997
Indonesia,2022-04-23,94810218,94810218,115070,https://data.covid19.go.id/public/index.html,40323594,54486624,24033,91037,0.7911445207265143,24033,91037,40384184,54426034
Indonesia,2022-04-24,94904806,94904806,94588,https://data.covid19.go.id/public/index.html,40345384,54559422,21790,72798,0.7696325115236605,21790,72798,40405974,54498832
Indonesia,2022-04-25,95024563,95024563,119757,https://data.covid19.go.id/public/index.html,40364192,54660371,18808,100949,0.8429486376579239,18808,100949,40424782,54599781
Indonesia,2022-04-26,95155820,95155820,131257,https://data.covid19.go.id/public/index.html,40391795,54764025,27603,103654,0.7897026444303923,27603,103654,40452385,54703435
Indonesia,2022-04-27,95279624,95279624,123804,https://data.covid19.go.id/public/index.html,40417357,54862267,25562,98242,0.7935284805014378,25562,98242,40477947,54801677
Indonesia,2022-04-28,95397890,95397890,118266,https://data.covid19.go.id/public/index.html,40441656,54956234,24299,93967,0.7945394280689294,24299,93967,40502246,54895644
Indonesia,2022-04-29,95495775,95495775,97885,https://data.covid19.go.id/public/index.html,40461794,55033981,20138,77747,0.7942687847984881,20138,77747,40522384,54973391
Indonesia,2022-04-30,95581660,95581660,85885,https://data.covid19.go.id/public/index.html,40479750,55101910,17956,67929,0.7909297316178611,17956,67929,40540340,55041320
Indonesia,2022-05-01,95647196,95647196,65536,https://data.covid19.go.id/public/index.html,40492502,55154694,12752,52784,0.805419921875,12752,52784,40553092,55094104
Indonesia,2022-05-02,95693154,95693154,45958,https://data.covid19.go.id/public/index.html,40501067,55192087,8565,37393,0.8136341877366291,8565,37393,40561657,55131497
Indonesia,2022-05-03,95739932,95739932,46778,https://data.covid19.go.id/public/index.html,40507243,55232689,6176,40602,0.8679721236478687,6176,40602,40567833,55172099
Indonesia,2022-05-04,95809698,95809698,69766,https://data.covid19.go.id/public/index.html,40517802,55291896,10559,59207,0.8486512054582461,10559,59207,40578392,55231306
Indonesia,2022-05-05,95898504,95898504,88806,https://data.covid19.go.id/public/index.html,40533610,55364894,15808,72998,0.8219940094137783,15808,72998,40594200,55304304
Indonesia,2022-05-06,95994568,95994568,96064,https://data.covid19.go.id/public/index.html,40550828,55443740,17218,78846,0.8207653231179214,17218,78846,40611418,55383150
Indonesia,2022-05-07,96102159,96102159,107591,https://data.covid19.go.id/public/index.html,40572020,55530139,21192,86399,0.8030318521065889,21192,86399,40632610,55469549
Indonesia,2022-05-08,96221718,96221718,119559,https://data.covid19.go.id/public/index.html,40598074,55623644,26054,93505,0.7820824864711147,26054,93505,40658664,55563054
Indonesia,2022-05-09,96426056,96426056,204338,https://data.covid19.go.id/public/index.html,40624283,55801773,26209,178129,0.8717370239505133,26209,178129,40684873,55741183
Indonesia,2022-05-10,96426056,96426056,0,https://data.covid19.go.id/public/index.html,40624283,55801773,0,0,0.8717370239505133,0,0,40684873,55741183
Indonesia,2022-05-11,96426056,96426056,0,https://data.covid19.go.id/public/index.html,40624283,55801773,0,0,0.8717370239505133,0,0,40684873,55741183
Indonesia,2022-05-12,96968564,96968564,542508,https://data.covid19.go.id/public/index.html,40715721,56252843,91438,451070,0.8314531767273478,91438,451070,40776311,56192253
Indonesia,2022-05-13,97115043,97115043,146479,https://data.covid19.go.id/public/index.html,40741317,56373726,25596,120883,0.825258228141918,25596,120883,40801907,56313136
Indonesia,2022-05-14,97245391,97245391,130348,https://data.covid19.go.id/public/index.html,40766224,56479167,24907,105441,0.8089192009083377,24907,105441,40826814,56418577
Indonesia,2022-05-15,97346292,97346292,100901,https://data.covid19.go.id/public/index.html,40787678,56558614,21454,79447,0.7873757445416795,21454,79447,40848268,56498024
Indonesia,2022-05-16,97434437,97434437,88145,https://data.covid19.go.id/public/index.html,40802912,56631525,15234,72911,0.8271711384650292,15234,72911,40863502,56570935
Indonesia,2022-05-17,97570814,97570814,136377,https://data.covid19.go.id/public/index.html,40824202,56746612,21290,115087,0.8438886322473731,21290,115087,40884792,56686022
Indonesia,2022-05-18,97722986,97722986,152172,https://data.covid19.go.id/public/index.html,40853623,56869363,29421,122751,0.8066595694345872,29421,122751,40914213,56808773
Indonesia,2022-05-19,97850450,97850450,127464,https://data.covid19.go.id/public/index.html,40879708,56970742,26085,101379,0.7953539823008849,26085,101379,40940298,56910152
Indonesia,2022-05-20,97949335,97949335,98885,https://data.covid19.go.id/public/index.html,40900621,57048714,20913,77972,0.7885119077716539,20913,77972,40961211,56988124
Indonesia,2022-05-21,98027949,98027949,78614,https://data.covid19.go.id/public/index.html,40918149,57109800,17528,61086,0.7770371689520951,17528,61086,40978739,57049210
Indonesia,2022-05-22,98090610,98090610,62661,https://data.covid19.go.id/public/index.html,40935162,57155448,17013,45648,0.7284914061377891,17013,45648,40995752,57094858
Indonesia,2022-05-23,98171807,98171807,81197,https://data.covid19.go.id/public/index.html,40948798,57223009,13636,67561,0.8320627609394435,13636,67561,41009388,57162419
Indonesia,2022-05-24,98271696,98271696,99889,https://data.covid19.go.id/public/index.html,40970975,57300721,22177,77712,0.7779835617535464,22177,77712,41031565,57240131
Indonesia,2022-05-25,98357716,98357716,86020,https://data.covid19.go.id/public/index.html,40994841,57362875,23866,62154,0.7225528946756569,23866,62154,41055431,57302285
Indonesia,2022-05-26,98415619,98415619,57903,https://data.covid19.go.id/public/index.html,41012968,57402651,18127,39776,0.6869419546482911,18127,39776,41073558,57342061
Indonesia,2022-05-27,98479250,98479250,63631,https://data.covid19.go.id/public/index.html,41027840,57451410,14872,48759,0.7662774433845139,14872,48759,41088430,57390820
Indonesia,2022-05-28,98544606,98544606,65356,https://data.covid19.go.id/public/index.html,41045362,57499244,17522,47834,0.7318991370340903,17522,47834,41105952,57438654
Indonesia,2022-05-29,98592166,98592166,47560,https://data.covid19.go.id/public/index.html,41058797,57533369,13435,34125,0.7175147182506307,13435,34125,41119387,57472779
Indonesia,2022-05-30,98662159,98662159,69993,https://data.covid19.go.id/public/index.html,41070244,57591915,11447,58546,0.8364550740788365,11447,58546,41130834,57531325
Indonesia,2022-05-31,98738878,98738878,76719,https://data.covid19.go.id/public/index.html,41089754,57649124,19510,57209,0.7456953297097199,19510,57209,41150344,57588534
Indonesia,2022-06-01,98796457,98796457,57579,https://data.covid19.go.id/public/index.html,41108897,57687560,19143,38436,0.6675350388162351,19143,38436,41169487,57626970
Indonesia,2022-06-02,98855980,98855980,59523,https://data.covid19.go.id/public/index.html,41121624,57734356,12727,46796,0.7861834920954925,12727,46796,41182214,57673766
Indonesia,2022-06-03,98928466,98928466,72486,https://data.covid19.go.id/public/index.html,41139690,57788776,18066,54420,0.7507656650939492,18066,54420,41200280,57728186
Indonesia,2022-06-04,98928466,98928466,0,https://data.covid19.go.id/public/index.html,41139690,57788776,0,0,0.7507656650939492,0,0,41200280,57728186
Indonesia,2022-06-05,98928466,98928466,0,https://data.covid19.go.id/public/index.html,41139690,57788776,0,0,0.7507656650939492,0,0,41200280,57728186
Indonesia,2022-06-06,98928466,98928466,0,https://data.covid19.go.id/public/index.html,41139690,57788776,0,0,0.7507656650939492,0,0,41200280,57728186
Indonesia,2022-06-07,98928466,98928466,0,https://data.covid19.go.id/public/index.html,41139690,57788776,0,0,0.7507656650939492,0,0,41200280,57728186
Indonesia,2022-06-08,98928466,98928466,0,https://data.covid19.go.id/public/index.html,41139690,57788776,0,0,0.7507656650939492,0,0,41200280,57728186
Indonesia,2022-06-09,98928466,98928466,0,https://data.covid19.go.id/public/index.html,41139690,57788776,0,0,0.7507656650939492,0,0,41200280,57728186
Indonesia,2022-06-10,98928466,98928466,0,https://data.covid19.go.id/public/index.html,41139690,57788776,0,0,0.7507656650939492,0,0,41200280,57728186
Indonesia,2022-06-11,98928466,98928466,0,https://data.covid19.go.id/public/index.html,41139690,57788776,0,0,0.7507656650939492,0,0,41200280,57728186
Indonesia,2022-06-12,98928466,98928466,0,https://data.covid19.go.id/public/index.html,41139690,57788776,0,0,0.7507656650939492,0,0,41200280,57728186
Indonesia,2022-06-13,98928466,98928466,0,https://data.covid19.go.id/public/index.html,41139690,57788776,0,0,0.7507656650939492,0,0,41200280,57728186
Indonesia,2022-06-14,98928466,98928466,0,https://data.covid19.go.id/public/index.html,41139690,57788776,0,0,0.7507656650939492,0,0,41200280,57728186
Indonesia,2022-06-15,98928466,98928466,0,https://data.covid19.go.id/public/index.html,41139690,57788776,0,0,0.7507656650939492,0,0,41200280,57728186
Indonesia,2022-06-16,98928466,98928466,0,https://data.covid19.go.id/public/index.html,41139690,57788776,0,0,0.7507656650939492,0,0,41200280,57728186
Indonesia,2022-06-17,98928466,98928466,0,https://data.covid19.go.id/public/index.html,41139690,57788776,0,0,0.7507656650939492,0,0,41200280,57728186
Indonesia,2022-06-18,98928466,98928466,0,https://data.covid19.go.id/public/index.html,41139690,57788776,0,0,0.7507656650939492,0,0,41200280,57728186
Indonesia,2022-06-19,98928466,98928466,0,https://data.covid19.go.id/public/index.html,41139690,57788776,0,0,0.7507656650939492,0,0,41200280,57728186
Indonesia,2022-06-20,98928466,98928466,0,https://data.covid19.go.id/public/index.html,41139690,57788776,0,0,0.7507656650939492,0,0,41200280,57728186
Indonesia,2022-06-21,98928466,98928466,0,https://data.covid19.go.id/public/index.html,41139690,57788776,0,0,0.7507656650939492,0,0,41200280,57728186
Indonesia,2022-06-22,98928466,98928466,0,https://data.covid19.go.id/public/index.html,41139690,57788776,0,0,0.7507656650939492,0,0,41200280,57728186
Indonesia,2022-06-23,98928466,98928466,0,https://data.covid19.go.id/public/index.html,41139690,57788776,0,0,0.7507656650939492,0,0,41200280,57728186
Indonesia,2022-06-24,100384534,100384534,1456068,https://data.covid19.go.id/public/index.html,41564747,58819787,425057,1031011,0.708078880931385,425057,1031011,41625337,58759197
Indonesia,2022-06-25,100449034,100449034,64500,https://data.covid19.go.id/public/index.html,41587168,58861866,22421,42079,0.6523875968992248,22421,42079,41647758,58801276
Indonesia,2022-06-26,100499919,100499919,50885,https://data.covid19.go.id/public/index.html,41607068,58892851,19900,30985,0.608922079198192,19900,30985,41667658,58832261
Indonesia,2022-06-27,100572843,100572843,72924,https://data.covid19.go.id/public/index.html,41624644,58948199,17576,55348,0.7589819538149306,17576,55348,41685234,58887609
Indonesia,2022-06-28,100661561,100661561,88718,https://data.covid19.go.id/public/index.html,41652569,59008992,27925,60793,0.6852386212493519,27925,60793,41713159,58948402
Indonesia,2022-06-29,100741581,100741581,80020,https://data.covid19.go.id/public/index.html,41678254,59063327,25685,54335,0.679017745563609,25685,54335,41738844,59002737
Indonesia,2022-06-30,100820965,100820965,79384,https://data.covid19.go.id/public/index.html,41704148,59116817,25894,53490,0.673813362894286,25894,53490,41764738,59056227
Indonesia,2022-07-01,100899655,100899655,78690,https://data.covid19.go.id/public/index.html,41727920,59171735,23772,54918,0.6979031643156691,23772,54918,41788510,59111145
Indonesia,2022-07-02,100962881,100962881,63226,https://data.covid19.go.id/public/index.html,41747647,59215234,19727,43499,0.6879922816562807,19727,43499,41808237,59154644
Indonesia,2022-07-03,101009594,101009594,46713,https://data.covid19.go.id/public/index.html,41764292,59245302,16645,30068,0.643675208186158,16645,30068,41824882,59184712
Indonesia,2022-07-04,101079822,101079822,70228,https://data.covid19.go.id/public/index.html,41778110,59301712,13818,56410,0.8032408725864327,13818,56410,41838700,59241122
Indonesia,2022-07-05,101170840,101170840,91018,https://data.covid19.go.id/public/index.html,41803614,59367226,25504,65514,0.719791689555912,25504,65514,41864204,59306636
Indonesia,2022-07-06,101250215,101250215,79375,https://data.covid19.go.id/public/index.html,41827945,59422270,24331,55044,0.693467716535433,24331,55044,41888535,59361680
Indonesia,2022-07-07,101326722,101326722,76507,https://data.covid19.go.id/public/index.html,41850809,59475913,22864,53643,0.7011515286182963,22864,53643,41911399,59415323
Indonesia,2022-07-08,101398629,101398629,71907,https://data.covid19.go.id/public/index.html,41872906,59525723,22097,49810,0.6927002934345752,22097,49810,41933496,59465133
Indonesia,2022-07-09,101453673,101453673,55044,https://data.covid19.go.id/public/index.html,41893575,59560098,20669,34375,0.6245003996802558,20669,34375,41954165,59499508
Indonesia,2022-07-10,101495375,101495375,41702,https://data.covid19.go.id/public/index.html,41909373,59586002,15798,25904,0.6211692484772913,15798,25904,41969963,59525412
Indonesia,2022-07-11,101566470,101566470,71095,https://data.covid19.go.id/public/index.html,41922418,59644052,13045,58050,0.816513116252901,13045,58050,41983008,59583462
Indonesia,2022-07-12,101664405,101664405,97935,https://data.covid19.go.id/public/index.html,83871179,119359696,41948761,59715644,0.5873800569629065,40410,57525,42023418,59640987
Indonesia,2022-07-13,101753259,101753259,88854,https://data.covid19.go.id/public/index.html,83896516,119423213,25337,63517,0.7148468273797466,25337,63517,42048755,59704504
Indonesia,2022-07-14,101839771,101839771,86512,https://data.covid19.go.id/public/index.html,41999446,59840325,-41897070,-59582888,0.5871394625527929,35717,50795,42084472,59755299
Indonesia,2022-07-15,101923188,101923188,83417,https://data.covid19.go.id/public/index.html,42024061,59899127,24615,58802,0.7049162640708728,24615,58802,42109087,59814101
Indonesia,2022-07-16,102007984,102007984,84796,https://data.covid19.go.id/public/index.html,42057768,59950216,33707,51089,0.6024930421246285,33707,51089,42142794,59865190
Indonesia,2022-07-17,102088338,102088338,80354,https://data.covid19.go.id/public/index.html,42086043,60002295,28275,52079,0.6481195708987729,28275,52079,42171069,59917269
Indonesia,2022-07-18,102193503,102193503,105165,https://data.covid19.go.id/public/index.html,42106160,60087343,20117,85048,0.8087101221889412,20117,85048,42191186,60002317
Indonesia,2022-07-19,102320536,102320536,127033,https://data.covid19.go.id/public/index.html,42140401,60180135,34241,92792,0.7304558657986507,34241,92792,42225427,60095109
Indonesia,2022-07-20,102439442,102439442,118906,https://data.covid19.go.id/public/index.html,42175327,60264115,34926,83980,0.706272181386978,34926,83980,42260353,60179089
Indonesia,2022-07-21,102562428,102562428,122986,https://data.covid19.go.id/public/index.html,42212801,60349627,37474,85512,0.6952986518790757,37474,85512,42297827,60264601
Indonesia,2022-07-22,102675218,102675218,112790,https://data.covid19.go.id/public/index.html,42246925,60428293,34124,78666,0.69745544817803,34124,78666,42331951,60343267
Indonesia,2022-07-23,102779858,102779858,104640,https://data.covid19.go.id/public/index.html,42279466,60500392,32541,72099,0.689019495412844,32541,72099,42364492,60415366
Indonesia,2022-07-24,102864032,102864032,84174,https://data.covid19.go.id/public/index.html,42307677,60556355,28211,55963,0.6648490032551619,28211,55963,42392703,60471329
Indonesia,2022-07-25,102974551,102974551,110519,https://data.covid19.go.id/public/index.html,42331471,60643080,23794,86725,0.7847067020150381,23794,86725,42416497,60558054
Indonesia,2022-07-26,103116512,103116512,141961,https://data.covid19.go.id/public/index.html,42368846,60747666,37375,104586,0.7367234663041258,37375,104586,42453872,60662640
Indonesia,2022-07-27,103240858,103240858,124346,https://data.covid19.go.id/public/index.html,42407268,60833590,38422,85924,0.6910073504575941,38422,85924,42492294,60748564
Indonesia,2022-07-28,103363087,103363087,122229,https://data.covid19.go.id/public/index.html,42442818,60920269,35550,86679,0.7091524924526913,35550,86679,42527844,60835243
Indonesia,2022-07-29,103472603,103472603,109516,https://data.covid19.go.id/public/index.html,42477669,60994934,34851,74665,0.6817725263888381,34851,74665,42562695,60909908
Indonesia,2022-07-30,103563868,103563868,91265,https://data.covid19.go.id/public/index.html,42511208,61052660,33539,57726,0.632509724428861,33539,57726,42596234,60967634
Indonesia,2022-07-31,103638507,103638507,74639,https://data.covid19.go.id/public/index.html,42536101,61102406,24893,49746,0.6664880290464771,24893,49746,42621127,61017380
Indonesia,2022-08-01,103751537,103751537,113030,https://data.covid19.go.id/public/index.html,42560075,61191462,23974,89056,0.7878970184906662,23974,89056,42645101,61106436
Indonesia,2022-08-02,103884748,103884748,133211,https://data.covid19.go.id/public/index.html,42598675,61286073,38600,94611,0.7102341398232879,38600,94611,42683701,61201047
Indonesia,2022-08-03,103884748,103884748,0,https://data.covid19.go.id/public/index.html,42598675,61286073,0,0,0.7102341398232879,0,0,42683701,61201047
Indonesia,2022-08-04,103884748,103884748,0,https://data.covid19.go.id/public/index.html,42598675,61286073,0,0,0.7102341398232879,0,0,42683701,61201047
Indonesia,2022-08-05,103884748,103884748,0,https://data.covid19.go.id/public/index.html,42598675,61286073,0,0,0.7102341398232879,0,0,42683701,61201047
Indonesia,2022-08-06,103884748,103884748,0,https://data.covid19.go.id/public/index.html,42598675,61286073,0,0,0.7102341398232879,0,0,42683701,61201047
Indonesia,2022-08-07,103884748,103884748,0,https://data.covid19.go.id/public/index.html,42598675,61286073,0,0,0.7102341398232879,0,0,42683701,61201047
Indonesia,2022-08-08,103884748,103884748,0,https://data.covid19.go.id/public/index.html,42598675,61286073,0,0,0.7102341398232879,0,0,42683701,61201047
Indonesia,2022-08-09,103884748,103884748,0,https://data.covid19.go.id/public/index.html,42598675,61286073,0,0,0.7102341398232879,0,0,42683701,61201047
Indonesia,2022-08-10,103884748,103884748,0,https://data.covid19.go.id/public/index.html,42598675,61286073,0,0,0.7102341398232879,0,0,42683701,61201047
Indonesia,2022-08-11,104910593,104910593,1025845,https://data.covid19.go.id/public/index.html,42908109,62002484,309434,716411,0.6983618382894102,309434,716411,42993135,61917458
Indonesia,2022-08-12,105029539,105029539,118946,https://data.covid19.go.id/public/index.html,42941848,62087691,33739,85207,0.7163502765961024,33739,85207,43026874,62002665
Indonesia,2022-08-13,105126271,105126271,96732,https://data.covid19.go.id/public/index.html,42973204,62153067,31356,65376,0.6758466691477484,31356,65376,43058230,62068041
Indonesia,2022-08-14,105201993,105201993,75722,https://data.covid19.go.id/public/index.html,43000656,62201337,27452,48270,0.6374633527904704,27452,48270,43085682,62116311
Indonesia,2022-08-15,105302298,105302298,100305,https://data.covid19.go.id/public/index.html,43023745,62278553,23089,77216,0.7698120731768108,23089,77216,43108771,62193527
Indonesia,2022-08-16,105414707,105414707,112409,https://data.covid19.go.id/public/index.html,43060487,62354220,36742,75667,0.6731400510635269,36742,75667,43145513,62269194
Indonesia,2022-08-17,105499887,105499887,85180,https://data.covid19.go.id/public/index.html,43096252,62403635,35765,49415,0.5801244423573609,35765,49415,43181278,62318609
Indonesia,2022-08-18,105581584,105581584,81697,https://data.covid19.go.id/public/index.html,43121215,62460369,24963,56734,0.6944441044346794,24963,56734,43206241,62375343
Indonesia,2022-08-19,105681997,105681997,100413,https://data.covid19.go.id/public/index.html,43154430,62527567,33215,67198,0.6692161373527332,33215,67198,43239456,62442541
Indonesia,2022-08-20,105765132,105765132,83135,https://data.covid19.go.id/public/index.html,43185813,62579319,31383,51752,0.6225055632405124,31383,51752,43270839,62494293
Indonesia,2022-08-21,105829381,105829381,64249,https://data.covid19.go.id/public/index.html,43212836,62616545,27023,37226,0.579402014039129,27023,37226,43297862,62531519
Indonesia,2022-08-22,105920916,105920916,91535,https://data.covid19.go.id/public/index.html,43234946,62685970,22110,69425,0.7584530507456164,22110,69425,43319972,62600944
Indonesia,2022-08-23,106033887,106033887,112971,https://data.covid19.go.id/public/index.html,43271042,62762845,36096,76875,0.6804843720954935,36096,76875,43356068,62677819
Indonesia,2022-08-24,106136104,106136104,102217,https://data.covid19.go.id/public/index.html,43304763,62831341,33721,68496,0.6701037987810247,33721,68496,43389789,62746315
Indonesia,2022-08-25,106235330,106235330,99226,https://data.covid19.go.id/public/index.html,43338914,62896416,34151,65075,0.655826093967307,34151,65075,43423940,62811390
Indonesia,2022-08-26,106324594,106324594,89264,https://data.covid19.go.id/public/index.html,43369435,62955159,30521,58743,0.658081645456175,30521,58743,43454461,62870133
Indonesia,2022-08-27,106406169,106406169,81575,https://data.covid19.go.id/public/index.html,43398667,63007502,29232,52343,0.6416549187863929,29232,52343,43483693,62922476
Indonesia,2022-08-28,106464732,106464732,58563,https://data.covid19.go.id/public/index.html,43423225,63041507,24558,34005,0.5806567286511961,24558,34005,43508251,62956481
Indonesia,2022-08-29,106546452,106546452,81720,https://data.covid19.go.id/public/index.html,43441586,63104866,18361,63359,0.7753181595692609,18361,63359,43526612,63019840
Indonesia,2022-08-30,106645001,106645001,98549,https://data.covid19.go.id/public/index.html,43473476,63171525,31890,66659,0.676404631198693,31890,66659,43558502,63086499
Indonesia,2022-08-31,106732670,106732670,87669,https://data.covid19.go.id/public/index.html,43501934,63230736,28458,59211,0.675392670157068,28458,59211,43586960,63145710
Indonesia,2022-09-01,106819620,106819620,86950,https://data.covid19.go.id/public/index.html,43529365,63290255,27431,59519,0.6845198389879241,27431,59519,43614391,63205229
Indonesia,2022-09-02,106896133,106896133,76513,https://data.covid19.go.id/public/index.html,43554059,63342074,24694,51819,0.6772574595166835,24694,51819,43639085,63257048
Indonesia,2022-09-03,106959748,106959748,63615,https://data.covid19.go.id/public/index.html,43576307,63383441,22248,41367,0.6502711624616836,22248,41367,43661333,63298415
Indonesia,2022-09-04,107008442,107008442,48694,https://data.covid19.go.id/public/index.html,43595016,63413426,18709,29985,0.6157842855382594,18709,29985,43680042,63328400
Indonesia,2022-09-05,107081078,107081078,72636,https://data.covid19.go.id/public/index.html,43610961,63470117,15945,56691,0.7804807533454485,15945,56691,43695987,63385091
Indonesia,2022-09-06,107171995,107171995,90917,https://data.covid19.go.id/public/index.html,43637367,63534628,26406,64511,0.7095592683436541,26406,64511,43722393,63449602
Indonesia,2022-09-07,107252227,107252227,80232,https://data.covid19.go.id/public/index.html,43661067,63591160,23700,56532,0.7046066407418486,23700,56532,43746093,63506134
Indonesia,2022-09-08,107329264,107329264,77037,https://data.covid19.go.id/public/index.html,43683425,63645839,22358,54679,0.7097758220076067,22358,54679,43768451,63560813
Indonesia,2022-09-09,107398366,107398366,69102,https://data.covid19.go.id/public/index.html,43703223,63695143,19798,49304,0.7134959914329542,19798,49304,43788249,63610117
Indonesia,2022-09-10,107455417,107455417,57051,https://data.covid19.go.id/public/index.html,43721475,63733942,18252,38799,0.6800757217226692,18252,38799,43806501,63648916
Indonesia,2022-09-11,107498588,107498588,43171,https://data.covid19.go.id/public/index.html,43737352,63761236,15877,27294,0.6322299691922818,15877,27294,43822378,63676210
Indonesia,2022-09-12,107562459,107562459,63871,https://data.covid19.go.id/public/index.html,43749747,63812712,12395,51476,0.8059369666985017,12395,51476,43834773,63727686
Indonesia,2022-09-13,107642398,107642398,79939,https://data.covid19.go.id/public/index.html,43772411,63869987,22664,57275,0.7164838189119204,22664,57275,43857437,63784961
Indonesia,2022-09-14,107716925,107716925,74527,https://data.covid19.go.id/public/index.html,43792807,63924118,20396,54131,0.726327371288258,20396,54131,43877833,63839092
Indonesia,2022-09-15,107785960,107785960,69035,https://data.covid19.go.id/public/index.html,43813068,63972892,20261,48774,0.7065111899760991,20261,48774,43898094,63887866
Indonesia,2022-09-16,107849082,107849082,63122,https://data.covid19.go.id/public/index.html,43831077,64018005,18009,45113,0.7146953518583061,18009,45113,43916103,63932979
Indonesia,2022-09-17,107902204,107902204,53122,https://data.covid19.go.id/public/index.html,43847632,64054572,16555,36567,0.6883588720304206,16555,36567,43932658,63969546
Indonesia,2022-09-18,107942059,107942059,39855,https://data.covid19.go.id/public/index.html,43861867,64080192,14235,25620,0.6428302596913813,14235,25620,43946893,63995166
Indonesia,2022-09-19,108003402,108003402,61343,https://data.covid19.go.id/public/index.html,87735938,128209523,43874071,64129331,0.5937713980528132,24919,36424,43971812,64031590
Indonesia,2022-09-20,108081378,108081378,77976,https://data.covid19.go.id/public/index.html,43895830,64185548,-43840108,-64023975,0.5935615750796306,31692,46284,44003504,64077874
Indonesia,2022-09-21,108151698,108151698,70320,https://data.covid19.go.id/public/index.html,43916921,64234777,21091,49229,0.700071103526735,21091,49229,44024595,64127103
Indonesia,2022-09-22,108220629,108220629,68931,https://data.covid19.go.id/public/index.html,43935748,64284881,18827,50104,0.7268717993355674,18827,50104,44043422,64177207
Indonesia,2022-09-23,108280205,108280205,59576,https://data.covid19.go.id/public/index.html,43951261,64328944,15513,44063,0.7396099100308849,15513,44063,44058935,64221270
Indonesia,2022-09-24,108330581,108330581,50376,https://data.covid19.go.id/public/index.html,43966551,64364030,15290,35086,0.6964824519612514,15290,35086,44074225,64256356
Indonesia,2022-09-25,108372888,108372888,42307,https://data.covid19.go.id/public/index.html,43979365,64393523,12814,29493,0.6971186801238566,12814,29493,44087039,64285849
Indonesia,2022-09-26,108437077,108437077,64189,https://data.covid19.go.id/public/index.html,43991006,64446071,11641,52548,0.8186449391640312,11641,52548,44098680,64338397
Indonesia,2022-09-27,108516957,108516957,79880,https://data.covid19.go.id/public/index.html,44010553,64506404,19547,60333,0.7552954431647472,19547,60333,44118227,64398730
Indonesia,2022-09-28,108590948,108590948,73991,https://data.covid19.go.id/public/index.html,44029353,64561595,18800,55191,0.7459150437215337,18800,55191,44137027,64453921
Indonesia,2022-09-29,108656989,108656989,66041,https://data.covid19.go.id/public/index.html,44047808,64609181,18455,47586,0.7205523841250132,18455,47586,44155482,64501507
Indonesia,2022-09-30,108723455,108723455,66466,https://data.covid19.go.id/public/index.html,44064645,64658810,16837,49629,0.7466825143682484,16837,49629,44172319,64551136
Indonesia,2022-10-01,108776738,108776738,53283,https://data.covid19.go.id/public/index.html,44080050,64696688,15405,37878,0.7108833962051686,15405,37878,44187724,64589014
Indonesia,2022-10-02,108776738,108776738,0,https://data.covid19.go.id/public/index.html,44080050,64696688,0,0,0.7108833962051686,0,0,44187724,64589014
Indonesia,2022-10-03,108776738,108776738,0,https://data.covid19.go.id/public/index.html,44080050,64696688,0,0,0.7108833962051686,0,0,44187724,64589014
Indonesia,2022-10-04,108776738,108776738,0,https://data.covid19.go.id/public/index.html,44080050,64696688,0,0,0.7108833962051686,0,0,44187724,64589014
Indonesia,2022-10-05,108776738,108776738,0,https://data.covid19.go.id/public/index.html,44080050,64696688,0,0,0.7108833962051686,0,0,44187724,64589014
Indonesia,2022-10-06,108776738,108776738,0,https://data.covid19.go.id/public/index.html,44080050,64696688,0,0,0.7108833962051686,0,0,44187724,64589014
Indonesia,2022-10-07,108776738,108776738,0,https://data.covid19.go.id/public/index.html,44080050,64696688,0,0,0.7108833962051686,0,0,44187724,64589014
Indonesia,2022-10-08,108776738,108776738,0,https://data.covid19.go.id/public/index.html,44080050,64696688,0,0,0.7108833962051686,0,0,44187724,64589014
Indonesia,2022-10-09,108776738,108776738,0,https://data.covid19.go.id/public/index.html,44080050,64696688,0,0,0.7108833962051686,0,0,44187724,64589014
Indonesia,2022-10-10,109268056,109268056,491318,https://data.covid19.go.id/public/index.html,44201632,65066424,121582,369736,0.7525390887368263,121582,369736,44309306,64958750
Indonesia,2022-10-11,109341629,109341629,73573,https://data.covid19.go.id/public/index.html,44219894,65121735,18262,55311,0.7517839424788985,18262,55311,44327568,65014061
Indonesia,2022-10-12,109402949,109402949,61320,https://data.covid19.go.id/public/index.html,44237802,65165147,17908,43412,0.7079582517938683,17908,43412,44345476,65057473
Indonesia,2022-10-13,109466219,109466219,63270,https://data.covid19.go.id/public/index.html,44254157,65212062,16355,46915,0.7415046625572941,16355,46915,44361831,65104388
Indonesia,2022-10-14,109526897,109526897,60678,https://data.covid19.go.id/public/index.html,44269465,65257432,15308,45370,0.747717459375721,15308,45370,44377139,65149758
Indonesia,2022-10-15,109575332,109575332,48435,https://data.covid19.go.id/public/index.html,44283315,65292017,13850,34585,0.7140497574068339,13850,34585,44390989,65184343
Indonesia,2022-10-16,109612349,109612349,37017,https://data.covid19.go.id/public/index.html,44295198,65317151,11883,25134,0.6789853310641056,11883,25134,44402872,65209477
Indonesia,2022-10-17,109672450,109672450,60101,https://data.covid19.go.id/public/index.html,44305010,65367440,9812,50289,0.8367414851666362,9812,50289,44412684,65259766
Indonesia,2022-10-18,109739323,109739323,66873,https://data.covid19.go.id/public/index.html,44323577,65415746,18567,48306,0.7223543134000269,18567,48306,44431251,65308072
Indonesia,2022-10-19,109807776,109807776,68453,https://data.covid19.go.id/public/index.html,44339781,65467995,16204,52249,0.7632828363986969,16204,52249,44447455,65360321
Indonesia,2022-10-20,109870244,109870244,62468,https://data.covid19.go.id/public/index.html,44356025,65514219,16244,46224,0.7399628609848242,16244,46224,44463699,65406545
Indonesia,2022-10-21,109927936,109927936,57692,https://data.covid19.go.id/public/index.html,44371636,65556300,15611,42081,0.7294078901754143,15611,42081,44479310,65448626
Indonesia,2022-10-22,109976125,109976125,48189,https://data.covid19.go.id/public/index.html,44385566,65590559,13930,34259,0.7109298802631306,13930,34259,44493240,65482885
Indonesia,2022-10-23,110010718,110010718,34593,https://data.covid19.go.id/public/index.html,44398176,65612542,12610,21983,0.6354753851935363,12610,21983,44505850,65504868
Indonesia,2022-10-24,110065881,110065881,55163,https://data.covid19.go.id/public/index.html,44409423,65656458,11247,43916,0.796113336838098,11247,43916,44517097,65548784
Indonesia,2022-10-25,110135379,110135379,69498,https://data.covid19.go.id/public/index.html,44427721,65707658,18298,51200,0.736711847822959,18298,51200,44535395,65599984
Indonesia,2022-10-26,110194348,110194348,58969,https://data.covid19.go.id/public/index.html,44445341,65749007,17620,41349,0.7011989350336617,17620,41349,44553015,65641333
Indonesia,2022-10-27,110256393,110256393,62045,https://data.covid19.go.id/public/index.html,44462703,65793690,17362,44683,0.720170843742445,17362,44683,44570377,65686016
Indonesia,2022-10-28,110316326,110316326,59933,https://data.covid19.go.id/public/index.html,44478502,65837824,15799,44134,0.7363889676805766,15799,44134,44586176,65730150
Indonesia,2022-10-29,110366308,110366308,49982,https://data.covid19.go.id/public/index.html,44494746,65871562,16244,33738,0.6750030010803889,16244,33738,44602420,65763888
Indonesia,2022-10-30,110403412,110403412,37104,https://data.covid19.go.id/public/index.html,44508342,65895070,13596,23508,0.6335705045278137,13596,23508,44616016,65787396
Indonesia,2022-10-31,110460446,110460446,57034,https://data.covid19.go.id/public/index.html,44519534,65940912,11192,45842,0.8037661745625416,11192,45842,44627208,65833238
Indonesia,2022-11-01,110536735,110536735,76289,https://data.covid19.go.id/public/index.html,44541428,65995307,21894,54395,0.7130123608908231,21894,54395,44649102,65887633
Indonesia,2022-11-02,110601939,110601939,65204,https://data.covid19.go.id/public/index.html,44562436,66039503,21008,44196,0.6778111772283909,21008,44196,44670110,65931829
Indonesia,2022-11-03,110668196,110668196,66257,https://data.covid19.go.id/public/index.html,44582736,66085460,20300,45957,0.6936172781743816,20300,45957,44690410,65977786
Indonesia,2022-11-04,110730930,110730930,62734,https://data.covid19.go.id/public/index.html,44603298,66127632,20562,42172,0.672235151592438,20562,42172,44710972,66019958
Indonesia,2022-11-05,110783338,110783338,52408,https://data.covid19.go.id/public/index.html,44621603,66161735,18305,34103,0.6507212639291711,18305,34103,44729277,66054061
Indonesia,2022-11-06,110783338,110783338,0,https://data.covid19.go.id/public/index.html,44621603,66161735,0,0,0.6507212639291711,0,0,44729277,66054061
Indonesia,2022-11-07,110783338,110783338,0,https://data.covid19.go.id/public/index.html,44621603,66161735,0,0,0.6507212639291711,0,0,44729277,66054061
Indonesia,2022-11-08,110783338,110783338,0,https://data.covid19.go.id/public/index.html,44678263,66282770,56660,121035,0.6811390303610119,0,0,44729277,66054061
Indonesia,2022-11-09,111027963,111027963,244625,https://data.covid19.go.id/public/index.html,44700876,66327087,22613,44317,0.6621395487823099,82649,161976,44811926,66216037
Indonesia,2022-11-10,111027963,111027963,0,https://data.covid19.go.id/public/index.html,44700876,66327087,0,0,0.6621395487823099,0,0,44811926,66216037
Indonesia,2022-11-11,111027963,111027963,0,https://data.covid19.go.id/public/index.html,44700876,66327087,0,0,0.6621395487823099,0,0,44811926,66216037
Indonesia,2022-11-12,111027963,111027963,0,https://data.covid19.go.id/public/index.html,44700876,66327087,0,0,0.6621395487823099,0,0,44811926,66216037
Indonesia,2022-11-13,111027963,111027963,0,https://data.covid19.go.id/public/index.html,44700876,66327087,0,0,0.6621395487823099,0,0,44811926,66216037
Indonesia,2022-11-14,111027963,111027963,0,https://data.covid19.go.id/public/index.html,44700876,66327087,0,0,0.6621395487823099,0,0,44811926,66216037
Indonesia,2022-11-15,111027963,111027963,0,https://data.covid19.go.id/public/index.html,44700876,66327087,0,0,0.6621395487823099,0,0,44811926,66216037
Indonesia,2022-11-16,111502173,111502173,474210,https://data.covid19.go.id/public/index.html,44865566,66636607,164690,309520,0.652706606777588,164690,309520,44976616,66525557
Indonesia,2022-11-17,111582012,111582012,79839,https://data.covid19.go.id/public/index.html,44892522,66689490,26956,52883,0.6623705206728541,26956,52883,45003572,66578440
Indonesia,2022-11-18,111660489,111660489,78477,https://data.covid19.go.id/public/index.html,44915354,66745135,22832,55645,0.709061253615709,22832,55645,45026404,66634085
Indonesia,2022-11-19,111724301,111724301,63812,https://data.covid19.go.id/public/index.html,44938270,66786031,22916,40896,0.6408825926158089,22916,40896,45049320,66674981
Indonesia,2022-11-20,111772509,111772509,48208,https://data.covid19.go.id/public/index.html,44957847,66814662,19577,28631,0.5939055758380352,19577,28631,45068897,66703612
Indonesia,2022-11-21,111842418,111842418,69909,https://data.covid19.go.id/public/index.html,44972845,66869573,14998,54911,0.7854639602912358,14998,54911,45083895,66758523
Indonesia,2022-11-22,111931755,111931755,89337,https://data.covid19.go.id/public/index.html,45002021,66929734,29176,60161,0.673416389625799,29176,60161,45113071,66818684
Indonesia,2022-11-23,112010136,112010136,78381,https://data.covid19.go.id/public/index.html,45029623,66980513,27602,50779,0.6478483305903217,27602,50779,45140673,66869463
Indonesia,2022-11-24,112088248,112088248,78112,https://data.covid19.go.id/public/index.html,45055799,67032449,26176,51936,0.6648914379352724,26176,51936,45166849,66921399
Indonesia,2022-11-25,112161548,112161548,73300,https://data.covid19.go.id/public/index.html,45078933,67082615,23134,50166,0.6843929058663029,23134,50166,45189983,66971565
Indonesia,2022-11-26,112220477,112220477,58929,https://data.covid19.go.id/public/index.html,45100286,67120191,21353,37576,0.6376486958882723,21353,37576,45211336,67009141
Indonesia,2022-11-27,112262636,112262636,42159,https://data.covid19.go.id/public/index.html,45117510,67145126,17224,24935,0.5914514101378117,17224,24935,45228560,67034076
Indonesia,2022-11-28,112326546,112326546,63910,https://data.covid19.go.id/public/index.html,45133168,67193378,15658,48252,0.75499921764982,15658,48252,45244218,67082328
Indonesia,2022-11-29,112408992,112408992,82446,https://data.covid19.go.id/public/index.html,45159297,67249695,26129,56317,0.6830774082429711,26129,56317,45270347,67138645
Indonesia,2022-11-30,112482021,112482021,73029,https://data.covid19.go.id/public/index.html,45182693,67299328,23396,49633,0.6796341179531419,23396,49633,45293743,67188278
Indonesia,2022-12-01,112482021,112482021,0,https://data.covid19.go.id/public/index.html,45182693,67299328,0,0,0.6796341179531419,0,0,45293743,67188278
Indonesia,2022-12-02,112612890,112612890,130869,https://data.covid19.go.id/public/index.html,45223274,67389616,40581,90288,0.6899112853311327,40581,90288,45334324,67278566
Indonesia,2022-12-03,112663528,112663528,50638,https://data.covid19.go.id/public/index.html,45241845,67421683,18571,32067,0.6332596074094553,18571,32067,45352895,67310633
Indonesia,2022-12-04,112703337,112703337,39809,https://data.covid19.go.id/public/index.html,45255922,67447415,14077,25732,0.6463864955160893,14077,25732,45366972,67336365
Indonesia,2022-12-05,112761095,112761095,57758,https://data.covid19.go.id/public/index.html,45267892,67493203,11970,45788,0.7927559818553274,11970,45788,45378942,67382153
Indonesia,2022-12-06,112835077,112835077,73982,https://data.covid19.go.id/public/index.html,45289922,67545155,22030,51952,0.7022248655078263,22030,51952,45400972,67434105
Indonesia,2022-12-07,112897538,112897538,62461,https://data.covid19.go.id/public/index.html,45307731,67589807,17809,44652,0.7148780839243688,17809,44652,45418781,67478757
Indonesia,2022-12-08,112955652,112955652,58114,https://data.covid19.go.id/public/index.html,45323893,67631759,16162,41952,0.7218914547269161,16162,41952,45434943,67520709
Indonesia,2022-12-09,113009498,113009498,53846,https://data.covid19.go.id/public/index.html,45339702,67669796,15809,38037,0.7064034468669911,15809,38037,45450752,67558746
Indonesia,2022-12-10,113009498,113009498,0,https://data.covid19.go.id/public/index.html,45339702,67669796,0,0,0.7064034468669911,0,0,45450752,67558746
Indonesia,2022-12-11,113086080,113086080,76582,https://data.covid19.go.id/public/index.html,45366220,67719860,26518,50064,0.6537306416651433,26518,50064,45477270,67608810
Indonesia,2022-12-12,113134923,113134923,48843,https://data.covid19.go.id/public/index.html,45375756,67759167,9536,39307,0.8047621972442315,9536,39307,45486806,67648117
Indonesia,2022-12-13,113197060,113197060,62137,https://data.covid19.go.id/public/index.html,45392857,67804203,17101,45036,0.7247855545005392,17101,45036,45503907,67693153
Indonesia,2022-12-14,113251877,113251877,54817,https://data.covid19.go.id/public/index.html,45408380,67843497,15523,39294,0.7168214240107996,15523,39294,45519430,67732447
Indonesia,2022-12-15,113303536,113303536,51659,https://data.covid19.go.id/public/index.html,45421592,67881944,13212,38447,0.7442459203623764,13212,38447,45532642,67770894
Indonesia,2022-12-16,113350160,113350160,46624,https://data.covid19.go.id/public/index.html,45433370,67916790,11778,34846,0.7473833218943033,11778,34846,45544420,67805740
Indonesia,2022-12-17,113388504,113388504,38344,https://data.covid19.go.id/public/index.html,45444246,67944258,10876,27468,0.7163571875651993,10876,27468,45555296,67833208
Indonesia,2022-12-18,113415386,113415386,26882,https://data.covid19.go.id/public/index.html,45452987,67962399,8741,18141,0.6748381816829105,8741,18141,45564037,67851349
Indonesia,2022-12-19,113415386,113415386,0,https://data.covid19.go.id/public/index.html,45452987,67962399,0,0,0.6748381816829105,0,0,45564037,67851349
Indonesia,2022-12-20,113415386,113415386,0,https://data.covid19.go.id/public/index.html,45452987,67962399,0,0,0.6748381816829105,0,0,45564037,67851349
Indonesia,2022-12-21,113415386,113415386,0,https://data.covid19.go.id/public/index.html,45452987,67962399,0,0,0.6748381816829105,0,0,45564037,67851349
Indonesia,2022-12-22,113415386,113415386,0,https://data.covid19.go.id/public/index.html,45452987,67962399,0,0,0.6748381816829105,0,0,45564037,67851349
Indonesia,2022-12-23,113415386,113415386,0,https://data.covid19.go.id/public/index.html,27163638,55438665,-18289349,-12523734,0.40644209474267795,0,0,45564037,67851349
Indonesia,2022-12-24,113415386,113415386,0,https://data.covid19.go.id/public/index.html,27163638,55438665,0,0,0.40644209474267795,0,0,45564037,67851349
Indonesia,2022-12-25,113702073,113702073,286687,https://data.covid19.go.id/public/index.html,45525369,68176704,18361731,12738039,0.4095862766830751,169264,117423,45733301,67968772
Indonesia,2022-12-26,113702073,113702073,0,https://data.covid19.go.id/public/index.html,45525369,68176704,0,0,0.4095862766830751,0,0,45733301,67968772
Indonesia,2022-12-27,113702073,113702073,0,https://data.covid19.go.id/public/index.html,45525369,68176704,0,0,0.4095862766830751,0,0,45733301,67968772
Indonesia,2022-12-28,113702073,113702073,0,https://data.covid19.go.id/public/index.html,45525369,68176704,0,0,0.4095862766830751,0,0,45733301,67968772
Indonesia,2022-12-29,113702073,113702073,0,https://data.covid19.go.id/public/index.html,45525369,68176704,0,0,0.4095862766830751,0,0,45733301,67968772
Indonesia,2022-12-30,113702073,113702073,0,https://data.covid19.go.id/public/index.html,45525369,68176704,0,0,0.4095862766830751,0,0,45733301,67968772
Indonesia,2022-12-31,113702073,113702073,0,https://data.covid19.go.id/public/index.html,45525369,68176704,0,0,0.4095862766830751,0,0,45733301,67968772
Indonesia,2023-01-01,113702073,113702073,0,https://data.covid19.go.id/public/index.html,45525369,68176704,0,0,0.4095862766830751,0,0,45733301,67968772
Indonesia,2023-01-02,113702073,113702073,0,https://data.covid19.go.id/public/index.html,45525369,68176704,0,0,0.4095862766830751,0,0,45733301,67968772
Indonesia,2023-01-03,113702073,113702073,0,https://data.covid19.go.id/public/index.html,45525369,68176704,0,0,0.4095862766830751,0,0,45733301,67968772
Indonesia,2023-01-04,113702073,113702073,0,https://data.covid19.go.id/public/index.html,45525369,68176704,0,0,0.4095862766830751,0,0,45733301,67968772
Indonesia,2023-01-05,113702073,113702073,0,https://data.covid19.go.id/public/index.html,45525369,68176704,0,0,0.4095862766830751,0,0,45733301,67968772
Indonesia,2023-01-06,113702073,113702073,0,https://data.covid19.go.id/public/index.html,45525369,68176704,0,0,0.4095862766830751,0,0,45733301,67968772
Indonesia,2023-01-07,113702073,113702073,0,https://data.covid19.go.id/public/index.html,45525369,68176704,0,0,0.4095862766830751,0,0,45733301,67968772
Indonesia,2023-01-08,113702073,113702073,0,https://data.covid19.go.id/public/index.html,45525369,68176704,0,0,0.4095862766830751,0,0,45733301,67968772
Indonesia,2023-01-09,113702073,113702073,0,https://data.covid19.go.id/public/index.html,45525369,68176704,0,0,0.4095862766830751,0,0,45733301,67968772
Indonesia,2023-01-10,113702073,113702073,0,https://data.covid19.go.id/public/index.html,45525369,68176704,0,0,0.4095862766830751,0,0,45733301,67968772
Indonesia,2023-01-11,113702073,113702073,0,https://data.covid19.go.id/public/index.html,45525369,68176704,0,0,0.4095862766830751,0,0,45733301,67968772
Indonesia,2023-01-12,113702073,113702073,0,https://data.covid19.go.id/public/index.html,45525369,68176704,0,0,0.4095862766830751,0,0,45733301,67968772
Indonesia,2023-01-13,113702073,113702073,0,https://data.covid19.go.id/public/index.html,45525369,68176704,0,0,0.4095862766830751,0,0,45733301,67968772
Indonesia,2023-01-14,113702073,113702073,0,https://data.covid19.go.id/public/index.html,45525369,68176704,0,0,0.4095862766830751,0,0,45733301,67968772
Indonesia,2023-01-15,113702073,113702073,0,https://data.covid19.go.id/public/index.html,45525369,68176704,0,0,0.4095862766830751,0,0,45733301,67968772
Indonesia,2023-01-16,113702073,113702073,0,https://data.covid19.go.id/public/index.html,45525369,68176704,0,0,0.4095862766830751,0,0,45733301,67968772
Indonesia,2023-01-17,113702073,113702073,0,https://data.covid19.go.id/public/index.html,45525369,68176704,0,0,0.4095862766830751,0,0,45733301,67968772
Indonesia,2023-01-18,113702073,113702073,0,https://data.covid19.go.id/public/index.html,45525369,68176704,0,0,0.4095862766830751,0,0,45733301,67968772
Indonesia,2023-01-19,113702073,113702073,0,https://data.covid19.go.id/public/index.html,45525369,68176704,0,0,0.4095862766830751,0,0,45733301,67968772
Indonesia,2023-01-20,113702073,113702073,0,https://data.covid19.go.id/public/index.html,45525369,68176704,0,0,0.4095862766830751,0,0,45733301,67968772
Indonesia,2023-01-21,113702073,113702073,0,https://data.covid19.go.id/public/index.html,45525369,68176704,0,0,0.4095862766830751,0,0,45733301,67968772
Indonesia,2023-01-22,113702073,113702073,0,https://data.covid19.go.id/public/index.html,45525369,68176704,0,0,0.4095862766830751,0,0,45733301,67968772
Indonesia,2023-01-23,113702073,113702073,0,https://data.covid19.go.id/public/index.html,45525369,68176704,0,0,0.4095862766830751,0,0,45733301,67968772
Indonesia,2023-01-24,113702073,113702073,0,https://data.covid19.go.id/public/index.html,45525369,68176704,0,0,0.4095862766830751,0,0,45733301,67968772
Indonesia,2023-01-25,113702073,113702073,0,https://data.covid19.go.id/public/index.html,45525369,68176704,0,0,0.4095862766830751,0,0,45733301,67968772
Indonesia,2023-01-26,113702073,113702073,0,https://data.covid19.go.id/public/index.html,45525369,68176704,0,0,0.4095862766830751,0,0,45733301,67968772
Indonesia,2023-01-27,113702073,113702073,0,https://data.covid19.go.id/public/index.html,45525369,68176704,0,0,0.4095862766830751,0,0,45733301,67968772
Indonesia,2023-01-28,113702073,113702073,0,https://data.covid19.go.id/public/index.html,45525369,68176704,0,0,0.4095862766830751,0,0,45733301,67968772
Indonesia,2023-01-29,113702073,113702073,0,https://data.covid19.go.id/public/index.html,45525369,68176704,0,0,0.4095862766830751,0,0,45733301,67968772
Indonesia,2023-01-30,113702073,113702073,0,https://data.covid19.go.id/public/index.html,45525369,68176704,0,0,0.4095862766830751,0,0,45733301,67968772
Indonesia,2023-01-31,113702073,113702073,0,https://data.covid19.go.id/public/index.html,45525369,68176704,0,0,0.4095862766830751,0,0,45733301,67968772
Indonesia,2023-02-01,113702073,113702073,0,https://data.covid19.go.id/public/index.html,45525369,68176704,0,0,0.4095862766830751,0,0,45733301,67968772
Indonesia,2023-02-02,113702073,113702073,0,https://data.covid19.go.id/public/index.html,45525369,68176704,0,0,0.4095862766830751,0,0,45733301,67968772
Indonesia,2023-02-03,113702073,113702073,0,https://data.covid19.go.id/public/index.html,45525369,68176704,0,0,0.4095862766830751,0,0,45733301,67968772
Indonesia,2023-02-04,113702073,113702073,0,https://data.covid19.go.id/public/index.html,45525369,68176704,0,0,0.4095862766830751,0,0,45733301,67968772
Indonesia,2023-02-05,113702073,113702073,0,https://data.covid19.go.id/public/index.html,45525369,68176704,0,0,0.4095862766830751,0,0,45733301,67968772
Indonesia,2023-02-06,113702073,113702073,0,https://data.covid19.go.id/public/index.html,45525369,68176704,0,0,0.4095862766830751,0,0,45733301,67968772
Indonesia,2023-02-07,113702073,113702073,0,https://data.covid19.go.id/public/index.html,45525369,68176704,0,0,0.4095862766830751,0,0,45733301,67968772
Indonesia,2023-02-08,113702073,113702073,0,https://data.covid19.go.id/public/index.html,45525369,68176704,0,0,0.4095862766830751,0,0,45733301,67968772
Indonesia,2023-02-09,113702073,113702073,0,https://data.covid19.go.id/public/index.html,45525369,68176704,0,0,0.4095862766830751,0,0,45733301,67968772
Indonesia,2023-02-10,113702073,113702073,0,https://data.covid19.go.id/public/index.html,45525369,68176704,0,0,0.4095862766830751,0,0,45733301,67968772
Indonesia,2023-02-11,113702073,113702073,0,https://data.covid19.go.id/public/index.html,45525369,68176704,0,0,0.4095862766830751,0,0,45733301,67968772
Indonesia,2023-02-12,113702073,113702073,0,https://data.covid19.go.id/public/index.html,45525369,68176704,0,0,0.4095862766830751,0,0,45733301,67968772
Indonesia,2023-02-13,113702073,113702073,0,https://data.covid19.go.id/public/index.html,45525369,68176704,0,0,0.4095862766830751,0,0,45733301,67968772
Indonesia,2023-02-14,113702073,113702073,0,https://data.covid19.go.id/public/index.html,45525369,68176704,0,0,0.4095862766830751,0,0,45733301,67968772
Italy,2021-06-03,66717978,66717978,97633,https://raw.githubusercontent.com/pcm-dpc/COVID-19/master/dati-json/dpc-covid19-ita-andamento-nazionale-latest.json,49557296,17160682,62025,35608,0.3647127508117132,62025,35608,49557296,17160682
Italy,2021-06-04,66938917,66938917,220939,https://raw.githubusercontent.com/pcm-dpc/COVID-19/master/dati-json/dpc-covid19-ita-andamento-nazionale-latest.json,49661208,17277709,103912,117027,0.5296801379566306,103912,117027,49661208,17277709
Italy,2021-06-05,67177549,67177549,238632,https://raw.githubusercontent.com/pcm-dpc/COVID-19/master/dati-json/dpc-covid19-ita-andamento-nazionale-latest.json,49774399,17403150,113191,125441,0.5256671360085823,113191,125441,49774399,17403150
Italy,2021-06-06,67327507,67327507,149958,https://raw.githubusercontent.com/pcm-dpc/COVID-19/master/dati-json/dpc-covid19-ita-andamento-nazionale-latest.json,49862425,17465082,88026,61932,0.4129956387788581,88026,61932,49862425,17465082
Italy,2021-06-07,67412074,67412074,84567,https://raw.githubusercontent.com/pcm-dpc/COVID-19/master/dati-json/dpc-covid19-ita-andamento-nazionale-latest.json,49912181,17499893,49756,34811,0.4116381094280275,49756,34811,49912181,17499893
Italy,2021-06-08,67632991,67632991,220917,https://raw.githubusercontent.com/pcm-dpc/COVID-19/master/dati-json/dpc-covid19-ita-andamento-nazionale-latest.json,50013870,17619121,101689,119228,0.5396959038915068,101689,119228,50013870,17619121
Italy,2021-06-09,67851729,67851729,218738,https://raw.githubusercontent.com/pcm-dpc/COVID-19/master/dati-json/dpc-covid19-ita-andamento-nazionale-latest.json,50136828,17714901,122958,95780,0.4378754491674972,122958,95780,50136828,17714901
Italy,2021-06-10,68057064,68057064,205335,https://raw.githubusercontent.com/pcm-dpc/COVID-19/master/dati-json/dpc-covid19-ita-andamento-nazionale-latest.json,50244071,17812993,107243,98092,0.4777169016485256,107243,98092,50244071,17812993
Italy,2021-06-11,68257459,68257459,200395,https://raw.githubusercontent.com/pcm-dpc/COVID-19/master/dati-json/dpc-covid19-ita-andamento-nazionale-latest.json,50341628,17915831,97557,102838,0.5131764764589934,97557,102838,50341628,17915831
Italy,2021-06-12,68470425,68470425,212966,https://raw.githubusercontent.com/pcm-dpc/COVID-19/master/dati-json/dpc-covid19-ita-andamento-nazionale-latest.json,50436753,18033672,95125,117841,0.5533324568240939,95125,117841,50436753,18033672
Italy,2021-06-13,68604561,68604561,134136,https://raw.githubusercontent.com/pcm-dpc/COVID-19/master/dati-json/dpc-covid19-ita-andamento-nazionale-latest.json,50510527,18094034,73774,60362,0.45000596409614124,73774,60362,50510527,18094034
Italy,2021-06-14,68684085,68684085,79524,https://raw.githubusercontent.com/pcm-dpc/COVID-19/master/dati-json/dpc-covid19-ita-andamento-nazionale-latest.json,50555019,18129066,44492,35032,0.44052110054826216,44492,35032,50555019,18129066
Italy,2021-06-15,68896197,68896197,212112,https://raw.githubusercontent.com/pcm-dpc/COVID-19/master/dati-json/dpc-covid19-ita-andamento-nazionale-latest.json,50656352,18239845,101333,110779,0.5222665384325262,101333,110779,50656352,18239845
Italy,2021-06-16,69099370,69099370,203173,https://raw.githubusercontent.com/pcm-dpc/COVID-19/master/dati-json/dpc-covid19-ita-andamento-nazionale-latest.json,50764084,18335286,107732,95441,0.46975237851486173,107732,95441,50764084,18335286
Italy,2021-06-17,69299685,69299685,200315,https://raw.githubusercontent.com/pcm-dpc/COVID-19/master/dati-json/dpc-covid19-ita-andamento-nazionale-latest.json,50864061,18435624,99977,100338,0.5009010807977435,99977,100338,50864061,18435624
Italy,2021-06-18,69515711,69515711,216026,https://raw.githubusercontent.com/pcm-dpc/COVID-19/master/dati-json/dpc-covid19-ita-andamento-nazionale-latest.json,50952072,18563639,88011,128015,0.5925907066741967,88011,128015,50952072,18563639
Italy,2021-06-19,69765699,69765699,249988,https://raw.githubusercontent.com/pcm-dpc/COVID-19/master/dati-json/dpc-covid19-ita-andamento-nazionale-latest.json,51042709,18722990,90637,159351,0.6374345968606493,90637,159351,51042709,18722990
Italy,2021-06-20,69916221,69916221,150522,https://raw.githubusercontent.com/pcm-dpc/COVID-19/master/dati-json/dpc-covid19-ita-andamento-nazionale-latest.json,51109726,18806495,67017,83505,0.5547694024793718,67017,83505,51109726,18806495
Italy,2021-06-21,69997973,69997973,81752,https://raw.githubusercontent.com/pcm-dpc/COVID-19/master/dati-json/dpc-covid19-ita-andamento-nazionale-latest.json,51149035,18848938,39309,42443,0.5191677267834426,39309,42443,51149035,18848938
Italy,2021-06-22,70190855,70190855,192882,https://raw.githubusercontent.com/pcm-dpc/COVID-19/master/dati-json/dpc-covid19-ita-andamento-nazionale-latest.json,51242092,18948763,93057,99825,0.51754440538775,93057,99825,51242092,18948763
Italy,2021-06-23,70388886,70388886,198031,https://raw.githubusercontent.com/pcm-dpc/COVID-19/master/dati-json/dpc-covid19-ita-andamento-nazionale-latest.json,51346290,19042596,104198,93833,0.47382985492170415,104198,93833,51346290,19042596
Italy,2021-06-24,70577077,70577077,188191,https://raw.githubusercontent.com/pcm-dpc/COVID-19/master/dati-json/dpc-covid19-ita-andamento-nazionale-latest.json,51428966,19148111,82676,105515,0.5606803726001774,82676,105515,51428966,19148111
Italy,2021-06-25,70769618,70769618,192541,https://raw.githubusercontent.com/pcm-dpc/COVID-19/master/dati-json/dpc-covid19-ita-andamento-nazionale-latest.json,51505508,19264110,76542,115999,0.6024638908076722,76542,115999,51505508,19264110
Italy,2021-06-26,70994111,70994111,224493,https://raw.githubusercontent.com/pcm-dpc/COVID-19/master/dati-json/dpc-covid19-ita-andamento-nazionale-latest.json,51585935,19408176,80427,144066,0.6417393860833077,80427,144066,51585935,19408176
Italy,2021-06-27,71132502,71132502,138391,https://raw.githubusercontent.com/pcm-dpc/COVID-19/master/dati-json/dpc-covid19-ita-andamento-nazionale-latest.json,51648557,19483945,62622,75769,0.5474994761220021,62622,75769,51648557,19483945
Italy,2021-06-28,71207555,71207555,75053,https://raw.githubusercontent.com/pcm-dpc/COVID-19/master/dati-json/dpc-covid19-ita-andamento-nazionale-latest.json,51686201,19521354,37644,37409,0.4984344396626384,37644,37409,51686201,19521354
Italy,2021-06-29,71398190,71398190,190635,https://raw.githubusercontent.com/pcm-dpc/COVID-19/master/dati-json/dpc-covid19-ita-andamento-nazionale-latest.json,51772454,19625736,86253,104382,0.5475489810370604,86253,104382,51772454,19625736
Italy,2021-06-30,71583206,71583206,185016,https://raw.githubusercontent.com/pcm-dpc/COVID-19/master/dati-json/dpc-covid19-ita-andamento-nazionale-latest.json,51864808,19718398,92354,92662,0.5008323604445021,92354,92662,51864808,19718398
Italy,2021-07-01,71771680,71771680,188474,https://raw.githubusercontent.com/pcm-dpc/COVID-19/master/dati-json/dpc-covid19-ita-andamento-nazionale-latest.json,51953621,19818059,88813,99661,0.5287785052580197,88813,99661,51953621,19818059
Italy,2021-07-02,71970918,71970918,199238,https://raw.githubusercontent.com/pcm-dpc/COVID-19/master/dati-json/dpc-covid19-ita-andamento-nazionale-latest.json,52036180,19934738,82559,116679,0.5856262359590038,82559,116679,52036180,19934738
Italy,2021-07-03,72199045,72199045,228127,https://raw.githubusercontent.com/pcm-dpc/COVID-19/master/dati-json/dpc-covid19-ita-andamento-nazionale-latest.json,52121065,20077980,84885,143242,0.6279046320689792,84885,143242,52121065,20077980
Italy,2021-07-04,72340685,72340685,141640,https://raw.githubusercontent.com/pcm-dpc/COVID-19/master/dati-json/dpc-covid19-ita-andamento-nazionale-latest.json,52185355,20155330,64290,77350,0.5461027958203897,64290,77350,52185355,20155330
Italy,2021-07-05,72415334,72415334,74649,https://raw.githubusercontent.com/pcm-dpc/COVID-19/master/dati-json/dpc-covid19-ita-andamento-nazionale-latest.json,52219735,20195599,34380,40269,0.5394446007314231,34380,40269,52219735,20195599
Italy,2021-07-06,72607758,72607758,192424,https://raw.githubusercontent.com/pcm-dpc/COVID-19/master/dati-json/dpc-covid19-ita-andamento-nazionale-latest.json,52306087,20301671,86352,106072,0.5512410094374922,86352,106072,52306087,20301671
Italy,2021-07-07,72785735,72785735,177977,https://raw.githubusercontent.com/pcm-dpc/COVID-19/master/dati-json/dpc-covid19-ita-andamento-nazionale-latest.json,52395134,20390601,89047,88930,0.4996713058428898,89047,88930,52395134,20390601
Italy,2021-07-08,72960587,72960587,174852,https://raw.githubusercontent.com/pcm-dpc/COVID-19/master/dati-json/dpc-covid19-ita-andamento-nazionale-latest.json,52481505,20479082,86371,88481,0.5060336741930318,86371,88481,52481505,20479082
Italy,2021-07-09,73157509,73157509,196922,https://raw.githubusercontent.com/pcm-dpc/COVID-19/master/dati-json/dpc-covid19-ita-andamento-nazionale-latest.json,52563607,20593902,82102,114820,0.5830735011832096,82102,114820,52563607,20593902
Italy,2021-07-10,73365928,73365928,208419,https://raw.githubusercontent.com/pcm-dpc/COVID-19/master/dati-json/dpc-covid19-ita-andamento-nazionale-latest.json,52642946,20722982,79339,129080,0.6193293317787726,79339,129080,52642946,20722982
Italy,2021-07-11,73509260,73509260,143332,https://raw.githubusercontent.com/pcm-dpc/COVID-19/master/dati-json/dpc-covid19-ita-andamento-nazionale-latest.json,52708153,20801107,65207,78125,0.5450632098903245,65207,78125,52708153,20801107
Italy,2021-07-12,73582831,73582831,73571,https://raw.githubusercontent.com/pcm-dpc/COVID-19/master/dati-json/dpc-covid19-ita-andamento-nazionale-latest.json,52745243,20837588,37090,36481,0.49586114093868505,37090,36481,52745243,20837588
Italy,2021-07-13,73775374,73775374,192543,https://raw.githubusercontent.com/pcm-dpc/COVID-19/master/dati-json/dpc-covid19-ita-andamento-nazionale-latest.json,52831764,20943610,86521,106022,0.5506406361176465,86521,106022,52831764,20943610
Italy,2021-07-14,73985973,73985973,210599,https://raw.githubusercontent.com/pcm-dpc/COVID-19/master/dati-json/dpc-covid19-ita-andamento-nazionale-latest.json,52933366,21052607,101602,108997,0.5175570634238529,101602,108997,52933366,21052607
Italy,2021-07-15,74176895,74176895,190922,https://raw.githubusercontent.com/pcm-dpc/COVID-19/master/dati-json/dpc-covid19-ita-andamento-nazionale-latest.json,53025450,21151445,92084,98838,0.5176878515833692,92084,98838,53025450,21151445
Italy,2021-07-16,74382497,74382497,205602,https://raw.githubusercontent.com/pcm-dpc/COVID-19/master/dati-json/dpc-covid19-ita-andamento-nazionale-latest.json,53116943,21265554,91493,114109,0.5549994649857491,91493,114109,53116943,21265554
Italy,2021-07-17,74627294,74627294,244797,https://raw.githubusercontent.com/pcm-dpc/COVID-19/master/dati-json/dpc-covid19-ita-andamento-nazionale-latest.json,53205793,21421501,88850,155947,0.637046205631605,88850,155947,53205793,21421501
Italy,2021-07-18,74792563,74792563,165269,https://raw.githubusercontent.com/pcm-dpc/COVID-19/master/dati-json/dpc-covid19-ita-andamento-nazionale-latest.json,53280157,21512406,74364,90905,0.5500426577277046,74364,90905,53280157,21512406
Italy,2021-07-19,74881652,74881652,89089,https://raw.githubusercontent.com/pcm-dpc/COVID-19/master/dati-json/dpc-covid19-ita-andamento-nazionale-latest.json,53327382,21554270,47225,41864,0.46991211036154856,47225,41864,53327382,21554270
Italy,2021-07-20,75100357,75100357,218705,https://raw.githubusercontent.com/pcm-dpc/COVID-19/master/dati-json/dpc-covid19-ita-andamento-nazionale-latest.json,53421858,21678499,94476,124229,0.5680208500034293,94476,124229,53421858,21678499
Italy,2021-07-21,75335454,75335454,235097,https://raw.githubusercontent.com/pcm-dpc/COVID-19/master/dati-json/dpc-covid19-ita-andamento-nazionale-latest.json,53537923,21797531,116065,119032,0.5063101613376606,116065,119032,53537923,21797531
Italy,2021-07-22,75555232,75555232,219778,https://raw.githubusercontent.com/pcm-dpc/COVID-19/master/dati-json/dpc-covid19-ita-andamento-nazionale-latest.json,53639886,21915346,101963,117815,0.5360636642430089,101963,117815,53639886,21915346
Italy,2021-07-23,75792867,75792867,237635,https://raw.githubusercontent.com/pcm-dpc/COVID-19/master/dati-json/dpc-covid19-ita-andamento-nazionale-latest.json,53739841,22053026,99955,137680,0.5793759336798031,99955,137680,53739841,22053026
Italy,2021-07-24,76051796,76051796,258929,https://raw.githubusercontent.com/pcm-dpc/COVID-19/master/dati-json/dpc-covid19-ita-andamento-nazionale-latest.json,53838808,22212988,98967,159962,0.6177832533242703,98967,159962,53838808,22212988
Italy,2021-07-25,76228449,76228449,176653,https://raw.githubusercontent.com/pcm-dpc/COVID-19/master/dati-json/dpc-covid19-ita-andamento-nazionale-latest.json,53914872,22313577,76064,100589,0.5694157472559198,76064,100589,53914872,22313577
Italy,2021-07-26,76316696,76316696,88247,https://raw.githubusercontent.com/pcm-dpc/COVID-19/master/dati-json/dpc-covid19-ita-andamento-nazionale-latest.json,53963263,22353433,48391,39856,0.4516414155722008,48391,39856,53963263,22353433
Italy,2021-07-27,76558586,76558586,241890,https://raw.githubusercontent.com/pcm-dpc/COVID-19/master/dati-json/dpc-covid19-ita-andamento-nazionale-latest.json,54064580,22494006,101317,140573,0.5811443217991649,101317,140573,54064580,22494006
Italy,2021-07-28,76807058,76807058,248472,https://raw.githubusercontent.com/pcm-dpc/COVID-19/master/dati-json/dpc-covid19-ita-andamento-nazionale-latest.json,54187112,22619946,122532,125940,0.5068579155800251,122532,125940,54187112,22619946
Italy,2021-07-29,77031848,77031848,224790,https://raw.githubusercontent.com/pcm-dpc/COVID-19/master/dati-json/dpc-covid19-ita-andamento-nazionale-latest.json,54294154,22737694,107042,117748,0.5238133368922105,107042,117748,54294154,22737694
Italy,2021-07-30,77279334,77279334,247486,https://raw.githubusercontent.com/pcm-dpc/COVID-19/master/dati-json/dpc-covid19-ita-andamento-nazionale-latest.json,54404275,22875059,110121,137365,0.5550414972968168,110121,137365,54404275,22875059
Italy,2021-07-31,77544194,77544194,264860,https://raw.githubusercontent.com/pcm-dpc/COVID-19/master/dati-json/dpc-covid19-ita-andamento-nazionale-latest.json,54497272,23046922,92997,171863,0.6488824284527674,92997,171863,54497272,23046922
Italy,2021-08-01,77711955,77711955,167761,https://raw.githubusercontent.com/pcm-dpc/COVID-19/master/dati-json/dpc-covid19-ita-andamento-nazionale-latest.json,54569773,23142182,72501,95260,0.5678316175988459,72501,95260,54569773,23142182
Italy,2021-08-02,77795178,77795178,83223,https://raw.githubusercontent.com/pcm-dpc/COVID-19/master/dati-json/dpc-covid19-ita-andamento-nazionale-latest.json,54612288,23182890,42515,40708,0.48914362616103724,42515,40708,54612288,23182890
Italy,2021-08-03,78004897,78004897,209719,https://raw.githubusercontent.com/pcm-dpc/COVID-19/master/dati-json/dpc-covid19-ita-andamento-nazionale-latest.json,54704552,23300345,92264,117455,0.5600589360048446,92264,117455,54704552,23300345
Italy,2021-08-04,78220645,78220645,215748,https://raw.githubusercontent.com/pcm-dpc/COVID-19/master/dati-json/dpc-covid19-ita-andamento-nazionale-latest.json,54812163,23408482,107611,108137,0.5012190147764986,107611,108137,54812163,23408482
Italy,2021-08-05,78432872,78432872,212227,https://raw.githubusercontent.com/pcm-dpc/COVID-19/master/dati-json/dpc-covid19-ita-andamento-nazionale-latest.json,54910966,23521906,98803,113424,0.5344466066994303,98803,113424,54910966,23521906
Italy,2021-08-06,78677529,78677529,244657,https://raw.githubusercontent.com/pcm-dpc/COVID-19/master/dati-json/dpc-covid19-ita-andamento-nazionale-latest.json,55012203,23665326,101237,143420,0.5862084469277397,101237,143420,55012203,23665326
Italy,2021-08-07,78971392,78971392,293863,https://raw.githubusercontent.com/pcm-dpc/COVID-19/master/dati-json/dpc-covid19-ita-andamento-nazionale-latest.json,55108789,23862603,96586,197277,0.671323031480656,96586,197277,55108789,23862603
Italy,2021-08-08,79174903,79174903,203511,https://raw.githubusercontent.com/pcm-dpc/COVID-19/master/dati-json/dpc-covid19-ita-andamento-nazionale-latest.json,55182257,23992646,73468,130043,0.6389974006319069,73468,130043,55182257,23992646
Italy,2021-08-09,79277767,79277767,102864,https://raw.githubusercontent.com/pcm-dpc/COVID-19/master/dati-json/dpc-covid19-ita-andamento-nazionale-latest.json,55225285,24052482,43028,59836,0.5817001088816302,43028,59836,55225285,24052482
Italy,2021-08-10,79277767,79277767,0,https://raw.githubusercontent.com/pcm-dpc/COVID-19/master/dati-json/dpc-covid19-ita-andamento-nazionale-latest.json,55225285,24052482,0,0,0.5817001088816302,0,0,55225285,24052482
Italy,2021-08-11,79749572,79749572,471805,https://raw.githubusercontent.com/pcm-dpc/COVID-19/master/dati-json/dpc-covid19-ita-andamento-nazionale-latest.json,55419637,24329935,194352,277453,0.5880671039942349,194352,277453,55419637,24329935
Italy,2021-08-12,79966541,79966541,216969,https://raw.githubusercontent.com/pcm-dpc/COVID-19/master/dati-json/dpc-covid19-ita-andamento-nazionale-latest.json,55513139,24453402,93502,123467,0.5690536436080731,93502,123467,55513139,24453402
Italy,2021-08-13,80192027,80192027,225486,https://raw.githubusercontent.com/pcm-dpc/COVID-19/master/dati-json/dpc-covid19-ita-andamento-nazionale-latest.json,55608773,24583254,95634,129852,0.5758761076075677,95634,129852,55608773,24583254
Italy,2021-08-14,80446033,80446033,254006,https://raw.githubusercontent.com/pcm-dpc/COVID-19/master/dati-json/dpc-covid19-ita-andamento-nazionale-latest.json,55698982,24747051,90209,163797,0.6448548459485209,90209,163797,55698982,24747051
Italy,2021-08-15,80606903,80606903,160870,https://raw.githubusercontent.com/pcm-dpc/COVID-19/master/dati-json/dpc-covid19-ita-andamento-nazionale-latest.json,55763772,24843131,64790,96080,0.5972524398582707,64790,96080,55763772,24843131
Italy,2021-08-16,80680924,80680924,74021,https://raw.githubusercontent.com/pcm-dpc/COVID-19/master/dati-json/dpc-covid19-ita-andamento-nazionale-latest.json,55801186,24879738,37414,36607,0.49454884424690293,37414,36607,55801186,24879738
Italy,2021-08-17,80918997,80918997,238073,https://raw.githubusercontent.com/pcm-dpc/COVID-19/master/dati-json/dpc-covid19-ita-andamento-nazionale-latest.json,55887829,25031168,86643,151430,0.6360654085091547,86643,151430,55887829,25031168
Italy,2021-08-18,81145420,81145420,226423,https://raw.githubusercontent.com/pcm-dpc/COVID-19/master/dati-json/dpc-covid19-ita-andamento-nazionale-latest.json,55987914,25157506,100085,126338,0.5579733507638358,100085,126338,55987914,25157506
Italy,2021-08-19,81351951,81351951,206531,https://raw.githubusercontent.com/pcm-dpc/COVID-19/master/dati-json/dpc-covid19-ita-andamento-nazionale-latest.json,56076867,25275084,88953,117578,0.5692995240423956,88953,117578,56076867,25275084
Italy,2021-08-20,81572607,81572607,220656,https://raw.githubusercontent.com/pcm-dpc/COVID-19/master/dati-json/dpc-covid19-ita-andamento-nazionale-latest.json,56162599,25410008,85732,134924,0.6114676238126314,85732,134924,56162599,25410008
Italy,2021-08-21,81827825,81827825,255218,https://raw.githubusercontent.com/pcm-dpc/COVID-19/master/dati-json/dpc-covid19-ita-andamento-nazionale-latest.json,56252852,25574973,90253,164965,0.6463689865134904,90253,164965,56252852,25574973
Italy,2021-08-22,82003364,82003364,175539,https://raw.githubusercontent.com/pcm-dpc/COVID-19/master/dati-json/dpc-covid19-ita-andamento-nazionale-latest.json,56322084,25681280,69232,106307,0.605603313223842,69232,106307,56322084,25681280
Italy,2021-08-23,82104705,82104705,101341,https://raw.githubusercontent.com/pcm-dpc/COVID-19/master/dati-json/dpc-covid19-ita-andamento-nazionale-latest.json,56364064,25740641,41980,59361,0.5857550251132315,41980,59361,56364064,25740641
Italy,2021-08-24,82370951,82370951,266246,https://raw.githubusercontent.com/pcm-dpc/COVID-19/master/dati-json/dpc-covid19-ita-andamento-nazionale-latest.json,56461924,25909027,97860,168386,0.6324451822750389,97860,168386,56461924,25909027
Italy,2021-08-25,82615371,82615371,244420,https://raw.githubusercontent.com/pcm-dpc/COVID-19/master/dati-json/dpc-covid19-ita-andamento-nazionale-latest.json,56574161,26041210,112237,132183,0.5408027166352999,112237,132183,56574161,26041210
Italy,2021-08-26,82836243,82836243,220872,https://raw.githubusercontent.com/pcm-dpc/COVID-19/master/dati-json/dpc-covid19-ita-andamento-nazionale-latest.json,56670393,26165850,96232,124640,0.5643087399036546,96232,124640,56670393,26165850
Italy,2021-08-27,83101723,83101723,265480,https://raw.githubusercontent.com/pcm-dpc/COVID-19/master/dati-json/dpc-covid19-ita-andamento-nazionale-latest.json,56770912,26330811,100519,164961,0.6213688413439807,100519,164961,56770912,26330811
Italy,2021-08-28,83395187,83395187,293464,https://raw.githubusercontent.com/pcm-dpc/COVID-19/master/dati-json/dpc-covid19-ita-andamento-nazionale-latest.json,56866439,26528748,95527,197937,0.6744847749638797,95527,197937,56866439,26528748
Italy,2021-08-29,83618273,83618273,223086,https://raw.githubusercontent.com/pcm-dpc/COVID-19/master/dati-json/dpc-covid19-ita-andamento-nazionale-latest.json,56947693,26670580,81254,141832,0.6357727513156362,81254,141832,56947693,26670580
Italy,2021-08-30,83728076,83728076,109803,https://raw.githubusercontent.com/pcm-dpc/COVID-19/master/dati-json/dpc-covid19-ita-andamento-nazionale-latest.json,56997959,26730117,50266,59537,0.5422165150314654,50266,59537,56997959,26730117
Italy,2021-08-31,84035719,84035719,307643,https://raw.githubusercontent.com/pcm-dpc/COVID-19/master/dati-json/dpc-covid19-ita-andamento-nazionale-latest.json,57111626,26924093,113667,193976,0.6305230413173711,113667,193976,57111626,26924093
Italy,2021-09-01,84339436,84339436,303717,https://raw.githubusercontent.com/pcm-dpc/COVID-19/master/dati-json/dpc-covid19-ita-andamento-nazionale-latest.json,57232920,27106516,121294,182423,0.6006348014763744,121294,182423,57232920,27106516
Italy,2021-09-02,84632503,84632503,293067,https://raw.githubusercontent.com/pcm-dpc/COVID-19/master/dati-json/dpc-covid19-ita-andamento-nazionale-latest.json,57350136,27282367,117216,175851,0.6000368516414335,117216,175851,57350136,27282367
Italy,2021-09-03,84928897,84928897,296394,https://raw.githubusercontent.com/pcm-dpc/COVID-19/master/dati-json/dpc-covid19-ita-andamento-nazionale-latest.json,57475534,27453363,125398,170996,0.5769212602144443,125398,170996,57475534,27453363
Italy,2021-09-04,85260247,85260247,331350,https://raw.githubusercontent.com/pcm-dpc/COVID-19/master/dati-json/dpc-covid19-ita-andamento-nazionale-latest.json,57568980,27691267,93446,237904,0.7179840048287309,93446,237904,57568980,27691267
Italy,2021-09-05,85520003,85520003,259756,https://raw.githubusercontent.com/pcm-dpc/COVID-19/master/dati-json/dpc-covid19-ita-andamento-nazionale-latest.json,57647826,27872177,78846,180910,0.6964612944455566,78846,180910,57647826,27872177
Italy,2021-09-06,85654396,85654396,134393,https://raw.githubusercontent.com/pcm-dpc/COVID-19/master/dati-json/dpc-covid19-ita-andamento-nazionale-latest.json,57696131,27958265,48305,86088,0.6405690772584882,48305,86088,57696131,27958265
Italy,2021-09-07,85973261,85973261,318865,https://raw.githubusercontent.com/pcm-dpc/COVID-19/master/dati-json/dpc-covid19-ita-andamento-nazionale-latest.json,57802636,28170625,106505,212360,0.6659871732551393,106505,212360,57802636,28170625
Italy,2021-09-08,86275241,86275241,301980,https://raw.githubusercontent.com/pcm-dpc/COVID-19/master/dati-json/dpc-covid19-ita-andamento-nazionale-latest.json,57934218,28341023,131582,170398,0.5642691568978078,131582,170398,57934218,28341023
Italy,2021-09-09,86566709,86566709,291468,https://raw.githubusercontent.com/pcm-dpc/COVID-19/master/dati-json/dpc-covid19-ita-andamento-nazionale-latest.json,58047899,28518810,113681,177787,0.6099709058970453,113681,177787,58047899,28518810
Italy,2021-09-10,86852737,86852737,286028,https://raw.githubusercontent.com/pcm-dpc/COVID-19/master/dati-json/dpc-covid19-ita-andamento-nazionale-latest.json,58154366,28698371,106467,179561,0.6277742039240913,106467,179561,58154366,28698371
Italy,2021-09-11,87186478,87186478,333741,https://raw.githubusercontent.com/pcm-dpc/COVID-19/master/dati-json/dpc-covid19-ita-andamento-nazionale-latest.json,58258247,28928231,103881,229860,0.6887376738249121,103881,229860,58258247,28928231
Italy,2021-09-12,87453836,87453836,267358,https://raw.githubusercontent.com/pcm-dpc/COVID-19/master/dati-json/dpc-covid19-ita-andamento-nazionale-latest.json,58348470,29105366,90223,177135,0.6625386186311987,90223,177135,58348470,29105366
Italy,2021-09-13,87573881,87573881,120045,https://raw.githubusercontent.com/pcm-dpc/COVID-19/master/dati-json/dpc-covid19-ita-andamento-nazionale-latest.json,58398719,29175162,50249,69796,0.5814153025948603,50249,69796,58398719,29175162
Italy,2021-09-14,87892474,87892474,318593,https://raw.githubusercontent.com/pcm-dpc/COVID-19/master/dati-json/dpc-covid19-ita-andamento-nazionale-latest.json,58507212,29385262,108493,210100,0.6594620722991403,108493,210100,58507212,29385262
Italy,2021-09-15,88210140,88210140,317666,https://raw.githubusercontent.com/pcm-dpc/COVID-19/master/dati-json/dpc-covid19-ita-andamento-nazionale-latest.json,58633294,29576846,126082,191584,0.6030988522536249,126082,191584,58633294,29576846
Italy,2021-09-16,88516407,88516407,306267,https://raw.githubusercontent.com/pcm-dpc/COVID-19/master/dati-json/dpc-covid19-ita-andamento-nazionale-latest.json,58745788,29770619,112494,193773,0.6326930423454045,112494,193773,58745788,29770619
Italy,2021-09-17,88800986,88800986,284579,https://raw.githubusercontent.com/pcm-dpc/COVID-19/master/dati-json/dpc-covid19-ita-andamento-nazionale-latest.json,58845032,29955954,99244,185335,0.6512602827334413,99244,185335,58845032,29955954
Italy,2021-09-18,89156919,89156919,355933,https://raw.githubusercontent.com/pcm-dpc/COVID-19/master/dati-json/dpc-covid19-ita-andamento-nazionale-latest.json,58960530,30196389,115498,240435,0.6755063452953224,115498,240435,58960530,30196389
Italy,2021-09-19,89420490,89420490,263571,https://raw.githubusercontent.com/pcm-dpc/COVID-19/master/dati-json/dpc-covid19-ita-andamento-nazionale-latest.json,59041923,30378567,81393,182178,0.6911913677908419,81393,182178,59041923,30378567
Italy,2021-09-20,89542931,89542931,122441,https://raw.githubusercontent.com/pcm-dpc/COVID-19/master/dati-json/dpc-covid19-ita-andamento-nazionale-latest.json,59091430,30451501,49507,72934,0.5956664842658913,49507,72934,59091430,30451501
Italy,2021-09-21,89873206,89873206,330275,https://raw.githubusercontent.com/pcm-dpc/COVID-19/master/dati-json/dpc-covid19-ita-andamento-nazionale-latest.json,59203516,30669690,112086,218189,0.6606282643251835,112086,218189,59203516,30669690
Italy,2021-09-22,90166078,90166078,292872,https://raw.githubusercontent.com/pcm-dpc/COVID-19/master/dati-json/dpc-covid19-ita-andamento-nazionale-latest.json,59327279,30838799,123763,169109,0.5774160725504658,123763,169109,59327279,30838799
Italy,2021-09-23,90487632,90487632,321554,https://raw.githubusercontent.com/pcm-dpc/COVID-19/master/dati-json/dpc-covid19-ita-andamento-nazionale-latest.json,59450226,31037406,122947,198607,0.6176474246938306,122947,198607,59450226,31037406
Italy,2021-09-24,90765140,90765140,277508,https://raw.githubusercontent.com/pcm-dpc/COVID-19/master/dati-json/dpc-covid19-ita-andamento-nazionale-latest.json,59546939,31218201,96713,180795,0.6514947316834109,96713,180795,59546939,31218201
Italy,2021-09-25,91122631,91122631,357491,https://raw.githubusercontent.com/pcm-dpc/COVID-19/master/dati-json/dpc-covid19-ita-andamento-nazionale-latest.json,59652090,31470541,105151,252340,0.7058639238470339,105151,252340,59652090,31470541
Italy,2021-09-26,91398852,91398852,276221,https://raw.githubusercontent.com/pcm-dpc/COVID-19/master/dati-json/dpc-covid19-ita-andamento-nazionale-latest.json,59739534,31659318,87444,188777,0.6834274005234938,87444,188777,59739534,31659318
Italy,2021-09-27,91522929,91522929,124077,https://raw.githubusercontent.com/pcm-dpc/COVID-19/master/dati-json/dpc-covid19-ita-andamento-nazionale-latest.json,59787712,31735217,48178,75899,0.6117088582090153,48178,75899,59787712,31735217
Italy,2021-09-28,91861354,91861354,338425,https://raw.githubusercontent.com/pcm-dpc/COVID-19/master/dati-json/dpc-covid19-ita-andamento-nazionale-latest.json,59905325,31956029,117613,220812,0.6524695279604048,117613,220812,59905325,31956029
Italy,2021-09-29,92156806,92156806,295452,https://raw.githubusercontent.com/pcm-dpc/COVID-19/master/dati-json/dpc-covid19-ita-andamento-nazionale-latest.json,60028656,32128150,123331,172121,0.582568403666247,123331,172121,60028656,32128150
Italy,2021-09-30,92465642,92465642,308836,https://raw.githubusercontent.com/pcm-dpc/COVID-19/master/dati-json/dpc-covid19-ita-andamento-nazionale-latest.json,60150908,32314734,122252,186584,0.6041523656568535,122252,186584,60150908,32314734
Italy,2021-10-01,92759111,92759111,293469,https://raw.githubusercontent.com/pcm-dpc/COVID-19/master/dati-json/dpc-covid19-ita-andamento-nazionale-latest.json,60259807,32499304,108899,184570,0.6289250312639495,108899,184570,60259807,32499304
Italy,2021-10-02,93115007,93115007,355896,https://raw.githubusercontent.com/pcm-dpc/COVID-19/master/dati-json/dpc-covid19-ita-andamento-nazionale-latest.json,60372560,32742447,112753,243143,0.6831855373479893,112753,243143,60372560,32742447
Italy,2021-10-03,93400967,93400967,285960,https://raw.githubusercontent.com/pcm-dpc/COVID-19/master/dati-json/dpc-covid19-ita-andamento-nazionale-latest.json,60459617,32941350,87057,198903,0.6955623164078892,87057,198903,60459617,32941350
Italy,2021-10-04,93523181,93523181,122214,https://raw.githubusercontent.com/pcm-dpc/COVID-19/master/dati-json/dpc-covid19-ita-andamento-nazionale-latest.json,60510390,33012791,50773,71441,0.584556597443828,50773,71441,60510390,33012791
Italy,2021-10-05,93845463,93845463,322282,https://raw.githubusercontent.com/pcm-dpc/COVID-19/master/dati-json/dpc-covid19-ita-andamento-nazionale-latest.json,60615507,33229956,105117,217165,0.6738353367547676,105117,217165,60615507,33229956
Italy,2021-10-06,94147236,94147236,301773,https://raw.githubusercontent.com/pcm-dpc/COVID-19/master/dati-json/dpc-covid19-ita-andamento-nazionale-latest.json,60748686,33398550,133179,168594,0.5586782117684485,133179,168594,60748686,33398550
Italy,2021-10-07,94444592,94444592,297356,https://raw.githubusercontent.com/pcm-dpc/COVID-19/master/dati-json/dpc-covid19-ita-andamento-nazionale-latest.json,60863483,33581109,114797,182559,0.6139408654945587,114797,182559,60863483,33581109
Italy,2021-10-08,94716158,94716158,271566,https://raw.githubusercontent.com/pcm-dpc/COVID-19/master/dati-json/dpc-covid19-ita-andamento-nazionale-latest.json,60971361,33744797,107878,163688,0.6027558678185045,107878,163688,60971361,33744797
Italy,2021-10-09,95061127,95061127,344969,https://raw.githubusercontent.com/pcm-dpc/COVID-19/master/dati-json/dpc-covid19-ita-andamento-nazionale-latest.json,61075375,33985752,104014,240955,0.6984830521003337,104014,240955,61075375,33985752
Italy,2021-10-10,95331171,95331171,270044,https://raw.githubusercontent.com/pcm-dpc/COVID-19/master/dati-json/dpc-covid19-ita-andamento-nazionale-latest.json,61154936,34176235,79561,190483,0.705377642162018,79561,190483,61154936,34176235
Italy,2021-10-11,95445947,95445947,114776,https://raw.githubusercontent.com/pcm-dpc/COVID-19/master/dati-json/dpc-covid19-ita-andamento-nazionale-latest.json,61203810,34242137,48874,65902,0.57417927092772,48874,65902,61203810,34242137
Italy,2021-10-12,95761232,95761232,315285,https://raw.githubusercontent.com/pcm-dpc/COVID-19/master/dati-json/dpc-covid19-ita-andamento-nazionale-latest.json,61308451,34452781,104641,210644,0.6681066336806382,104641,210644,61308451,34452781
Italy,2021-10-13,96040177,96040177,278945,https://raw.githubusercontent.com/pcm-dpc/COVID-19/master/dati-json/dpc-covid19-ita-andamento-nazionale-latest.json,61428982,34611195,120531,158414,0.5679040671100037,120531,158414,61428982,34611195
Italy,2021-10-14,96364791,96364791,324614,https://raw.githubusercontent.com/pcm-dpc/COVID-19/master/dati-json/dpc-covid19-ita-andamento-nazionale-latest.json,61540896,34823895,111914,212700,0.6552397616861872,111914,212700,61540896,34823895
Italy,2021-10-15,96870834,96870834,506043,https://raw.githubusercontent.com/pcm-dpc/COVID-19/master/dati-json/dpc-covid19-ita-andamento-nazionale-latest.json,61650555,35220279,109659,396384,0.7833010238260385,109659,396384,61650555,35220279
Italy,2021-10-16,97343369,97343369,472535,https://raw.githubusercontent.com/pcm-dpc/COVID-19/master/dati-json/dpc-covid19-ita-andamento-nazionale-latest.json,61765276,35578093,114721,357814,0.7572222163437629,114721,357814,61765276,35578093
Italy,2021-10-17,97724420,97724420,381051,https://raw.githubusercontent.com/pcm-dpc/COVID-19/master/dati-json/dpc-covid19-ita-andamento-nazionale-latest.json,61844834,35879586,79558,301493,0.7912142993982433,79558,301493,61844834,35879586
Italy,2021-10-18,97944298,97944298,219878,https://raw.githubusercontent.com/pcm-dpc/COVID-19/master/dati-json/dpc-covid19-ita-andamento-nazionale-latest.json,61889258,36055040,44424,175454,0.7979606872902246,44424,175454,61889258,36055040
Italy,2021-10-19,98606298,98606298,662000,https://raw.githubusercontent.com/pcm-dpc/COVID-19/master/dati-json/dpc-covid19-ita-andamento-nazionale-latest.json,62002436,36603862,113178,548822,0.8290362537764351,113178,548822,62002436,36603862
Italy,2021-10-20,99091911,99091911,485613,https://raw.githubusercontent.com/pcm-dpc/COVID-19/master/dati-json/dpc-covid19-ita-andamento-nazionale-latest.json,62124122,36967789,121686,363927,0.7494177462300227,121686,363927,62124122,36967789
Italy,2021-10-21,99666582,99666582,574671,https://raw.githubusercontent.com/pcm-dpc/COVID-19/master/dati-json/dpc-covid19-ita-andamento-nazionale-latest.json,62238970,37427612,114848,459823,0.800149998868918,114848,459823,62238970,37427612
Italy,2021-10-22,100153800,100153800,487218,https://raw.githubusercontent.com/pcm-dpc/COVID-19/master/dati-json/dpc-covid19-ita-andamento-nazionale-latest.json,62351624,37802176,112654,374564,0.7687811205661531,112654,374564,62351624,37802176
Italy,2021-10-23,100645374,100645374,491574,https://raw.githubusercontent.com/pcm-dpc/COVID-19/master/dati-json/dpc-covid19-ita-andamento-nazionale-latest.json,62457189,38188185,105565,386009,0.785251050706506,105565,386009,62457189,38188185
Italy,2021-10-24,101049089,101049089,403715,https://raw.githubusercontent.com/pcm-dpc/COVID-19/master/dati-json/dpc-covid19-ita-andamento-nazionale-latest.json,62540445,38508644,83256,320459,0.7937753117917342,83256,320459,62540445,38508644
Italy,2021-10-25,101271474,101271474,222385,https://raw.githubusercontent.com/pcm-dpc/COVID-19/master/dati-json/dpc-covid19-ita-andamento-nazionale-latest.json,62589472,38682002,49027,173358,0.7795399869595522,49027,173358,62589472,38682002
Italy,2021-10-26,101911219,101911219,639745,https://raw.githubusercontent.com/pcm-dpc/COVID-19/master/dati-json/dpc-covid19-ita-andamento-nazionale-latest.json,62702807,39208412,113335,526410,0.8228434766977467,113335,526410,62702807,39208412
Italy,2021-10-27,102379323,102379323,468104,https://raw.githubusercontent.com/pcm-dpc/COVID-19/master/dati-json/dpc-covid19-ita-andamento-nazionale-latest.json,62828246,39551077,125439,342665,0.7320274981628014,125439,342665,62828246,39551077
Italy,2021-10-28,102949658,102949658,570335,https://raw.githubusercontent.com/pcm-dpc/COVID-19/master/dati-json/dpc-covid19-ita-andamento-nazionale-latest.json,62951716,39997942,123470,446865,0.7835131983834063,123470,446865,62951716,39997942
Italy,2021-10-29,103424436,103424436,474778,https://raw.githubusercontent.com/pcm-dpc/COVID-19/master/dati-json/dpc-covid19-ita-andamento-nazionale-latest.json,63079137,40345299,127421,347357,0.7316198307419468,127421,347357,63079137,40345299
Italy,2021-10-30,103901788,103901788,477352,https://raw.githubusercontent.com/pcm-dpc/COVID-19/master/dati-json/dpc-covid19-ita-andamento-nazionale-latest.json,63187420,40714368,108283,369069,0.7731590105414872,108283,369069,63187420,40714368
Italy,2021-10-31,104251958,104251958,350170,https://raw.githubusercontent.com/pcm-dpc/COVID-19/master/dati-json/dpc-covid19-ita-andamento-nazionale-latest.json,63271453,40980505,84033,266137,0.7600222748950509,84033,266137,63271453,40980505
Italy,2021-11-01,104398683,104398683,146725,https://raw.githubusercontent.com/pcm-dpc/COVID-19/master/dati-json/dpc-covid19-ita-andamento-nazionale-latest.json,63316846,41081837,45393,101332,0.6906253194752088,45393,101332,63316846,41081837
Italy,2021-11-02,104637037,104637037,238354,https://raw.githubusercontent.com/pcm-dpc/COVID-19/master/dati-json/dpc-covid19-ita-andamento-nazionale-latest.json,63378327,41258710,61481,176873,0.7420601290517466,61481,176873,63378327,41258710
Italy,2021-11-03,105354348,105354348,717311,https://raw.githubusercontent.com/pcm-dpc/COVID-19/master/dati-json/dpc-covid19-ita-andamento-nazionale-latest.json,63507841,41846507,129514,587797,0.8194451221297318,129514,587797,63507841,41846507
Italy,2021-11-04,105868977,105868977,514629,https://raw.githubusercontent.com/pcm-dpc/COVID-19/master/dati-json/dpc-covid19-ita-andamento-nazionale-latest.json,63645336,42223641,137495,377134,0.7328269491225718,137495,377134,63645336,42223641
Italy,2021-11-05,106412391,106412391,543414,https://raw.githubusercontent.com/pcm-dpc/COVID-19/master/dati-json/dpc-covid19-ita-andamento-nazionale-latest.json,63773771,42638620,128435,414979,0.7636516541715892,128435,414979,63773771,42638620
Italy,2021-11-06,106904353,106904353,491962,https://raw.githubusercontent.com/pcm-dpc/COVID-19/master/dati-json/dpc-covid19-ita-andamento-nazionale-latest.json,63906880,42997473,133109,358853,0.7294323545314475,133109,358853,63906880,42997473
Italy,2021-11-07,107339124,107339124,434771,https://raw.githubusercontent.com/pcm-dpc/COVID-19/master/dati-json/dpc-covid19-ita-andamento-nazionale-latest.json,64006304,43332820,99424,335347,0.7713186942091353,99424,335347,64006304,43332820
Italy,2021-11-08,107588239,107588239,249115,https://raw.githubusercontent.com/pcm-dpc/COVID-19/master/dati-json/dpc-covid19-ita-andamento-nazionale-latest.json,64068951,43519288,62647,186468,0.748521767055376,62647,186468,64068951,43519288
Italy,2021-11-09,108233928,108233928,645689,https://raw.githubusercontent.com/pcm-dpc/COVID-19/master/dati-json/dpc-covid19-ita-andamento-nazionale-latest.json,64198051,44035877,129100,516589,0.8000585421154767,129100,516589,64198051,44035877
Italy,2021-11-10,108721546,108721546,487618,https://raw.githubusercontent.com/pcm-dpc/COVID-19/master/dati-json/dpc-covid19-ita-andamento-nazionale-latest.json,64344604,44376942,146553,341065,0.6994512097584584,146553,341065,64344604,44376942
Italy,2021-11-11,109317358,109317358,595812,https://raw.githubusercontent.com/pcm-dpc/COVID-19/master/dati-json/dpc-covid19-ita-andamento-nazionale-latest.json,64490144,44827214,145540,450272,0.7557283169858949,145540,450272,64490144,44827214
Italy,2021-11-12,109816293,109816293,498935,https://raw.githubusercontent.com/pcm-dpc/COVID-19/master/dati-json/dpc-covid19-ita-andamento-nazionale-latest.json,64623457,45192836,133313,365622,0.7328048743824346,133313,365622,64623457,45192836
Italy,2021-11-13,110356664,110356664,540371,https://raw.githubusercontent.com/pcm-dpc/COVID-19/master/dati-json/dpc-covid19-ita-andamento-nazionale-latest.json,64758767,45597897,135310,405061,0.7495979614005933,135310,405061,64758767,45597897
Italy,2021-11-14,110802257,110802257,445593,https://raw.githubusercontent.com/pcm-dpc/COVID-19/master/dati-json/dpc-covid19-ita-andamento-nazionale-latest.json,64864335,45937922,105568,340025,0.7630842495281569,105568,340025,64864335,45937922
Italy,2021-11-15,111051082,111051082,248825,https://raw.githubusercontent.com/pcm-dpc/COVID-19/master/dati-json/dpc-covid19-ita-andamento-nazionale-latest.json,64929977,46121105,65642,183183,0.7361921028835527,65642,183183,64929977,46121105
Italy,2021-11-16,111735792,111735792,684710,https://raw.githubusercontent.com/pcm-dpc/COVID-19/master/dati-json/dpc-covid19-ita-andamento-nazionale-latest.json,65078921,46656871,148944,535766,0.7824714112543997,148944,535766,65078921,46656871
Italy,2021-11-17,112273557,112273557,537765,https://raw.githubusercontent.com/pcm-dpc/COVID-19/master/dati-json/dpc-covid19-ita-andamento-nazionale-latest.json,65254872,47018685,175951,361814,0.6728106143017861,175951,361814,65254872,47018685
Italy,2021-11-18,112899331,112899331,625774,https://raw.githubusercontent.com/pcm-dpc/COVID-19/master/dati-json/dpc-covid19-ita-andamento-nazionale-latest.json,65417133,47482198,162261,463513,0.7407035127697859,162261,463513,65417133,47482198
Italy,2021-11-19,113441297,113441297,541966,https://raw.githubusercontent.com/pcm-dpc/COVID-19/master/dati-json/dpc-covid19-ita-andamento-nazionale-latest.json,65576766,47864531,159633,382333,0.7054556927925368,159633,382333,65576766,47864531
Italy,2021-11-20,114012631,114012631,571334,https://raw.githubusercontent.com/pcm-dpc/COVID-19/master/dati-json/dpc-covid19-ita-andamento-nazionale-latest.json,65732775,48279856,156009,415325,0.7269390584141675,156009,415325,65732775,48279856
Italy,2021-11-21,114499740,114499740,487109,https://raw.githubusercontent.com/pcm-dpc/COVID-19/master/dati-json/dpc-covid19-ita-andamento-nazionale-latest.json,65859791,48639949,127016,360093,0.7392452202689747,127016,360093,65859791,48639949
Italy,2021-11-22,114767310,114767310,267570,https://raw.githubusercontent.com/pcm-dpc/COVID-19/master/dati-json/dpc-covid19-ita-andamento-nazionale-latest.json,65933097,48834213,73306,194264,0.7260305714392495,73306,194264,65933097,48834213
Italy,2021-11-23,115456590,115456590,689280,https://raw.githubusercontent.com/pcm-dpc/COVID-19/master/dati-json/dpc-covid19-ita-andamento-nazionale-latest.json,66090711,49365879,157614,531666,0.7713353064066852,157614,531666,66090711,49365879
Italy,2021-11-24,116019095,116019095,562505,https://raw.githubusercontent.com/pcm-dpc/COVID-19/master/dati-json/dpc-covid19-ita-andamento-nazionale-latest.json,66278086,49741009,187375,375130,0.6668918498502235,187375,375130,66278086,49741009
Italy,2021-11-25,116669093,116669093,649998,https://raw.githubusercontent.com/pcm-dpc/COVID-19/master/dati-json/dpc-covid19-ita-andamento-nazionale-latest.json,66454367,50214726,176281,473717,0.7287976270696217,176281,473717,66454367,50214726
Italy,2021-11-26,117226273,117226273,557180,https://raw.githubusercontent.com/pcm-dpc/COVID-19/master/dati-json/dpc-covid19-ita-andamento-nazionale-latest.json,66622177,50604096,167810,389370,0.6988226425930579,167810,389370,66622177,50604096
Italy,2021-11-27,117823171,117823171,596898,https://raw.githubusercontent.com/pcm-dpc/COVID-19/master/dati-json/dpc-covid19-ita-andamento-nazionale-latest.json,66793350,51029821,171173,425725,0.7132290609115796,171173,425725,66793350,51029821
Italy,2021-11-28,118335763,118335763,512592,https://raw.githubusercontent.com/pcm-dpc/COVID-19/master/dati-json/dpc-covid19-ita-andamento-nazionale-latest.json,66928963,51406800,135613,376979,0.7354367606205325,135613,376979,66928963,51406800
Italy,2021-11-29,118611763,118611763,276000,https://raw.githubusercontent.com/pcm-dpc/COVID-19/master/dati-json/dpc-covid19-ita-andamento-nazionale-latest.json,67009417,51602346,80454,195546,0.7085,80454,195546,67009417,51602346
Italy,2021-11-30,119331735,119331735,719972,https://raw.githubusercontent.com/pcm-dpc/COVID-19/master/dati-json/dpc-covid19-ita-andamento-nazionale-latest.json,67180429,52151306,171012,548960,0.7624740962148528,171012,548960,67180429,52151306
Italy,2021-12-01,119905510,119905510,573775,https://raw.githubusercontent.com/pcm-dpc/COVID-19/master/dati-json/dpc-covid19-ita-andamento-nazionale-latest.json,67376786,52528724,196357,377418,0.6577804888675874,196357,377418,67376786,52528724
Italy,2021-12-02,120584972,120584972,679462,https://raw.githubusercontent.com/pcm-dpc/COVID-19/master/dati-json/dpc-covid19-ita-andamento-nazionale-latest.json,67574694,53010278,197908,481554,0.7087283762741698,197908,481554,67574694,53010278
Italy,2021-12-03,121173417,121173417,588445,https://raw.githubusercontent.com/pcm-dpc/COVID-19/master/dati-json/dpc-covid19-ita-andamento-nazionale-latest.json,67759212,53414205,184518,403927,0.686431187281734,184518,403927,67759212,53414205
Italy,2021-12-04,121810009,121810009,636592,https://raw.githubusercontent.com/pcm-dpc/COVID-19/master/dati-json/dpc-covid19-ita-andamento-nazionale-latest.json,67938532,53871477,179320,457272,0.7183125141377837,179320,457272,67938532,53871477
Italy,2021-12-05,122335117,122335117,525108,https://raw.githubusercontent.com/pcm-dpc/COVID-19/master/dati-json/dpc-covid19-ita-andamento-nazionale-latest.json,68082495,54252622,143963,381145,0.7258411602946442,143963,381145,68082495,54252622
Italy,2021-12-06,122636677,122636677,301560,https://raw.githubusercontent.com/pcm-dpc/COVID-19/master/dati-json/dpc-covid19-ita-andamento-nazionale-latest.json,68170338,54466339,87843,213717,0.7087047353760446,87843,213717,68170338,54466339
Italy,2021-12-07,123331813,123331813,695136,https://raw.githubusercontent.com/pcm-dpc/COVID-19/master/dati-json/dpc-covid19-ita-andamento-nazionale-latest.json,68339652,54992161,169314,525822,0.7564303963540947,169314,525822,68339652,54992161
Italy,2021-12-08,123896511,123896511,564698,https://raw.githubusercontent.com/pcm-dpc/COVID-19/master/dati-json/dpc-covid19-ita-andamento-nazionale-latest.json,68530979,55365532,191327,373371,0.6611870415691219,191327,373371,68530979,55365532
Italy,2021-12-09,124209339,124209339,312828,https://raw.githubusercontent.com/pcm-dpc/COVID-19/master/dati-json/dpc-covid19-ita-andamento-nazionale-latest.json,68639490,55569849,108511,204317,0.653128875931822,108511,204317,68639490,55569849
Italy,2021-12-10,124925626,124925626,716287,https://raw.githubusercontent.com/pcm-dpc/COVID-19/master/dati-json/dpc-covid19-ita-andamento-nazionale-latest.json,68822803,56102823,183313,532974,0.7440788399063504,183313,532974,68822803,56102823
Italy,2021-12-11,125490703,125490703,565077,https://raw.githubusercontent.com/pcm-dpc/COVID-19/master/dati-json/dpc-covid19-ita-andamento-nazionale-latest.json,69019027,56471676,196224,368853,0.6527482095360455,196224,368853,69019027,56471676
Italy,2021-12-12,125992518,125992518,501815,https://raw.githubusercontent.com/pcm-dpc/COVID-19/master/dati-json/dpc-covid19-ita-andamento-nazionale-latest.json,69174889,56817629,155862,345953,0.6894034654205236,155862,345953,69174889,56817629
Italy,2021-12-13,126306054,126306054,313536,https://raw.githubusercontent.com/pcm-dpc/COVID-19/master/dati-json/dpc-covid19-ita-andamento-nazionale-latest.json,69269958,57036096,95069,218467,0.6967844202898551,95069,218467,69269958,57036096
Italy,2021-12-14,127082617,127082617,776563,https://raw.githubusercontent.com/pcm-dpc/COVID-19/master/dati-json/dpc-covid19-ita-andamento-nazionale-latest.json,69458008,57624609,188050,588513,0.7578432142659385,188050,588513,69458008,57624609
Italy,2021-12-15,127717255,127717255,634638,https://raw.githubusercontent.com/pcm-dpc/COVID-19/master/dati-json/dpc-covid19-ita-andamento-nazionale-latest.json,69677195,58040060,219187,415451,0.6546267320897897,219187,415451,69677195,58040060
Italy,2021-12-16,128435536,128435536,718281,https://raw.githubusercontent.com/pcm-dpc/COVID-19/master/dati-json/dpc-covid19-ita-andamento-nazionale-latest.json,69890580,58544956,213385,504896,0.7029226723246195,213385,504896,69890580,58544956
Italy,2021-12-17,129104696,129104696,669160,https://raw.githubusercontent.com/pcm-dpc/COVID-19/master/dati-json/dpc-covid19-ita-andamento-nazionale-latest.json,70101368,59003328,210788,458372,0.6849961145316517,210788,458372,70101368,59003328
Italy,2021-12-18,129802436,129802436,697740,https://raw.githubusercontent.com/pcm-dpc/COVID-19/master/dati-json/dpc-covid19-ita-andamento-nazionale-latest.json,70319725,59482711,218357,479383,0.687051050534583,218357,479383,70319725,59482711
Italy,2021-12-19,130368736,130368736,566300,https://raw.githubusercontent.com/pcm-dpc/COVID-19/master/dati-json/dpc-covid19-ita-andamento-nazionale-latest.json,70495451,59873285,175726,390574,0.6896945082111955,175726,390574,70495451,59873285
Italy,2021-12-20,130705958,130705958,337222,https://raw.githubusercontent.com/pcm-dpc/COVID-19/master/dati-json/dpc-covid19-ita-andamento-nazionale-latest.json,70598903,60107055,103452,233770,0.6932228620908482,103452,233770,70598903,60107055
Italy,2021-12-21,131557823,131557823,851865,https://raw.githubusercontent.com/pcm-dpc/COVID-19/master/dati-json/dpc-covid19-ita-andamento-nazionale-latest.json,70810613,60747210,211710,640155,0.7514747054991108,211710,640155,70810613,60747210
Italy,2021-12-22,132337126,132337126,779303,https://raw.githubusercontent.com/pcm-dpc/COVID-19/master/dati-json/dpc-covid19-ita-andamento-nazionale-latest.json,71055692,61281434,245079,534224,0.6855151333948413,245079,534224,71055692,61281434
Italy,2021-12-23,133238576,133238576,901450,https://raw.githubusercontent.com/pcm-dpc/COVID-19/master/dati-json/dpc-covid19-ita-andamento-nazionale-latest.json,71317437,61921139,261745,639705,0.7096400244051251,261745,639705,71317437,61921139
Italy,2021-12-24,134168351,134168351,929775,https://raw.githubusercontent.com/pcm-dpc/COVID-19/master/dati-json/dpc-covid19-ita-andamento-nazionale-latest.json,71595127,62573224,277690,652085,0.7013363448146057,277690,652085,71595127,62573224
Italy,2021-12-25,135138103,135138103,969752,https://raw.githubusercontent.com/pcm-dpc/COVID-19/master/dati-json/dpc-covid19-ita-andamento-nazionale-latest.json,71860000,63278103,264873,704879,0.7268652191488133,264873,704879,71860000,63278103
Italy,2021-12-26,135355155,135355155,217052,https://raw.githubusercontent.com/pcm-dpc/COVID-19/master/dati-json/dpc-covid19-ita-andamento-nazionale-latest.json,71974179,63380976,114179,102873,0.4739555498221624,114179,102873,71974179,63380976
Italy,2021-12-27,135699123,135699123,343968,https://raw.githubusercontent.com/pcm-dpc/COVID-19/master/dati-json/dpc-covid19-ita-andamento-nazionale-latest.json,72087933,63611190,113754,230214,0.6692890036282445,113754,230214,72087933,63611190
Italy,2021-12-28,136733800,136733800,1034677,https://raw.githubusercontent.com/pcm-dpc/COVID-19/master/dati-json/dpc-covid19-ita-andamento-nazionale-latest.json,72335409,64398391,247476,787201,0.7608181103861398,247476,787201,72335409,64398391
Italy,2021-12-29,137763229,137763229,1029429,https://raw.githubusercontent.com/pcm-dpc/COVID-19/master/dati-json/dpc-covid19-ita-andamento-nazionale-latest.json,72652945,65110284,317536,711893,0.6915416216174209,317536,711893,72652945,65110284
Italy,2021-12-30,138913581,138913581,1150352,https://raw.githubusercontent.com/pcm-dpc/COVID-19/master/dati-json/dpc-covid19-ita-andamento-nazionale-latest.json,72990973,65922608,338028,812324,0.7061525515668248,338028,812324,72990973,65922608
Italy,2021-12-31,140137606,140137606,1224025,https://raw.githubusercontent.com/pcm-dpc/COVID-19/master/dati-json/dpc-covid19-ita-andamento-nazionale-latest.json,73357137,66780469,366164,857861,0.7008525152672536,366164,857861,73357137,66780469
Italy,2022-01-01,141221901,141221901,1084295,https://raw.githubusercontent.com/pcm-dpc/COVID-19/master/dati-json/dpc-covid19-ita-andamento-nazionale-latest.json,73690819,67531082,333682,750613,0.6922590254497162,333682,750613,73690819,67531082
Italy,2022-01-02,141547196,141547196,325295,https://raw.githubusercontent.com/pcm-dpc/COVID-19/master/dati-json/dpc-covid19-ita-andamento-nazionale-latest.json,73856391,67690805,165572,159723,0.49100969888870105,165572,159723,73856391,67690805
Italy,2022-01-03,141992517,141992517,445321,https://raw.githubusercontent.com/pcm-dpc/COVID-19/master/dati-json/dpc-covid19-ita-andamento-nazionale-latest.json,74013084,67979433,156693,288628,0.6481347163057659,156693,288628,74013084,67979433
Italy,2022-01-04,143220927,143220927,1228410,https://raw.githubusercontent.com/pcm-dpc/COVID-19/master/dati-json/dpc-covid19-ita-andamento-nazionale-latest.json,74299160,68921767,286076,942334,0.7671168420966941,286076,942334,74299160,68921767
Italy,2022-01-05,144315182,144315182,1094255,https://raw.githubusercontent.com/pcm-dpc/COVID-19/master/dati-json/dpc-covid19-ita-andamento-nazionale-latest.json,74662839,69652343,363679,730576,0.6676469378709716,363679,730576,74662839,69652343
Italy,2022-01-06,145453492,145453492,1138310,https://raw.githubusercontent.com/pcm-dpc/COVID-19/master/dati-json/dpc-covid19-ita-andamento-nazionale-latest.json,75023110,70430382,360271,778039,0.6835036150082139,360271,778039,75023110,70430382
Italy,2022-01-07,145945664,145945664,492172,https://raw.githubusercontent.com/pcm-dpc/COVID-19/master/dati-json/dpc-covid19-ita-andamento-nazionale-latest.json,75250881,70694783,227771,264401,0.5372126004730053,227771,264401,75250881,70694783
Italy,2022-01-08,147165930,147165930,1220266,https://raw.githubusercontent.com/pcm-dpc/COVID-19/master/dati-json/dpc-covid19-ita-andamento-nazionale-latest.json,75568209,71597721,317328,902938,0.7399517810051252,317328,902938,75568209,71597721
Italy,2022-01-09,148159131,148159131,993201,https://raw.githubusercontent.com/pcm-dpc/COVID-19/master/dati-json/dpc-covid19-ita-andamento-nazionale-latest.json,75856287,72302844,288078,705123,0.7099499497080651,288078,705123,75856287,72302844
Italy,2022-01-10,148771952,148771952,612821,https://raw.githubusercontent.com/pcm-dpc/COVID-19/master/dati-json/dpc-covid19-ita-andamento-nazionale-latest.json,76085265,72686687,228978,383843,0.6263541882539926,228978,383843,76085265,72686687
Italy,2022-01-11,150147466,150147466,1375514,https://raw.githubusercontent.com/pcm-dpc/COVID-19/master/dati-json/dpc-covid19-ita-andamento-nazionale-latest.json,76403257,73744209,317992,1057522,0.7688195103793927,317992,1057522,76403257,73744209
Italy,2022-01-12,151338033,151338033,1190567,https://raw.githubusercontent.com/pcm-dpc/COVID-19/master/dati-json/dpc-covid19-ita-andamento-nazionale-latest.json,76764844,74573189,361587,828980,0.6962900869921642,361587,828980,76764844,74573189
Italy,2022-01-13,152519212,152519212,1181179,https://raw.githubusercontent.com/pcm-dpc/COVID-19/master/dati-json/dpc-covid19-ita-andamento-nazionale-latest.json,77098992,75420220,334148,847031,0.7171063826905152,334148,847031,77098992,75420220
Italy,2022-01-14,153651521,153651521,1132309,https://raw.githubusercontent.com/pcm-dpc/COVID-19/master/dati-json/dpc-covid19-ita-andamento-nazionale-latest.json,77413988,76237533,314996,817313,0.7218109191042374,314996,817313,77413988,76237533
Italy,2022-01-15,154869351,154869351,1217830,https://raw.githubusercontent.com/pcm-dpc/COVID-19/master/dati-json/dpc-covid19-ita-andamento-nazionale-latest.json,77738750,77130601,324762,893068,0.7333273116937503,324762,893068,77738750,77130601
Italy,2022-01-16,155797197,155797197,927846,https://raw.githubusercontent.com/pcm-dpc/COVID-19/master/dati-json/dpc-covid19-ita-andamento-nazionale-latest.json,77976882,77820315,238132,689714,0.743349650696344,238132,689714,77976882,77820315
Italy,2022-01-17,156338495,156338495,541298,https://raw.githubusercontent.com/pcm-dpc/COVID-19/master/dati-json/dpc-covid19-ita-andamento-nazionale-latest.json,78131373,78207122,154491,386807,0.7145915928010079,154491,386807,78131373,78207122
Italy,2022-01-18,157819844,157819844,1481349,https://raw.githubusercontent.com/pcm-dpc/COVID-19/master/dati-json/dpc-covid19-ita-andamento-nazionale-latest.json,78396506,79423338,265133,1216216,0.8210192196437166,265133,1216216,78396506,79423338
Italy,2022-01-19,159001733,159001733,1181889,https://raw.githubusercontent.com/pcm-dpc/COVID-19/master/dati-json/dpc-covid19-ita-andamento-nazionale-latest.json,78704737,80296996,308231,873658,0.7392047814980933,308231,873658,78704737,80296996
Italy,2022-01-20,160111999,160111999,1110266,https://raw.githubusercontent.com/pcm-dpc/COVID-19/master/dati-json/dpc-covid19-ita-andamento-nazionale-latest.json,78992687,81119312,287950,822316,0.74064773666851,287950,822316,78992687,81119312
Italy,2022-01-21,161229552,161229552,1117553,https://raw.githubusercontent.com/pcm-dpc/COVID-19/master/dati-json/dpc-covid19-ita-andamento-nazionale-latest.json,79260426,81969126,267739,849814,0.7604238904105667,267739,849814,79260426,81969126
Italy,2022-01-22,162273201,162273201,1043649,https://raw.githubusercontent.com/pcm-dpc/COVID-19/master/dati-json/dpc-covid19-ita-andamento-nazionale-latest.json,79521523,82751678,261097,782552,0.7498229768820743,261097,782552,79521523,82751678
Italy,2022-01-23,163206585,163206585,933384,https://raw.githubusercontent.com/pcm-dpc/COVID-19/master/dati-json/dpc-covid19-ita-andamento-nazionale-latest.json,79721198,83485387,199675,733709,0.7860741131195735,199675,733709,79721198,83485387
Italy,2022-01-24,163725878,163725878,519293,https://raw.githubusercontent.com/pcm-dpc/COVID-19/master/dati-json/dpc-covid19-ita-andamento-nazionale-latest.json,79854189,83871689,132991,386302,0.7438998792589155,132991,386302,79854189,83871689
Italy,2022-01-25,165123123,165123123,1397245,https://raw.githubusercontent.com/pcm-dpc/COVID-19/master/dati-json/dpc-covid19-ita-andamento-nazionale-latest.json,80111876,85011247,257687,1139558,0.8155749349612988,257687,1139558,80111876,85011247
Italy,2022-01-26,166244710,166244710,1121587,https://raw.githubusercontent.com/pcm-dpc/COVID-19/master/dati-json/dpc-covid19-ita-andamento-nazionale-latest.json,80372410,85872300,260534,861053,0.7677095044789214,260534,861053,80372410,85872300
Italy,2022-01-27,167284466,167284466,1039756,https://raw.githubusercontent.com/pcm-dpc/COVID-19/master/dati-json/dpc-covid19-ita-andamento-nazionale-latest.json,80606511,86677955,234101,805655,0.7748500609758443,234101,805655,80606511,86677955
Italy,2022-01-28,168335754,168335754,1051288,https://raw.githubusercontent.com/pcm-dpc/COVID-19/master/dati-json/dpc-covid19-ita-andamento-nazionale-latest.json,80837676,87498078,231165,820123,0.7801125857043931,231165,820123,80837676,87498078
Italy,2022-01-29,169335244,169335244,999490,https://raw.githubusercontent.com/pcm-dpc/COVID-19/master/dati-json/dpc-covid19-ita-andamento-nazionale-latest.json,81055511,88279733,217835,781655,0.7820538474622057,217835,781655,81055511,88279733
Italy,2022-01-30,170153413,170153413,818169,https://raw.githubusercontent.com/pcm-dpc/COVID-19/master/dati-json/dpc-covid19-ita-andamento-nazionale-latest.json,81225749,88927664,170238,647931,0.7919280735398188,170238,647931,81225749,88927664
Italy,2022-01-31,170631727,170631727,478314,https://raw.githubusercontent.com/pcm-dpc/COVID-19/master/dati-json/dpc-covid19-ita-andamento-nazionale-latest.json,81342858,89288869,117109,361205,0.7551629264458075,117109,361205,81342858,89288869
Italy,2022-02-01,171878714,171878714,1246987,https://raw.githubusercontent.com/pcm-dpc/COVID-19/master/dati-json/dpc-covid19-ita-andamento-nazionale-latest.json,81545324,90333390,202466,1044521,0.8376358374225232,202466,1044521,81545324,90333390
Italy,2022-02-02,172843235,172843235,964521,https://raw.githubusercontent.com/pcm-dpc/COVID-19/master/dati-json/dpc-covid19-ita-andamento-nazionale-latest.json,81773768,91069467,228444,736077,0.7631529018030712,228444,736077,81773768,91069467
Italy,2022-02-03,173758572,173758572,915337,https://raw.githubusercontent.com/pcm-dpc/COVID-19/master/dati-json/dpc-covid19-ita-andamento-nazionale-latest.json,81978831,91779741,205063,710274,0.7759699433104966,205063,710274,81978831,91779741
Italy,2022-02-04,174643465,174643465,884893,https://raw.githubusercontent.com/pcm-dpc/COVID-19/master/dati-json/dpc-covid19-ita-andamento-nazionale-latest.json,82168606,92474859,189775,695118,0.7855390425735089,189775,695118,82168606,92474859
Italy,2022-02-05,175489945,175489945,846480,https://raw.githubusercontent.com/pcm-dpc/COVID-19/master/dati-json/dpc-covid19-ita-andamento-nazionale-latest.json,82366772,93123173,198166,648314,0.765894055382289,198166,648314,82366772,93123173
Italy,2022-02-06,176176489,176176489,686544,https://raw.githubusercontent.com/pcm-dpc/COVID-19/master/dati-json/dpc-covid19-ita-andamento-nazionale-latest.json,82517134,93659355,150362,536182,0.7809870889556969,150362,536182,82517134,93659355
Italy,2022-02-07,176570152,176570152,393663,https://raw.githubusercontent.com/pcm-dpc/COVID-19/master/dati-json/dpc-covid19-ita-andamento-nazionale-latest.json,82605992,93964160,88858,304805,0.7742790152998885,88858,304805,82605992,93964160
Italy,2022-02-08,177569247,177569247,999095,https://raw.githubusercontent.com/pcm-dpc/COVID-19/master/dati-json/dpc-covid19-ita-andamento-nazionale-latest.json,82785626,94783621,179634,819461,0.8202032839719946,179634,819461,82785626,94783621
Italy,2022-02-09,178300531,178300531,731284,https://raw.githubusercontent.com/pcm-dpc/COVID-19/master/dati-json/dpc-covid19-ita-andamento-nazionale-latest.json,82976598,95323933,190972,540312,0.7388538515816017,190972,540312,82976598,95323933
Italy,2022-02-10,178984246,178984246,683715,https://raw.githubusercontent.com/pcm-dpc/COVID-19/master/dati-json/dpc-covid19-ita-andamento-nazionale-latest.json,83142747,95841499,166149,517566,0.7569908514512625,166149,517566,83142747,95841499
Italy,2022-02-11,179648032,179648032,663786,https://raw.githubusercontent.com/pcm-dpc/COVID-19/master/dati-json/dpc-covid19-ita-andamento-nazionale-latest.json,83313057,96334975,170310,493476,0.7434263452377724,170310,493476,83313057,96334975
Italy,2022-02-12,180235677,180235677,587645,https://raw.githubusercontent.com/pcm-dpc/COVID-19/master/dati-json/dpc-covid19-ita-andamento-nazionale-latest.json,83484074,96751603,171017,416628,0.7089790604871989,171017,416628,83484074,96751603
Italy,2022-02-13,180698558,180698558,462881,https://raw.githubusercontent.com/pcm-dpc/COVID-19/master/dati-json/dpc-covid19-ita-andamento-nazionale-latest.json,83603062,97095496,118988,343893,0.7429404101702165,118988,343893,83603062,97095496
Italy,2022-02-14,180982449,180982449,283891,https://raw.githubusercontent.com/pcm-dpc/COVID-19/master/dati-json/dpc-covid19-ita-andamento-nazionale-latest.json,83677548,97304901,74486,209405,0.7376246517149188,74486,209405,83677548,97304901
Italy,2022-02-15,181678193,181678193,695744,https://raw.githubusercontent.com/pcm-dpc/COVID-19/master/dati-json/dpc-covid19-ita-andamento-nazionale-latest.json,83819169,97859024,141621,554123,0.796446681538037,141621,554123,83819169,97859024
Italy,2022-02-16,182233273,182233273,555080,https://raw.githubusercontent.com/pcm-dpc/COVID-19/master/dati-json/dpc-covid19-ita-andamento-nazionale-latest.json,83967772,98265501,148603,406477,0.7322854363335015,148603,406477,83967772,98265501
Italy,2022-02-17,182771404,182771404,538131,https://raw.githubusercontent.com/pcm-dpc/COVID-19/master/dati-json/dpc-covid19-ita-andamento-nazionale-latest.json,84100681,98670723,132909,405222,0.7530173879594374,132909,405222,84100681,98670723
Italy,2022-02-18,183281687,183281687,510283,https://raw.githubusercontent.com/pcm-dpc/COVID-19/master/dati-json/dpc-covid19-ita-andamento-nazionale-latest.json,84228399,99053288,127718,382565,0.7497114346352907,127718,382565,84228399,99053288
Italy,2022-02-19,183773732,183773732,492045,https://raw.githubusercontent.com/pcm-dpc/COVID-19/master/dati-json/dpc-covid19-ita-andamento-nazionale-latest.json,84351579,99422153,123180,368865,0.7496570435630887,123180,368865,84351579,99422153
Italy,2022-02-20,184146508,184146508,372776,https://raw.githubusercontent.com/pcm-dpc/COVID-19/master/dati-json/dpc-covid19-ita-andamento-nazionale-latest.json,84446773,99699735,95194,277582,0.7446348477369787,95194,277582,84446773,99699735
Italy,2022-02-21,184378274,184378274,231766,https://raw.githubusercontent.com/pcm-dpc/COVID-19/master/dati-json/dpc-covid19-ita-andamento-nazionale-latest.json,84507224,99871050,60451,171315,0.7391722685812414,60451,171315,84507224,99871050
Italy,2022-02-22,184981913,184981913,603639,https://raw.githubusercontent.com/pcm-dpc/COVID-19/master/dati-json/dpc-covid19-ita-andamento-nazionale-latest.json,84638245,100343668,131021,472618,0.7829480865219113,131021,472618,84638245,100343668
Italy,2022-02-23,185461360,185461360,479447,https://raw.githubusercontent.com/pcm-dpc/COVID-19/master/dati-json/dpc-covid19-ita-andamento-nazionale-latest.json,84774479,100686881,136234,343213,0.715851804266165,136234,343213,84774479,100686881
Italy,2022-02-24,185945890,185945890,484530,https://raw.githubusercontent.com/pcm-dpc/COVID-19/master/dati-json/dpc-covid19-ita-andamento-nazionale-latest.json,84894619,101051271,120140,364390,0.7520483767774957,120140,364390,84894619,101051271
Italy,2022-02-25,186386005,186386005,440115,https://raw.githubusercontent.com/pcm-dpc/COVID-19/master/dati-json/dpc-covid19-ita-andamento-nazionale-latest.json,85013268,101372737,118649,321466,0.7304136418890518,118649,321466,85013268,101372737
Italy,2022-02-26,186820082,186820082,434077,https://raw.githubusercontent.com/pcm-dpc/COVID-19/master/dati-json/dpc-covid19-ita-andamento-nazionale-latest.json,85121863,101698219,108595,325482,0.749825491790627,108595,325482,85121863,101698219
Italy,2022-02-27,187137866,187137866,317784,https://raw.githubusercontent.com/pcm-dpc/COVID-19/master/dati-json/dpc-covid19-ita-andamento-nazionale-latest.json,85200886,101936980,79023,238761,0.751331092817763,79023,238761,85200886,101936980
Italy,2022-02-28,187336379,187336379,198513,https://raw.githubusercontent.com/pcm-dpc/COVID-19/master/dati-json/dpc-covid19-ita-andamento-nazionale-latest.json,85251765,102084614,50879,147634,0.7436994050767456,50879,147634,85251765,102084614
Italy,2022-03-01,187867237,187867237,530858,https://raw.githubusercontent.com/pcm-dpc/COVID-19/master/dati-json/dpc-covid19-ita-andamento-nazionale-latest.json,85369378,102497859,117613,413245,0.778447343734106,117613,413245,85369378,102497859
Italy,2022-03-02,188282525,188282525,415288,https://raw.githubusercontent.com/pcm-dpc/COVID-19/master/dati-json/dpc-covid19-ita-andamento-nazionale-latest.json,85487020,102795505,117642,297646,0.7167218893876057,117642,297646,85487020,102795505
Italy,2022-03-03,188713837,188713837,431312,https://raw.githubusercontent.com/pcm-dpc/COVID-19/master/dati-json/dpc-covid19-ita-andamento-nazionale-latest.json,85590680,103123157,103660,327652,0.7596635382275476,103660,327652,85590680,103123157
Italy,2022-03-04,189102673,189102673,388836,https://raw.githubusercontent.com/pcm-dpc/COVID-19/master/dati-json/dpc-covid19-ita-andamento-nazionale-latest.json,85693793,103408880,103113,285723,0.7348162207203037,103113,285723,85693793,103408880
Italy,2022-03-05,189484157,189484157,381484,https://raw.githubusercontent.com/pcm-dpc/COVID-19/master/dati-json/dpc-covid19-ita-andamento-nazionale-latest.json,85787000,103697157,93207,288277,0.7556725839091548,93207,288277,85787000,103697157
Italy,2022-03-06,189780403,189780403,296246,https://raw.githubusercontent.com/pcm-dpc/COVID-19/master/dati-json/dpc-covid19-ita-andamento-nazionale-latest.json,85859150,103921253,72150,224096,0.7564524077962234,72150,224096,85859150,103921253
Italy,2022-03-07,189968677,189968677,188274,https://raw.githubusercontent.com/pcm-dpc/COVID-19/master/dati-json/dpc-covid19-ita-andamento-nazionale-latest.json,85904001,104064676,44851,143423,0.7617780468891084,44851,143423,85904001,104064676
Italy,2022-03-08,190499871,190499871,531194,https://raw.githubusercontent.com/pcm-dpc/COVID-19/master/dati-json/dpc-covid19-ita-andamento-nazionale-latest.json,86022321,104477550,118320,412874,0.7772565202167193,118320,412874,86022321,104477550
Italy,2022-03-09,190933832,190933832,433961,https://raw.githubusercontent.com/pcm-dpc/COVID-19/master/dati-json/dpc-covid19-ita-andamento-nazionale-latest.json,86147575,104786257,125254,308707,0.7113703766006623,125254,308707,86147575,104786257
Italy,2022-03-10,191387173,191387173,453341,https://raw.githubusercontent.com/pcm-dpc/COVID-19/master/dati-json/dpc-covid19-ita-andamento-nazionale-latest.json,86253299,105133874,105724,347617,0.7667892381231788,105724,347617,86253299,105133874
Italy,2022-03-11,191812811,191812811,425638,https://raw.githubusercontent.com/pcm-dpc/COVID-19/master/dati-json/dpc-covid19-ita-andamento-nazionale-latest.json,86355379,105457432,102080,323558,0.7601717891729591,102080,323558,86355379,105457432
Italy,2022-03-12,192230588,192230588,417777,https://raw.githubusercontent.com/pcm-dpc/COVID-19/master/dati-json/dpc-covid19-ita-andamento-nazionale-latest.json,86453597,105776991,98218,319559,0.7649032857242022,98218,319559,86453597,105776991
Italy,2022-03-13,192560616,192560616,330028,https://raw.githubusercontent.com/pcm-dpc/COVID-19/master/dati-json/dpc-covid19-ita-andamento-nazionale-latest.json,86531713,106028903,78116,251912,0.7633049317027646,78116,251912,86531713,106028903
Italy,2022-03-14,192765493,192765493,204877,https://raw.githubusercontent.com/pcm-dpc/COVID-19/master/dati-json/dpc-covid19-ita-andamento-nazionale-latest.json,86576281,106189212,44568,160309,0.7824646007116465,44568,160309,86576281,106189212
Italy,2022-03-15,193352508,193352508,587015,https://raw.githubusercontent.com/pcm-dpc/COVID-19/master/dati-json/dpc-covid19-ita-andamento-nazionale-latest.json,86698487,106654021,122206,464809,0.7918179262880847,122206,464809,86698487,106654021
Italy,2022-03-16,193843219,193843219,490711,https://raw.githubusercontent.com/pcm-dpc/COVID-19/master/dati-json/dpc-covid19-ita-andamento-nazionale-latest.json,86821819,107021400,123332,367379,0.748666730519593,123332,367379,86821819,107021400
Italy,2022-03-17,194373101,194373101,529882,https://raw.githubusercontent.com/pcm-dpc/COVID-19/master/dati-json/dpc-covid19-ita-andamento-nazionale-latest.json,86936668,107436433,114849,415033,0.7832555172661083,114849,415033,86936668,107436433
Italy,2022-03-18,194863984,194863984,490883,https://raw.githubusercontent.com/pcm-dpc/COVID-19/master/dati-json/dpc-covid19-ita-andamento-nazionale-latest.json,87043832,107820152,107164,383719,0.7816913602630362,107164,383719,87043832,107820152
Italy,2022-03-19,195342035,195342035,478051,https://raw.githubusercontent.com/pcm-dpc/COVID-19/master/dati-json/dpc-covid19-ita-andamento-nazionale-latest.json,87147082,108194953,103250,374801,0.7840188599124361,103250,374801,87147082,108194953
Italy,2022-03-20,195712501,195712501,370466,https://raw.githubusercontent.com/pcm-dpc/COVID-19/master/dati-json/dpc-covid19-ita-andamento-nazionale-latest.json,87228523,108483978,81441,289025,0.780166061123018,81441,289025,87228523,108483978
Italy,2022-03-21,195930717,195930717,218216,https://raw.githubusercontent.com/pcm-dpc/COVID-19/master/dati-json/dpc-covid19-ita-andamento-nazionale-latest.json,87278454,108652263,49931,168285,0.7711854309491513,49931,168285,87278454,108652263
Italy,2022-03-22,196572613,196572613,641896,https://raw.githubusercontent.com/pcm-dpc/COVID-19/master/dati-json/dpc-covid19-ita-andamento-nazionale-latest.json,87396186,109176427,117732,524164,0.8165871106845969,117732,524164,87396186,109176427
Italy,2022-03-23,197086357,197086357,513744,https://raw.githubusercontent.com/pcm-dpc/COVID-19/master/dati-json/dpc-covid19-ita-andamento-nazionale-latest.json,87518600,109567757,122414,391330,0.7617217913980504,122414,391330,87518600,109567757
Italy,2022-03-24,197631659,197631659,545302,https://raw.githubusercontent.com/pcm-dpc/COVID-19/master/dati-json/dpc-covid19-ita-andamento-nazionale-latest.json,87632631,109999028,114031,431271,0.7908846840833152,114031,431271,87632631,109999028
Italy,2022-03-25,198135632,198135632,503973,https://raw.githubusercontent.com/pcm-dpc/COVID-19/master/dati-json/dpc-covid19-ita-andamento-nazionale-latest.json,87742645,110392987,110014,393959,0.7817065596768081,110014,393959,87742645,110392987
Italy,2022-03-26,198639817,198639817,504185,https://raw.githubusercontent.com/pcm-dpc/COVID-19/master/dati-json/dpc-covid19-ita-andamento-nazionale-latest.json,87844207,110795610,101562,402623,0.7985620357606831,101562,402623,87844207,110795610
Italy,2022-03-27,199024140,199024140,384323,https://raw.githubusercontent.com/pcm-dpc/COVID-19/master/dati-json/dpc-covid19-ita-andamento-nazionale-latest.json,87924008,111100132,79801,304522,0.7923595517312261,79801,304522,87924008,111100132
Italy,2022-03-28,199235675,199235675,211535,https://raw.githubusercontent.com/pcm-dpc/COVID-19/master/dati-json/dpc-covid19-ita-andamento-nazionale-latest.json,87968303,111267372,44295,167240,0.790602028033186,44295,167240,87968303,111267372
Italy,2022-03-29,199896383,199896383,660708,https://raw.githubusercontent.com/pcm-dpc/COVID-19/master/dati-json/dpc-covid19-ita-andamento-nazionale-latest.json,88093392,111802991,125089,535619,0.8106743069555689,125089,535619,88093392,111802991
Italy,2022-03-30,200421282,200421282,524899,https://raw.githubusercontent.com/pcm-dpc/COVID-19/master/dati-json/dpc-covid19-ita-andamento-nazionale-latest.json,88213039,112208243,119647,405252,0.7720571005088598,119647,405252,88213039,112208243
Italy,2022-03-31,200908095,200908095,486813,https://raw.githubusercontent.com/pcm-dpc/COVID-19/master/dati-json/dpc-covid19-ita-andamento-nazionale-latest.json,88316604,112591491,103565,383248,0.7872591734403148,103565,383248,88316604,112591491
Italy,2022-04-01,201422918,201422918,514823,https://raw.githubusercontent.com/pcm-dpc/COVID-19/master/dati-json/dpc-covid19-ita-andamento-nazionale-latest.json,88424024,112998894,107420,407403,0.791345763495415,107420,407403,88424024,112998894
Italy,2022-04-02,201899959,201899959,477041,https://raw.githubusercontent.com/pcm-dpc/COVID-19/master/dati-json/dpc-covid19-ita-andamento-nazionale-latest.json,88522226,113377733,98202,378839,0.794143480329783,98202,378839,88522226,113377733
Italy,2022-04-03,202264141,202264141,364182,https://raw.githubusercontent.com/pcm-dpc/COVID-19/master/dati-json/dpc-covid19-ita-andamento-nazionale-latest.json,88596224,113667917,73998,290184,0.7968103860157834,73998,290184,88596224,113667917
Italy,2022-04-04,203647359,203647359,1383218,https://raw.githubusercontent.com/pcm-dpc/COVID-19/master/dati-json/dpc-covid19-ita-andamento-nazionale-latest.json,88644333,115003026,48109,1335109,0.9652195098675697,48109,1335109,88644333,115003026
Italy,2022-04-05,204235935,204235935,588576,https://raw.githubusercontent.com/pcm-dpc/COVID-19/master/dati-json/dpc-covid19-ita-andamento-nazionale-latest.json,88747785,115488150,103452,485124,0.824233404012396,103452,485124,88747785,115488150
Italy,2022-04-06,204697383,204697383,461448,https://raw.githubusercontent.com/pcm-dpc/COVID-19/master/dati-json/dpc-covid19-ita-andamento-nazionale-latest.json,88855028,115842355,107243,354205,0.767594615211248,107243,354205,88855028,115842355
Italy,2022-04-07,205167186,205167186,469803,https://raw.githubusercontent.com/pcm-dpc/COVID-19/master/dati-json/dpc-covid19-ita-andamento-nazionale-latest.json,88952864,116214322,97836,371967,0.7917510105299456,97836,371967,88952864,116214322
Italy,2022-04-08,205609215,205609215,442029,https://raw.githubusercontent.com/pcm-dpc/COVID-19/master/dati-json/dpc-covid19-ita-andamento-nazionale-latest.json,89045428,116563787,92564,349465,0.7905929248985927,92564,349465,89045428,116563787
Italy,2022-04-09,206047664,206047664,438449,https://raw.githubusercontent.com/pcm-dpc/COVID-19/master/dati-json/dpc-covid19-ita-andamento-nazionale-latest.json,89134714,116912950,89286,349163,0.7963594397524,89286,349163,89134714,116912950
Italy,2022-04-10,206399929,206399929,352265,https://raw.githubusercontent.com/pcm-dpc/COVID-19/master/dati-json/dpc-covid19-ita-andamento-nazionale-latest.json,89202927,117197002,68213,284052,0.8063588491618526,68213,284052,89202927,117197002
Italy,2022-04-11,206592711,206592711,192782,https://raw.githubusercontent.com/pcm-dpc/COVID-19/master/dati-json/dpc-covid19-ita-andamento-nazionale-latest.json,89245718,117346993,42791,149991,0.7780342563102365,42791,149991,89245718,117346993
Italy,2022-04-12,207155729,207155729,563018,https://raw.githubusercontent.com/pcm-dpc/COVID-19/master/dati-json/dpc-covid19-ita-andamento-nazionale-latest.json,89344598,117811131,98880,464138,0.8243750643851528,98880,464138,89344598,117811131
Italy,2022-04-13,207575724,207575724,419995,https://raw.githubusercontent.com/pcm-dpc/COVID-19/master/dati-json/dpc-covid19-ita-andamento-nazionale-latest.json,89441567,118134157,96969,323026,0.7691186799842855,96969,323026,89441567,118134157
Italy,2022-04-14,208014099,208014099,438375,https://raw.githubusercontent.com/pcm-dpc/COVID-19/master/dati-json/dpc-covid19-ita-andamento-nazionale-latest.json,89531077,118483022,89510,348865,0.7958140861134874,89510,348865,89531077,118483022
Italy,2022-04-15,208411581,208411581,397482,https://raw.githubusercontent.com/pcm-dpc/COVID-19/master/dati-json/dpc-covid19-ita-andamento-nazionale-latest.json,89612318,118799263,81241,316241,0.7956108704293527,81241,316241,89612318,118799263
Italy,2022-04-16,208836063,208836063,424482,https://raw.githubusercontent.com/pcm-dpc/COVID-19/master/dati-json/dpc-covid19-ita-andamento-nazionale-latest.json,89688494,119147569,76176,348306,0.8205436272916166,76176,348306,89688494,119147569
Italy,2022-04-17,209170287,209170287,334224,https://raw.githubusercontent.com/pcm-dpc/COVID-19/master/dati-json/dpc-covid19-ita-andamento-nazionale-latest.json,89742963,119427324,54469,279755,0.8370284599550002,54469,279755,89742963,119427324
Italy,2022-04-18,209276026,209276026,105739,https://raw.githubusercontent.com/pcm-dpc/COVID-19/master/dati-json/dpc-covid19-ita-andamento-nazionale-latest.json,89769631,119506395,26668,79071,0.7477940967854813,26668,79071,89769631,119506395
Italy,2022-04-19,209450124,209450124,174098,https://raw.githubusercontent.com/pcm-dpc/COVID-19/master/dati-json/dpc-covid19-ita-andamento-nazionale-latest.json,89804639,119645485,35008,139090,0.7989178508656044,35008,139090,89804639,119645485
Italy,2022-04-20,210060724,210060724,610600,https://raw.githubusercontent.com/pcm-dpc/COVID-19/master/dati-json/dpc-covid19-ita-andamento-nazionale-latest.json,89900944,120159780,96305,514295,0.8422780871274157,96305,514295,89900944,120159780
Italy,2022-04-21,210506904,210506904,446180,https://raw.githubusercontent.com/pcm-dpc/COVID-19/master/dati-json/dpc-covid19-ita-andamento-nazionale-latest.json,89995782,120511122,94838,351342,0.7874445291138106,94838,351342,89995782,120511122
Italy,2022-04-22,210944097,210944097,437193,https://raw.githubusercontent.com/pcm-dpc/COVID-19/master/dati-json/dpc-covid19-ita-andamento-nazionale-latest.json,90082691,120861406,86909,350284,0.801211364317361,86909,350284,90082691,120861406
Italy,2022-04-23,211365630,211365630,421533,https://raw.githubusercontent.com/pcm-dpc/COVID-19/master/dati-json/dpc-covid19-ita-andamento-nazionale-latest.json,90159321,121206309,76630,344903,0.8182111483561192,76630,344903,90159321,121206309
Italy,2022-04-24,211691841,211691841,326211,https://raw.githubusercontent.com/pcm-dpc/COVID-19/master/dati-json/dpc-covid19-ita-andamento-nazionale-latest.json,90215117,121476724,55796,270415,0.828957331297841,55796,270415,90215117,121476724
Italy,2022-04-25,211830644,211830644,138803,https://raw.githubusercontent.com/pcm-dpc/COVID-19/master/dati-json/dpc-covid19-ita-andamento-nazionale-latest.json,90247206,121583438,32089,106714,0.7688162359603179,32089,106714,90247206,121583438
Italy,2022-04-26,212013319,212013319,182675,https://raw.githubusercontent.com/pcm-dpc/COVID-19/master/dati-json/dpc-covid19-ita-andamento-nazionale-latest.json,90282688,121730631,35482,147193,0.8057643355686328,35482,147193,90282688,121730631
Italy,2022-04-27,212567845,212567845,554526,https://raw.githubusercontent.com/pcm-dpc/COVID-19/master/dati-json/dpc-covid19-ita-andamento-nazionale-latest.json,90368487,122199358,85799,468727,0.8452750637481381,85799,468727,90368487,122199358
Italy,2022-04-28,213009371,213009371,441526,https://raw.githubusercontent.com/pcm-dpc/COVID-19/master/dati-json/dpc-covid19-ita-andamento-nazionale-latest.json,90466187,122543184,97700,343826,0.7787219778676681,97700,343826,90466187,122543184
Italy,2022-04-29,213390610,213390610,381239,https://raw.githubusercontent.com/pcm-dpc/COVID-19/master/dati-json/dpc-covid19-ita-andamento-nazionale-latest.json,90543721,122846889,77534,303705,0.7966262633151383,77534,303705,90543721,122846889
Italy,2022-04-30,213773683,213773683,383073,https://raw.githubusercontent.com/pcm-dpc/COVID-19/master/dati-json/dpc-covid19-ita-andamento-nazionale-latest.json,90618779,123154904,75058,308015,0.804063455268317,75058,308015,90618779,123154904
Italy,2022-05-01,214061284,214061284,287601,https://raw.githubusercontent.com/pcm-dpc/COVID-19/master/dati-json/dpc-covid19-ita-andamento-nazionale-latest.json,90676581,123384703,57802,229799,0.7990201703053884,57802,229799,90676581,123384703
Italy,2022-05-02,214183728,214183728,122444,https://raw.githubusercontent.com/pcm-dpc/COVID-19/master/dati-json/dpc-covid19-ita-andamento-nazionale-latest.json,90706673,123477055,30092,92352,0.7542386723726765,30092,92352,90706673,123477055
Italy,2022-05-03,214594775,214594775,411047,https://raw.githubusercontent.com/pcm-dpc/COVID-19/master/dati-json/dpc-covid19-ita-andamento-nazionale-latest.json,90787032,123807743,80359,330688,0.8045016749909377,80359,330688,90787032,123807743
Italy,2022-05-04,214930050,214930050,335275,https://raw.githubusercontent.com/pcm-dpc/COVID-19/master/dati-json/dpc-covid19-ita-andamento-nazionale-latest.json,90871121,124058929,84089,251186,0.7491939452688092,84089,251186,90871121,124058929
Italy,2022-05-05,215257228,215257228,327178,https://raw.githubusercontent.com/pcm-dpc/COVID-19/master/dati-json/dpc-covid19-ita-andamento-nazionale-latest.json,90946644,124310584,75523,251655,0.7691684648723325,75523,251655,90946644,124310584
Italy,2022-05-06,215559634,215559634,302406,https://raw.githubusercontent.com/pcm-dpc/COVID-19/master/dati-json/dpc-covid19-ita-andamento-nazionale-latest.json,91018122,124541512,71478,230928,0.7636356421499574,71478,230928,91018122,124541512
Italy,2022-05-07,215865197,215865197,305563,https://raw.githubusercontent.com/pcm-dpc/COVID-19/master/dati-json/dpc-covid19-ita-andamento-nazionale-latest.json,91086905,124778292,68783,236780,0.7748974843158367,68783,236780,91086905,124778292
Italy,2022-05-08,216068651,216068651,203454,https://raw.githubusercontent.com/pcm-dpc/COVID-19/master/dati-json/dpc-covid19-ita-andamento-nazionale-latest.json,91136795,124931856,49890,153564,0.7547848653749742,49890,153564,91136795,124931856
Italy,2022-05-09,216195210,216195210,126559,https://raw.githubusercontent.com/pcm-dpc/COVID-19/master/dati-json/dpc-covid19-ita-andamento-nazionale-latest.json,91165415,125029795,28620,97939,0.7738604129299378,28620,97939,91165415,125029795
Italy,2022-05-10,216566431,216566431,371221,https://raw.githubusercontent.com/pcm-dpc/COVID-19/master/dati-json/dpc-covid19-ita-andamento-nazionale-latest.json,91239041,125327390,73626,297595,0.8016653152704184,73626,297595,91239041,125327390
Italy,2022-05-11,216861042,216861042,294611,https://raw.githubusercontent.com/pcm-dpc/COVID-19/master/dati-json/dpc-covid19-ita-andamento-nazionale-latest.json,91316605,125544437,77564,217047,0.7367240191303108,77564,217047,91316605,125544437
Italy,2022-05-12,217129696,217129696,268654,https://raw.githubusercontent.com/pcm-dpc/COVID-19/master/dati-json/dpc-covid19-ita-andamento-nazionale-latest.json,91387900,125741796,71295,197359,0.7346214833949988,71295,197359,91387900,125741796
Italy,2022-05-13,217395343,217395343,265647,https://raw.githubusercontent.com/pcm-dpc/COVID-19/master/dati-json/dpc-covid19-ita-andamento-nazionale-latest.json,91450934,125944409,63034,202613,0.7627151821778526,63034,202613,91450934,125944409
Italy,2022-05-14,217659090,217659090,263747,https://raw.githubusercontent.com/pcm-dpc/COVID-19/master/dati-json/dpc-covid19-ita-andamento-nazionale-latest.json,91512742,126146348,61808,201939,0.765654206493344,61808,201939,91512742,126146348
Italy,2022-05-15,217853667,217853667,194577,https://raw.githubusercontent.com/pcm-dpc/COVID-19/master/dati-json/dpc-covid19-ita-andamento-nazionale-latest.json,91555528,126298139,42786,151791,0.7801076180637999,42786,151791,91555528,126298139
Italy,2022-05-16,217958460,217958460,104793,https://raw.githubusercontent.com/pcm-dpc/COVID-19/master/dati-json/dpc-covid19-ita-andamento-nazionale-latest.json,91583940,126374520,28412,76381,0.728875020278072,28412,76381,91583940,126374520
Italy,2022-05-17,218293677,218293677,335217,https://raw.githubusercontent.com/pcm-dpc/COVID-19/master/dati-json/dpc-covid19-ita-andamento-nazionale-latest.json,91655955,126637722,72015,263202,0.7851690099249143,72015,263202,91655955,126637722
Italy,2022-05-18,218557950,218557950,264273,https://raw.githubusercontent.com/pcm-dpc/COVID-19/master/dati-json/dpc-covid19-ita-andamento-nazionale-latest.json,91729417,126828533,73462,190811,0.722022302694562,73462,190811,91729417,126828533
Italy,2022-05-19,218805421,218805421,247471,https://raw.githubusercontent.com/pcm-dpc/COVID-19/master/dati-json/dpc-covid19-ita-andamento-nazionale-latest.json,91795532,127009889,66115,181356,0.7328373829660849,66115,181356,91795532,127009889
Italy,2022-05-20,219039166,219039166,233745,https://raw.githubusercontent.com/pcm-dpc/COVID-19/master/dati-json/dpc-covid19-ita-andamento-nazionale-latest.json,91853826,127185340,58294,175451,0.7506085691672549,58294,175451,91853826,127185340
Italy,2022-05-21,219271097,219271097,231931,https://raw.githubusercontent.com/pcm-dpc/COVID-19/master/dati-json/dpc-covid19-ita-andamento-nazionale-latest.json,91907917,127363180,54091,177840,0.7667797750192945,54091,177840,91907917,127363180
Italy,2022-05-22,219432092,219432092,160995,https://raw.githubusercontent.com/pcm-dpc/COVID-19/master/dati-json/dpc-covid19-ita-andamento-nazionale-latest.json,91947133,127484959,39216,121779,0.7564147954905431,39216,121779,91947133,127484959
Italy,2022-05-23,219525905,219525905,93813,https://raw.githubusercontent.com/pcm-dpc/COVID-19/master/dati-json/dpc-covid19-ita-andamento-nazionale-latest.json,91972260,127553645,25127,68686,0.7321586560498012,25127,68686,91972260,127553645
Italy,2022-05-24,219795876,219795876,269971,https://raw.githubusercontent.com/pcm-dpc/COVID-19/master/dati-json/dpc-covid19-ita-andamento-nazionale-latest.json,92027939,127767937,55679,214292,0.7937593297057832,55679,214292,92027939,127767937
Italy,2022-05-25,220034869,220034869,238993,https://raw.githubusercontent.com/pcm-dpc/COVID-19/master/dati-json/dpc-covid19-ita-andamento-nazionale-latest.json,92100016,127934853,72077,166916,0.6984137610725001,72077,166916,92100016,127934853
Italy,2022-05-26,220238476,220238476,203607,https://raw.githubusercontent.com/pcm-dpc/COVID-19/master/dati-json/dpc-covid19-ita-andamento-nazionale-latest.json,92149953,128088523,49937,153670,0.7547382948523381,49937,153670,92149953,128088523
Italy,2022-05-27,220450754,220450754,212278,https://raw.githubusercontent.com/pcm-dpc/COVID-19/master/dati-json/dpc-covid19-ita-andamento-nazionale-latest.json,92206777,128243977,56824,155454,0.732313287293078,56824,155454,92206777,128243977
Italy,2022-05-28,220643937,220643937,193183,https://raw.githubusercontent.com/pcm-dpc/COVID-19/master/dati-json/dpc-covid19-ita-andamento-nazionale-latest.json,92253870,128390067,47093,146090,0.7562259619117624,47093,146090,92253870,128390067
Italy,2022-05-29,220786003,220786003,142066,https://raw.githubusercontent.com/pcm-dpc/COVID-19/master/dati-json/dpc-covid19-ita-andamento-nazionale-latest.json,92290042,128495961,36172,105894,0.7453859473765715,36172,105894,92290042,128495961
Italy,2022-05-30,220866180,220866180,80177,https://raw.githubusercontent.com/pcm-dpc/COVID-19/master/dati-json/dpc-covid19-ita-andamento-nazionale-latest.json,92311740,128554440,21698,58479,0.7293737605547725,21698,58479,92311740,128554440
Italy,2022-05-31,221108240,221108240,242060,https://raw.githubusercontent.com/pcm-dpc/COVID-19/master/dati-json/dpc-covid19-ita-andamento-nazionale-latest.json,92371211,128737029,59471,182589,0.7543129802528299,59471,182589,92371211,128737029
Italy,2022-06-01,221300348,221300348,192108,https://raw.githubusercontent.com/pcm-dpc/COVID-19/master/dati-json/dpc-covid19-ita-andamento-nazionale-latest.json,92423753,128876595,52542,139566,0.7264975951027547,52542,139566,92423753,128876595
Italy,2022-06-02,221481403,221481403,181055,https://raw.githubusercontent.com/pcm-dpc/COVID-19/master/dati-json/dpc-covid19-ita-andamento-nazionale-latest.json,92471149,129010254,47396,133659,0.7382231918477811,47396,133659,92471149,129010254
Italy,2022-06-03,221552092,221552092,70689,https://raw.githubusercontent.com/pcm-dpc/COVID-19/master/dati-json/dpc-covid19-ita-andamento-nazionale-latest.json,92494086,129058006,22937,47752,0.675522358499908,22937,47752,92494086,129058006
Italy,2022-06-04,221741088,221741088,188996,https://raw.githubusercontent.com/pcm-dpc/COVID-19/master/dati-json/dpc-covid19-ita-andamento-nazionale-latest.json,92535215,129205873,41129,147867,0.7823816377066182,41129,147867,92535215,129205873
Italy,2022-06-05,221864787,221864787,123699,https://raw.githubusercontent.com/pcm-dpc/COVID-19/master/dati-json/dpc-covid19-ita-andamento-nazionale-latest.json,92567523,129297264,32308,91391,0.7388176137236356,32308,91391,92567523,129297264
Italy,2022-06-06,221939797,221939797,75010,https://raw.githubusercontent.com/pcm-dpc/COVID-19/master/dati-json/dpc-covid19-ita-andamento-nazionale-latest.json,92587291,129352506,19768,55242,0.7364618050926544,19768,55242,92587291,129352506
Italy,2022-06-07,222173350,222173350,233553,https://raw.githubusercontent.com/pcm-dpc/COVID-19/master/dati-json/dpc-covid19-ita-andamento-nazionale-latest.json,92645605,129527745,58314,175239,0.7503179149914581,58314,175239,92645605,129527745
Italy,2022-06-08,222361374,222361374,188024,https://raw.githubusercontent.com/pcm-dpc/COVID-19/master/dati-json/dpc-covid19-ita-andamento-nazionale-latest.json,92699202,129662172,53597,134427,0.7149459643449773,53597,134427,92699202,129662172
Italy,2022-06-09,222540501,222540501,179127,https://raw.githubusercontent.com/pcm-dpc/COVID-19/master/dati-json/dpc-covid19-ita-andamento-nazionale-latest.json,92747106,129793395,47904,131223,0.7325696293691069,47904,131223,92747106,129793395
Italy,2022-06-10,222710598,222710598,170097,https://raw.githubusercontent.com/pcm-dpc/COVID-19/master/dati-json/dpc-covid19-ita-andamento-nazionale-latest.json,92787792,129922806,40686,129411,0.7608070689077409,40686,129411,92787792,129922806
Italy,2022-06-11,222897832,222897832,187234,https://raw.githubusercontent.com/pcm-dpc/COVID-19/master/dati-json/dpc-covid19-ita-andamento-nazionale-latest.json,92833283,130064549,45491,141743,0.7570366493265112,45491,141743,92833283,130064549
Italy,2022-06-12,223025536,223025536,127704,https://raw.githubusercontent.com/pcm-dpc/COVID-19/master/dati-json/dpc-covid19-ita-andamento-nazionale-latest.json,92865018,130160518,31735,95969,0.7514956461817954,31735,95969,92865018,130160518
Italy,2022-06-13,223100172,223100172,74636,https://raw.githubusercontent.com/pcm-dpc/COVID-19/master/dati-json/dpc-covid19-ita-andamento-nazionale-latest.json,92885212,130214960,20194,54442,0.7294335173374779,20194,54442,92885212,130214960
Italy,2022-06-14,223328731,223328731,228559,https://raw.githubusercontent.com/pcm-dpc/COVID-19/master/dati-json/dpc-covid19-ita-andamento-nazionale-latest.json,92934496,130394235,49284,179275,0.7843707751608994,49284,179275,92934496,130394235
Italy,2022-06-15,223524170,223524170,195439,https://raw.githubusercontent.com/pcm-dpc/COVID-19/master/dati-json/dpc-covid19-ita-andamento-nazionale-latest.json,92988285,130535885,53789,141650,0.724778575412277,53789,141650,92988285,130535885
Italy,2022-06-16,223718846,223718846,194676,https://raw.githubusercontent.com/pcm-dpc/COVID-19/master/dati-json/dpc-covid19-ita-andamento-nazionale-latest.json,93035871,130682975,47586,147090,0.7555630894409172,47586,147090,93035871,130682975
Italy,2022-06-17,223904665,223904665,185819,https://raw.githubusercontent.com/pcm-dpc/COVID-19/master/dati-json/dpc-covid19-ita-andamento-nazionale-latest.json,93078277,130826388,42406,143413,0.771788676077258,42406,143413,93078277,130826388
Italy,2022-06-18,224097705,224097705,193040,https://raw.githubusercontent.com/pcm-dpc/COVID-19/master/dati-json/dpc-covid19-ita-andamento-nazionale-latest.json,93120721,130976984,42444,150596,0.7801284707832573,42444,150596,93120721,130976984
Italy,2022-06-19,224257916,224257916,160211,https://raw.githubusercontent.com/pcm-dpc/COVID-19/master/dati-json/dpc-covid19-ita-andamento-nazionale-latest.json,93153019,131104897,32298,127913,0.7984033555748357,32298,127913,93153019,131104897
Italy,2022-06-20,224337291,224337291,79375,https://raw.githubusercontent.com/pcm-dpc/COVID-19/master/dati-json/dpc-covid19-ita-andamento-nazionale-latest.json,93173182,131164109,20163,59212,0.7459779527559055,20163,59212,93173182,131164109
Italy,2022-06-21,224629636,224629636,292345,https://raw.githubusercontent.com/pcm-dpc/COVID-19/master/dati-json/dpc-covid19-ita-andamento-nazionale-latest.json,93229808,131399828,56626,235719,0.806304195385589,56626,235719,93229808,131399828
Italy,2022-06-22,224876148,224876148,246512,https://raw.githubusercontent.com/pcm-dpc/COVID-19/master/dati-json/dpc-covid19-ita-andamento-nazionale-latest.json,93286010,131590138,56202,190310,0.7720110988511716,56202,190310,93286010,131590138
Italy,2022-06-23,225124190,225124190,248042,https://raw.githubusercontent.com/pcm-dpc/COVID-19/master/dati-json/dpc-covid19-ita-andamento-nazionale-latest.json,93338419,131785771,52409,195633,0.7887091702211723,52409,195633,93338419,131785771
Italy,2022-06-24,225362259,225362259,238069,https://raw.githubusercontent.com/pcm-dpc/COVID-19/master/dati-json/dpc-covid19-ita-andamento-nazionale-latest.json,93383754,131978505,45335,192734,0.8095720148360349,45335,192734,93383754,131978505
Italy,2022-06-25,225620715,225620715,258456,https://raw.githubusercontent.com/pcm-dpc/COVID-19/master/dati-json/dpc-covid19-ita-andamento-nazionale-latest.json,93435794,132184921,52040,206416,0.79865044727148915,52040,206416,93435794,132184921
Italy,2022-06-26,225812503,225812503,191788,https://raw.githubusercontent.com/pcm-dpc/COVID-19/master/dati-json/dpc-covid19-ita-andamento-nazionale-latest.json,93461450,132351053,25656,166132,0.8662272926356185,25656,166132,93461450,132351053
Italy,2022-06-27,225913462,225913462,100959,https://raw.githubusercontent.com/pcm-dpc/COVID-19/master/dati-json/dpc-covid19-ita-andamento-nazionale-latest.json,93481860,132431602,20410,80549,0.7978387266117929,20410,80549,93481860,132431602
Italy,2022-06-28,226243590,226243590,330128,https://raw.githubusercontent.com/pcm-dpc/COVID-19/master/dati-json/dpc-covid19-ita-andamento-nazionale-latest.json,93536981,132706609,55121,275007,0.8330314302331217,55121,275007,93536981,132706609
Italy,2022-06-29,226600800,226600800,357210,https://raw.githubusercontent.com/pcm-dpc/COVID-19/master/dati-json/dpc-covid19-ita-andamento-nazionale-latest.json,93600061,133000739,63080,294130,0.8234091990705747,63080,294130,93600061,133000739
Italy,2022-06-30,226896830,226896830,296030,https://raw.githubusercontent.com/pcm-dpc/COVID-19/master/dati-json/dpc-covid19-ita-andamento-nazionale-latest.json,93655643,133241187,55582,240448,0.8122420024997467,55582,240448,93655643,133241187
Italy,2022-07-01,227212870,227212870,316040,https://raw.githubusercontent.com/pcm-dpc/COVID-19/master/dati-json/dpc-covid19-ita-andamento-nazionale-latest.json,93706988,133505882,51345,264695,0.8375363877990127,51345,264695,93706988,133505882
Italy,2022-07-02,227538458,227538458,325588,https://raw.githubusercontent.com/pcm-dpc/COVID-19/master/dati-json/dpc-covid19-ita-andamento-nazionale-latest.json,93755948,133782510,48960,276628,0.8496259075887318,48960,276628,93755948,133782510
Italy,2022-07-03,227801015,227801015,262557,https://raw.githubusercontent.com/pcm-dpc/COVID-19/master/dati-json/dpc-covid19-ita-andamento-nazionale-latest.json,93794877,134006138,38929,223628,0.8517312431205415,38929,223628,93794877,134006138
Italy,2022-07-04,227930923,227930923,129908,https://raw.githubusercontent.com/pcm-dpc/COVID-19/master/dati-json/dpc-covid19-ita-andamento-nazionale-latest.json,93815731,134115192,20854,109054,0.8394710102534101,20854,109054,93815731,134115192
Italy,2022-07-05,228395655,228395655,464732,https://raw.githubusercontent.com/pcm-dpc/COVID-19/master/dati-json/dpc-covid19-ita-andamento-nazionale-latest.json,93878876,134516779,63145,401587,0.8641259908936764,63145,401587,93878876,134516779
Italy,2022-07-06,228775690,228775690,380035,https://raw.githubusercontent.com/pcm-dpc/COVID-19/master/dati-json/dpc-covid19-ita-andamento-nazionale-latest.json,93945315,134830375,66439,313596,0.8251766284684305,66439,313596,93945315,134830375
Italy,2022-07-07,229153940,229153940,378250,https://raw.githubusercontent.com/pcm-dpc/COVID-19/master/dati-json/dpc-covid19-ita-andamento-nazionale-latest.json,94003025,135150915,57710,320540,0.847428949107733,57710,320540,94003025,135150915
Italy,2022-07-08,229525814,229525814,371874,https://raw.githubusercontent.com/pcm-dpc/COVID-19/master/dati-json/dpc-covid19-ita-andamento-nazionale-latest.json,94056662,135469152,53637,318237,0.8557656625631263,53637,318237,94056662,135469152
Italy,2022-07-09,229915390,229915390,389576,https://raw.githubusercontent.com/pcm-dpc/COVID-19/master/dati-json/dpc-covid19-ita-andamento-nazionale-latest.json,94108964,135806426,52302,337274,0.8657463498778158,52302,337274,94108964,135806426
Italy,2022-07-10,230219238,230219238,303848,https://raw.githubusercontent.com/pcm-dpc/COVID-19/master/dati-json/dpc-covid19-ita-andamento-nazionale-latest.json,94147779,136071459,38815,265033,0.8722552065506437,38815,265033,94147779,136071459
Italy,2022-07-11,230407391,230407391,188153,https://raw.githubusercontent.com/pcm-dpc/COVID-19/master/dati-json/dpc-covid19-ita-andamento-nazionale-latest.json,94169690,136237701,21911,166242,0.8835469006606326,21911,166242,94169690,136237701
Italy,2022-07-12,230958097,230958097,550706,https://raw.githubusercontent.com/pcm-dpc/COVID-19/master/dati-json/dpc-covid19-ita-andamento-nazionale-latest.json,94235906,136722191,66216,484490,0.8797616150904475,66216,484490,94235906,136722191
Italy,2022-07-13,231368532,231368532,410435,https://raw.githubusercontent.com/pcm-dpc/COVID-19/master/dati-json/dpc-covid19-ita-andamento-nazionale-latest.json,94299833,137068699,63927,346508,0.8442457392766212,63927,346508,94299833,137068699
Italy,2022-07-14,231776628,231776628,408096,https://raw.githubusercontent.com/pcm-dpc/COVID-19/master/dati-json/dpc-covid19-ita-andamento-nazionale-latest.json,94358940,137417688,59107,348989,0.8551639810240728,59107,348989,94358940,137417688
Italy,2022-07-15,232167636,232167636,391008,https://raw.githubusercontent.com/pcm-dpc/COVID-19/master/dati-json/dpc-covid19-ita-andamento-nazionale-latest.json,94411447,137756189,52507,338501,0.8657137449873148,52507,338501,94411447,137756189
Italy,2022-07-16,232565974,232565974,398338,https://raw.githubusercontent.com/pcm-dpc/COVID-19/master/dati-json/dpc-covid19-ita-andamento-nazionale-latest.json,94464501,138101473,53054,345284,0.8668116022071708,53054,345284,94464501,138101473
Italy,2022-07-17,232863728,232863728,297754,https://raw.githubusercontent.com/pcm-dpc/COVID-19/master/dati-json/dpc-covid19-ita-andamento-nazionale-latest.json,94501204,138362524,36703,261051,0.8767338138194617,36703,261051,94501204,138362524
Italy,2022-07-18,232999370,232999370,135642,https://raw.githubusercontent.com/pcm-dpc/COVID-19/master/dati-json/dpc-covid19-ita-andamento-nazionale-latest.json,94523918,138475452,22714,112928,0.8325444921189602,22714,112928,94523918,138475452
Italy,2022-07-19,233518654,233518654,519284,https://raw.githubusercontent.com/pcm-dpc/COVID-19/master/dati-json/dpc-covid19-ita-andamento-nazionale-latest.json,94586321,138932333,62403,456881,0.879828764221505,62403,456881,94586321,138932333
Italy,2022-07-20,233898775,233898775,380121,https://raw.githubusercontent.com/pcm-dpc/COVID-19/master/dati-json/dpc-covid19-ita-andamento-nazionale-latest.json,94649064,139249711,62743,317378,0.8349394008749845,62743,317378,94649064,139249711
Italy,2022-07-21,234264775,234264775,366000,https://raw.githubusercontent.com/pcm-dpc/COVID-19/master/dati-json/dpc-covid19-ita-andamento-nazionale-latest.json,94706008,139558767,56944,309056,0.8444153005464481,56944,309056,94706008,139558767
Italy,2022-07-22,234605966,234605966,341191,https://raw.githubusercontent.com/pcm-dpc/COVID-19/master/dati-json/dpc-covid19-ita-andamento-nazionale-latest.json,94753661,139852305,47653,293538,0.8603333616654602,47653,293538,94753661,139852305
Italy,2022-07-23,234956596,234956596,350630,https://raw.githubusercontent.com/pcm-dpc/COVID-19/master/dati-json/dpc-covid19-ita-andamento-nazionale-latest.json,94801846,140154750,48185,302445,0.8625759347460286,48185,302445,94801846,140154750
Italy,2022-07-24,235218628,235218628,262032,https://raw.githubusercontent.com/pcm-dpc/COVID-19/master/dati-json/dpc-covid19-ita-andamento-nazionale-latest.json,94839457,140379171,37611,224421,0.8564640959882762,37611,224421,94839457,140379171
Italy,2022-07-25,235341178,235341178,122550,https://raw.githubusercontent.com/pcm-dpc/COVID-19/master/dati-json/dpc-covid19-ita-andamento-nazionale-latest.json,94860765,140480413,21308,101242,0.8261281109751122,21308,101242,94860765,140480413
Italy,2022-07-26,235787896,235787896,446718,https://raw.githubusercontent.com/pcm-dpc/COVID-19/master/dati-json/dpc-covid19-ita-andamento-nazionale-latest.json,94921201,140866695,60436,386282,0.8647110705187613,60436,386282,94921201,140866695
Italy,2022-07-27,236105616,236105616,317720,https://raw.githubusercontent.com/pcm-dpc/COVID-19/master/dati-json/dpc-covid19-ita-andamento-nazionale-latest.json,94974912,141130704,53711,264009,0.8309486340173737,53711,264009,94974912,141130704
Italy,2022-07-28,236401920,236401920,296304,https://raw.githubusercontent.com/pcm-dpc/COVID-19/master/dati-json/dpc-covid19-ita-andamento-nazionale-latest.json,95022792,141379128,47880,248424,0.8384092013607646,47880,248424,95022792,141379128
Italy,2022-07-29,236683578,236683578,281658,https://raw.githubusercontent.com/pcm-dpc/COVID-19/master/dati-json/dpc-covid19-ita-andamento-nazionale-latest.json,95066728,141616850,43936,237722,0.8440094014727081,43936,237722,95066728,141616850
Italy,2022-07-30,236973591,236973591,290013,https://raw.githubusercontent.com/pcm-dpc/COVID-19/master/dati-json/dpc-covid19-ita-andamento-nazionale-latest.json,95110313,141863278,43585,246428,0.849713633526773,43585,246428,95110313,141863278
Italy,2022-07-31,237178494,237178494,204903,https://raw.githubusercontent.com/pcm-dpc/COVID-19/master/dati-json/dpc-covid19-ita-andamento-nazionale-latest.json,95139824,142038670,29511,175392,0.8559757543813414,29511,175392,95139824,142038670
Italy,2022-08-01,237284333,237284333,105839,https://raw.githubusercontent.com/pcm-dpc/COVID-19/master/dati-json/dpc-covid19-ita-andamento-nazionale-latest.json,95159112,142125221,19288,86551,0.81776093878438,19288,86551,95159112,142125221
Italy,2022-08-02,237638764,237638764,354431,https://raw.githubusercontent.com/pcm-dpc/COVID-19/master/dati-json/dpc-covid19-ita-andamento-nazionale-latest.json,95210767,142427997,51655,302776,0.8542593621889734,51655,302776,95210767,142427997
Italy,2022-08-03,237894561,237894561,255797,https://raw.githubusercontent.com/pcm-dpc/COVID-19/master/dati-json/dpc-covid19-ita-andamento-nazionale-latest.json,95259468,142635093,48701,207096,0.809610746021259,48701,207096,95259468,142635093
Italy,2022-08-04,238136571,238136571,242010,https://raw.githubusercontent.com/pcm-dpc/COVID-19/master/dati-json/dpc-covid19-ita-andamento-nazionale-latest.json,95301751,142834820,42283,199727,0.8252840791702822,42283,199727,95301751,142834820
Italy,2022-08-05,238360423,238360423,223852,https://raw.githubusercontent.com/pcm-dpc/COVID-19/master/dati-json/dpc-covid19-ita-andamento-nazionale-latest.json,95338709,143021714,36958,186894,0.8348998445401425,36958,186894,95338709,143021714
Italy,2022-08-06,238589603,238589603,229180,https://raw.githubusercontent.com/pcm-dpc/COVID-19/master/dati-json/dpc-covid19-ita-andamento-nazionale-latest.json,95374288,143215315,35579,193601,0.8447552142420804,35579,193601,95374288,143215315
Italy,2022-08-07,238756084,238756084,166481,https://raw.githubusercontent.com/pcm-dpc/COVID-19/master/dati-json/dpc-covid19-ita-andamento-nazionale-latest.json,95400809,143355275,26521,139960,0.8406965359410383,26521,139960,95400809,143355275
Italy,2022-08-08,238831686,238831686,75602,https://raw.githubusercontent.com/pcm-dpc/COVID-19/master/dati-json/dpc-covid19-ita-andamento-nazionale-latest.json,95416245,143415441,15436,60166,0.7958255072617126,15436,60166,95416245,143415441
Italy,2022-08-09,239104181,239104181,272495,https://raw.githubusercontent.com/pcm-dpc/COVID-19/master/dati-json/dpc-covid19-ita-andamento-nazionale-latest.json,95458194,143645987,41949,230546,0.8460558909337786,41949,230546,95458194,143645987
Italy,2022-08-10,239305690,239305690,201509,https://raw.githubusercontent.com/pcm-dpc/COVID-19/master/dati-json/dpc-covid19-ita-andamento-nazionale-latest.json,95498856,143806834,40662,160847,0.7982124867871907,40662,160847,95498856,143806834
Italy,2022-08-11,239494831,239494831,189141,https://raw.githubusercontent.com/pcm-dpc/COVID-19/master/dati-json/dpc-covid19-ita-andamento-nazionale-latest.json,95534395,143960436,35539,153602,0.8121031399855134,35539,153602,95534395,143960436
Italy,2022-08-12,239672650,239672650,177819,https://raw.githubusercontent.com/pcm-dpc/COVID-19/master/dati-json/dpc-covid19-ita-andamento-nazionale-latest.json,95564683,144107967,30288,147531,0.8296694953857574,30288,147531,95564683,144107967
Italy,2022-08-13,239857770,239857770,185120,https://raw.githubusercontent.com/pcm-dpc/COVID-19/master/dati-json/dpc-covid19-ita-andamento-nazionale-latest.json,95592979,144264791,28296,156824,0.8471477960242005,28296,156824,95592979,144264791
Italy,2022-08-14,239989072,239989072,131302,https://raw.githubusercontent.com/pcm-dpc/COVID-19/master/dati-json/dpc-covid19-ita-andamento-nazionale-latest.json,95613156,144375916,20177,111125,0.8463313582428295,20177,111125,95613156,144375916
Italy,2022-08-15,240053178,240053178,64106,https://raw.githubusercontent.com/pcm-dpc/COVID-19/master/dati-json/dpc-covid19-ita-andamento-nazionale-latest.json,95625650,144427528,12494,51612,0.8051040464231117,12494,51612,95625650,144427528
Italy,2022-08-16,240116727,240116727,63549,https://raw.githubusercontent.com/pcm-dpc/COVID-19/master/dati-json/dpc-covid19-ita-andamento-nazionale-latest.json,95640006,144476721,14356,49193,0.7740955797888244,14356,49193,95640006,144476721
Italy,2022-08-17,240345434,240345434,228707,https://raw.githubusercontent.com/pcm-dpc/COVID-19/master/dati-json/dpc-covid19-ita-andamento-nazionale-latest.json,95679255,144666179,39249,189458,0.8283874127158329,39249,189458,95679255,144666179
Italy,2022-08-18,240512619,240512619,167185,https://raw.githubusercontent.com/pcm-dpc/COVID-19/master/dati-json/dpc-covid19-ita-andamento-nazionale-latest.json,95713350,144799269,34095,133090,0.7960642402129378,34095,133090,95713350,144799269
Italy,2022-08-19,240671524,240671524,158905,https://raw.githubusercontent.com/pcm-dpc/COVID-19/master/dati-json/dpc-covid19-ita-andamento-nazionale-latest.json,95743494,144928030,30144,128761,0.8103017526194897,30144,128761,95743494,144928030
Italy,2022-08-20,240836328,240836328,164804,https://raw.githubusercontent.com/pcm-dpc/COVID-19/master/dati-json/dpc-covid19-ita-andamento-nazionale-latest.json,95770934,145065394,27440,137364,0.833499186912939,27440,137364,95770934,145065394
Italy,2022-08-21,240954848,240954848,118520,https://raw.githubusercontent.com/pcm-dpc/COVID-19/master/dati-json/dpc-covid19-ita-andamento-nazionale-latest.json,95790775,145164073,19841,98679,0.8325936550793115,19841,98679,95790775,145164073
Italy,2022-08-22,241018036,241018036,63188,https://raw.githubusercontent.com/pcm-dpc/COVID-19/master/dati-json/dpc-covid19-ita-andamento-nazionale-latest.json,95804468,145213568,13693,49495,0.783297461543331,13693,49495,95804468,145213568
Italy,2022-08-23,241225797,241225797,207761,https://raw.githubusercontent.com/pcm-dpc/COVID-19/master/dati-json/dpc-covid19-ita-andamento-nazionale-latest.json,95840835,145384962,36367,171394,0.8249575233080318,36367,171394,95840835,145384962
Italy,2022-08-24,241400024,241400024,174227,https://raw.githubusercontent.com/pcm-dpc/COVID-19/master/dati-json/dpc-covid19-ita-andamento-nazionale-latest.json,95877056,145522968,36221,138006,0.792104553255236,36221,138006,95877056,145522968
Italy,2022-08-25,241554167,241554167,154143,https://raw.githubusercontent.com/pcm-dpc/COVID-19/master/dati-json/dpc-covid19-ita-andamento-nazionale-latest.json,95908528,145645639,31472,122671,0.7958259538221003,31472,122671,95908528,145645639
Italy,2022-08-26,241702579,241702579,148412,https://raw.githubusercontent.com/pcm-dpc/COVID-19/master/dati-json/dpc-covid19-ita-andamento-nazionale-latest.json,95935463,145767116,26935,121477,0.8185119801633292,26935,121477,95935463,145767116
Italy,2022-08-27,241860865,241860865,158286,https://raw.githubusercontent.com/pcm-dpc/COVID-19/master/dati-json/dpc-covid19-ita-andamento-nazionale-latest.json,95962870,145897995,27407,130879,0.8268513955750982,27407,130879,95962870,145897995
Italy,2022-08-28,241978632,241978632,117767,https://raw.githubusercontent.com/pcm-dpc/COVID-19/master/dati-json/dpc-covid19-ita-andamento-nazionale-latest.json,95983659,145994973,20789,96978,0.8234734687985599,20789,96978,95983659,145994973
Italy,2022-08-29,242041599,242041599,62967,https://raw.githubusercontent.com/pcm-dpc/COVID-19/master/dati-json/dpc-covid19-ita-andamento-nazionale-latest.json,95997713,146043886,14054,48913,0.776803722584846,14054,48913,95997713,146043886
Italy,2022-08-30,242250595,242250595,208996,https://raw.githubusercontent.com/pcm-dpc/COVID-19/master/dati-json/dpc-covid19-ita-andamento-nazionale-latest.json,96035957,146214638,38244,170752,0.8170108518823327,38244,170752,96035957,146214638
Italy,2022-08-31,242418090,242418090,167495,https://raw.githubusercontent.com/pcm-dpc/COVID-19/master/dati-json/dpc-covid19-ita-andamento-nazionale-latest.json,96072729,146345361,36772,130723,0.7804591181826324,36772,130723,96072729,146345361
Italy,2022-09-01,242573841,242573841,155751,https://raw.githubusercontent.com/pcm-dpc/COVID-19/master/dati-json/dpc-covid19-ita-andamento-nazionale-latest.json,96105498,146468343,32769,122982,0.7896064872777703,32769,122982,96105498,146468343
Italy,2022-09-02,242732811,242732811,158970,https://raw.githubusercontent.com/pcm-dpc/COVID-19/master/dati-json/dpc-covid19-ita-andamento-nazionale-latest.json,96137533,146595278,32035,126935,0.7984839906900673,32035,126935,96137533,146595278
Italy,2022-09-03,242885263,242885263,152452,https://raw.githubusercontent.com/pcm-dpc/COVID-19/master/dati-json/dpc-covid19-ita-andamento-nazionale-latest.json,96166485,146718778,28952,123500,0.8100910450502453,28952,123500,96166485,146718778
Italy,2022-09-04,242997209,242997209,111946,https://raw.githubusercontent.com/pcm-dpc/COVID-19/master/dati-json/dpc-covid19-ita-andamento-nazionale-latest.json,96188916,146808293,22431,89515,0.7996266056848838,22431,89515,96188916,146808293
Italy,2022-09-05,243061031,243061031,63822,https://raw.githubusercontent.com/pcm-dpc/COVID-19/master/dati-json/dpc-covid19-ita-andamento-nazionale-latest.json,96202857,146858174,13941,49881,0.7815643508508038,13941,49881,96202857,146858174
Italy,2022-09-06,243263271,243263271,202240,https://raw.githubusercontent.com/pcm-dpc/COVID-19/master/dati-json/dpc-covid19-ita-andamento-nazionale-latest.json,96243817,147019454,40960,161280,0.7974683544303798,40960,161280,96243817,147019454
Italy,2022-09-07,243426378,243426378,163107,https://raw.githubusercontent.com/pcm-dpc/COVID-19/master/dati-json/dpc-covid19-ita-andamento-nazionale-latest.json,96283718,147142660,39901,123206,0.7553691748361505,39901,123206,96283718,147142660
Italy,2022-09-08,243575875,243575875,149497,https://raw.githubusercontent.com/pcm-dpc/COVID-19/master/dati-json/dpc-covid19-ita-andamento-nazionale-latest.json,96317193,147258682,33475,116022,0.7760824631932414,33475,116022,96317193,147258682
Italy,2022-09-09,243713008,243713008,137133,https://raw.githubusercontent.com/pcm-dpc/COVID-19/master/dati-json/dpc-covid19-ita-andamento-nazionale-latest.json,96346332,147366676,29139,107994,0.7875128524862725,29139,107994,96346332,147366676
Italy,2022-09-10,243853373,243853373,140365,https://raw.githubusercontent.com/pcm-dpc/COVID-19/master/dati-json/dpc-covid19-ita-andamento-nazionale-latest.json,96374450,147478923,28118,112247,0.7996794072596445,28118,112247,96374450,147478923
Italy,2022-09-11,243962017,243962017,108644,https://raw.githubusercontent.com/pcm-dpc/COVID-19/master/dati-json/dpc-covid19-ita-andamento-nazionale-latest.json,96397985,147564032,23535,85109,0.7833750598284305,23535,85109,96397985,147564032
Italy,2022-09-12,244019536,244019536,57519,https://raw.githubusercontent.com/pcm-dpc/COVID-19/master/dati-json/dpc-covid19-ita-andamento-nazionale-latest.json,96412275,147607261,14290,43229,0.7515603539699925,14290,43229,96412275,147607261
Italy,2022-09-13,244203747,244203747,184211,https://raw.githubusercontent.com/pcm-dpc/COVID-19/master/dati-json/dpc-covid19-ita-andamento-nazionale-latest.json,96450183,147753564,37908,146303,0.7942142434490883,37908,146303,96450183,147753564
Italy,2022-09-14,244375204,244375204,171457,https://raw.githubusercontent.com/pcm-dpc/COVID-19/master/dati-json/dpc-covid19-ita-andamento-nazionale-latest.json,96494705,147880499,44522,126935,0.7403313950436553,44522,126935,96494705,147880499
Italy,2022-09-15,244522187,244522187,146983,https://raw.githubusercontent.com/pcm-dpc/COVID-19/master/dati-json/dpc-covid19-ita-andamento-nazionale-latest.json,96527752,147994435,33047,113936,0.7751644748032085,33047,113936,96527752,147994435
Italy,2022-09-16,244660435,244660435,138248,https://raw.githubusercontent.com/pcm-dpc/COVID-19/master/dati-json/dpc-covid19-ita-andamento-nazionale-latest.json,96557969,148102466,30217,108031,0.7814290260980268,30217,108031,96557969,148102466
Italy,2022-09-17,244800946,244800946,140511,https://raw.githubusercontent.com/pcm-dpc/COVID-19/master/dati-json/dpc-covid19-ita-andamento-nazionale-latest.json,96585864,148215082,27895,112616,0.8014746176455936,27895,112616,96585864,148215082
Italy,2022-09-18,244898037,244898037,97091,https://raw.githubusercontent.com/pcm-dpc/COVID-19/master/dati-json/dpc-covid19-ita-andamento-nazionale-latest.json,96608470,148289567,22606,74485,0.7671668846752017,22606,74485,96608470,148289567
Italy,2022-09-19,244965453,244965453,67416,https://raw.githubusercontent.com/pcm-dpc/COVID-19/master/dati-json/dpc-covid19-ita-andamento-nazionale-latest.json,96623108,148342345,14638,52778,0.7828705351845259,14638,52778,96623108,148342345
Italy,2022-09-20,245172887,245172887,207434,https://raw.githubusercontent.com/pcm-dpc/COVID-19/master/dati-json/dpc-covid19-ita-andamento-nazionale-latest.json,96662410,148510477,39302,168132,0.8105325067250306,39302,168132,96662410,148510477
Italy,2022-09-21,245339387,245339387,166500,https://raw.githubusercontent.com/pcm-dpc/COVID-19/master/dati-json/dpc-covid19-ita-andamento-nazionale-latest.json,96699416,148639971,37006,129494,0.7777417417417417,37006,129494,96699416,148639971
Italy,2022-09-22,245504802,245504802,165415,https://raw.githubusercontent.com/pcm-dpc/COVID-19/master/dati-json/dpc-covid19-ita-andamento-nazionale-latest.json,96734693,148770109,35277,130138,0.7867363902910861,35277,130138,96734693,148770109
Italy,2022-09-23,245656409,245656409,151607,https://raw.githubusercontent.com/pcm-dpc/COVID-19/master/dati-json/dpc-covid19-ita-andamento-nazionale-latest.json,96763708,148892701,29015,122592,0.8086170163646798,29015,122592,96763708,148892701
Italy,2022-09-24,245808830,245808830,152421,https://raw.githubusercontent.com/pcm-dpc/COVID-19/master/dati-json/dpc-covid19-ita-andamento-nazionale-latest.json,96792519,149016311,28811,123610,0.810977489978415,28811,123610,96792519,149016311
Italy,2022-09-25,245930340,245930340,121510,https://raw.githubusercontent.com/pcm-dpc/COVID-19/master/dati-json/dpc-covid19-ita-andamento-nazionale-latest.json,96815458,149114882,22939,98571,0.811217183770883,22939,98571,96815458,149114882
Italy,2022-09-26,245996037,245996037,65697,https://raw.githubusercontent.com/pcm-dpc/COVID-19/master/dati-json/dpc-covid19-ita-andamento-nazionale-latest.json,96829502,149166535,14044,51653,0.7862307259083368,14044,51653,96829502,149166535
Italy,2022-09-27,246239458,246239458,243421,https://raw.githubusercontent.com/pcm-dpc/COVID-19/master/dati-json/dpc-covid19-ita-andamento-nazionale-latest.json,96871047,149368411,41545,201876,0.8293286117467269,41545,201876,96871047,149368411
Italy,2022-09-28,246438376,246438376,198918,https://raw.githubusercontent.com/pcm-dpc/COVID-19/master/dati-json/dpc-covid19-ita-andamento-nazionale-latest.json,96910152,149528224,39105,159813,0.8034114559768347,39105,159813,96910152,149528224
Italy,2022-09-29,246636495,246636495,198119,https://raw.githubusercontent.com/pcm-dpc/COVID-19/master/dati-json/dpc-covid19-ita-andamento-nazionale-latest.json,96947738,149688757,37586,160533,0.8102857373598695,37586,160533,96947738,149688757
Italy,2022-09-30,246819554,246819554,183059,https://raw.githubusercontent.com/pcm-dpc/COVID-19/master/dati-json/dpc-covid19-ita-andamento-nazionale-latest.json,96980810,149838744,33072,149987,0.8193369350865022,33072,149987,96980810,149838744
Italy,2022-10-01,246999795,246999795,180241,https://raw.githubusercontent.com/pcm-dpc/COVID-19/master/dati-json/dpc-covid19-ita-andamento-nazionale-latest.json,97009350,149990445,28540,151701,0.8416564488656854,28540,151701,97009350,149990445
Italy,2022-10-02,247147154,247147154,147359,https://raw.githubusercontent.com/pcm-dpc/COVID-19/master/dati-json/dpc-covid19-ita-andamento-nazionale-latest.json,97032618,150114536,23268,124091,0.8420999056725412,23268,124091,97032618,150114536
Italy,2022-10-03,247232847,247232847,85693,https://raw.githubusercontent.com/pcm-dpc/COVID-19/master/dati-json/dpc-covid19-ita-andamento-nazionale-latest.json,97052020,150180827,19402,66291,0.7735871074650205,19402,66291,97052020,150180827
Italy,2022-10-04,247525943,247525943,293096,https://raw.githubusercontent.com/pcm-dpc/COVID-19/master/dati-json/dpc-covid19-ita-andamento-nazionale-latest.json,97096569,150429374,44549,248547,0.84800543166744,44549,248547,97096569,150429374
Italy,2022-10-05,247750912,247750912,224969,https://raw.githubusercontent.com/pcm-dpc/COVID-19/master/dati-json/dpc-covid19-ita-andamento-nazionale-latest.json,97136975,150613937,40406,184563,0.8203930319288435,40406,184563,97136975,150613937
Italy,2022-10-06,247973838,247973838,222926,https://raw.githubusercontent.com/pcm-dpc/COVID-19/master/dati-json/dpc-covid19-ita-andamento-nazionale-latest.json,97174598,150799240,37623,185303,0.8312309914500776,37623,185303,97174598,150799240
Italy,2022-10-07,248179393,248179393,205555,https://raw.githubusercontent.com/pcm-dpc/COVID-19/master/dati-json/dpc-covid19-ita-andamento-nazionale-latest.json,97202196,150977197,27598,177957,0.865739096592153,27598,177957,97202196,150977197
Italy,2022-10-08,248394428,248394428,215035,https://raw.githubusercontent.com/pcm-dpc/COVID-19/master/dati-json/dpc-covid19-ita-andamento-nazionale-latest.json,97237370,151157058,35174,179861,0.8364266282233125,35174,179861,97237370,151157058
Italy,2022-10-09,248564666,248564666,170238,https://raw.githubusercontent.com/pcm-dpc/COVID-19/master/dati-json/dpc-covid19-ita-andamento-nazionale-latest.json,97261415,151303251,24045,146193,0.8587565643393367,24045,146193,97261415,151303251
Italy,2022-10-10,248648092,248648092,83426,https://raw.githubusercontent.com/pcm-dpc/COVID-19/master/dati-json/dpc-covid19-ita-andamento-nazionale-latest.json,97277051,151371041,15636,67790,0.8125764150264906,15636,67790,97277051,151371041
Italy,2022-10-11,248981296,248981296,333204,https://raw.githubusercontent.com/pcm-dpc/COVID-19/master/dati-json/dpc-covid19-ita-andamento-nazionale-latest.json,97328859,151652437,51808,281396,0.8445156720807674,51808,281396,97328859,151652437
Italy,2022-10-12,249226042,249226042,244746,https://raw.githubusercontent.com/pcm-dpc/COVID-19/master/dati-json/dpc-covid19-ita-andamento-nazionale-latest.json,97370953,151855089,42094,202652,0.8280094465282375,42094,202652,97370953,151855089
Italy,2022-10-13,249464295,249464295,238253,https://raw.githubusercontent.com/pcm-dpc/COVID-19/master/dati-json/dpc-covid19-ita-andamento-nazionale-latest.json,97410922,152053373,39969,198284,0.8322413568769333,39969,198284,97410922,152053373
Italy,2022-10-14,249680806,249680806,216511,https://raw.githubusercontent.com/pcm-dpc/COVID-19/master/dati-json/dpc-covid19-ita-andamento-nazionale-latest.json,97442974,152237832,32052,184459,0.8519613322186863,32052,184459,97442974,152237832
Italy,2022-10-15,249896478,249896478,215672,https://raw.githubusercontent.com/pcm-dpc/COVID-19/master/dati-json/dpc-covid19-ita-andamento-nazionale-latest.json,97473969,152422509,30995,184677,0.8562863978634222,30995,184677,97473969,152422509
Italy,2022-10-16,250072463,250072463,175985,https://raw.githubusercontent.com/pcm-dpc/COVID-19/master/dati-json/dpc-covid19-ita-andamento-nazionale-latest.json,97498654,152573809,24685,151300,0.859732363553712,24685,151300,97498654,152573809
Italy,2022-10-17,250156683,250156683,84220,https://raw.githubusercontent.com/pcm-dpc/COVID-19/master/dati-json/dpc-covid19-ita-andamento-nazionale-latest.json,97517036,152639647,18382,65838,0.7817383044407504,18382,65838,97517036,152639647
Italy,2022-10-18,250486252,250486252,329569,https://raw.githubusercontent.com/pcm-dpc/COVID-19/master/dati-json/dpc-covid19-ita-andamento-nazionale-latest.json,97565623,152920629,48587,280982,0.8525741195318735,48587,280982,97565623,152920629
Italy,2022-10-19,250719336,250719336,233084,https://raw.githubusercontent.com/pcm-dpc/COVID-19/master/dati-json/dpc-covid19-ita-andamento-nazionale-latest.json,97607163,153112173,41540,191544,0.8217809888280619,41540,191544,97607163,153112173
Italy,2022-10-20,250948476,250948476,229140,https://raw.githubusercontent.com/pcm-dpc/COVID-19/master/dati-json/dpc-covid19-ita-andamento-nazionale-latest.json,97645915,153302561,38752,190388,0.8308806842978091,38752,190388,97645915,153302561
Italy,2022-10-21,251161564,251161564,213088,https://raw.githubusercontent.com/pcm-dpc/COVID-19/master/dati-json/dpc-covid19-ita-andamento-nazionale-latest.json,97680227,153481337,34312,178776,0.8389773239225109,34312,178776,97680227,153481337
Italy,2022-10-22,251357139,251357139,195575,https://raw.githubusercontent.com/pcm-dpc/COVID-19/master/dati-json/dpc-covid19-ita-andamento-nazionale-latest.json,97710669,153646470,30442,165133,0.8443461587626231,30442,165133,97710669,153646470
Italy,2022-10-23,251518926,251518926,161787,https://raw.githubusercontent.com/pcm-dpc/COVID-19/master/dati-json/dpc-covid19-ita-andamento-nazionale-latest.json,97734710,153784216,24041,137746,0.8514033884057434,24041,137746,97734710,153784216
Italy,2022-10-24,251599245,251599245,80319,https://raw.githubusercontent.com/pcm-dpc/COVID-19/master/dati-json/dpc-covid19-ita-andamento-nazionale-latest.json,97749921,153849324,15211,65108,0.810617662072486,15211,65108,97749921,153849324
Italy,2022-10-25,251896513,251896513,297268,https://raw.githubusercontent.com/pcm-dpc/COVID-19/master/dati-json/dpc-covid19-ita-andamento-nazionale-latest.json,97796043,154100470,46122,251146,0.844847074020749,46122,251146,97796043,154100470
Italy,2022-10-26,252113248,252113248,216735,https://raw.githubusercontent.com/pcm-dpc/COVID-19/master/dati-json/dpc-covid19-ita-andamento-nazionale-latest.json,97835494,154277754,39451,177284,0.8179758691489607,39451,177284,97835494,154277754
Italy,2022-10-27,252318986,252318986,205738,https://raw.githubusercontent.com/pcm-dpc/COVID-19/master/dati-json/dpc-covid19-ita-andamento-nazionale-latest.json,97872586,154446400,37092,168646,0.8197124498148131,37092,168646,97872586,154446400
Italy,2022-10-28,252501600,252501600,182614,https://raw.githubusercontent.com/pcm-dpc/COVID-19/master/dati-json/dpc-covid19-ita-andamento-nazionale-latest.json,97905396,154596204,32810,149804,0.8203314094209644,32810,149804,97905396,154596204
Italy,2022-10-29,252677943,252677943,176343,https://raw.githubusercontent.com/pcm-dpc/COVID-19/master/dati-json/dpc-covid19-ita-andamento-nazionale-latest.json,97935126,154742817,29730,146613,0.831408108062129,29730,146613,97935126,154742817
Italy,2022-10-30,252677943,252677943,0,https://raw.githubusercontent.com/pcm-dpc/COVID-19/master/dati-json/dpc-covid19-ita-andamento-nazionale-latest.json,97935126,154742817,0,0,0.831408108062129,0,0,97935126,154742817
Italy,2022-10-31,252677943,252677943,0,https://raw.githubusercontent.com/pcm-dpc/COVID-19/master/dati-json/dpc-covid19-ita-andamento-nazionale-latest.json,97935126,154742817,0,0,0.831408108062129,0,0,97935126,154742817
Italy,2022-11-01,252677943,252677943,0,https://raw.githubusercontent.com/pcm-dpc/COVID-19/master/dati-json/dpc-covid19-ita-andamento-nazionale-latest.json,97935126,154742817,0,0,0.831408108062129,0,0,97935126,154742817
Italy,2022-11-02,252677943,252677943,0,https://raw.githubusercontent.com/pcm-dpc/COVID-19/master/dati-json/dpc-covid19-ita-andamento-nazionale-latest.json,97935126,154742817,0,0,0.831408108062129,0,0,97935126,154742817
Italy,2022-11-03,252677943,252677943,0,https://raw.githubusercontent.com/pcm-dpc/COVID-19/master/dati-json/dpc-covid19-ita-andamento-nazionale-latest.json,97935126,154742817,0,0,0.831408108062129,0,0,97935126,154742817
Italy,2022-11-04,253427252,253427252,749309,https://raw.githubusercontent.com/pcm-dpc/COVID-19/master/dati-json/dpc-covid19-ita-andamento-nazionale-latest.json,98060919,155366333,125793,623516,0.832121327783331,125793,623516,98060919,155366333
Italy,2022-11-05,253427252,253427252,0,https://raw.githubusercontent.com/pcm-dpc/COVID-19/master/dati-json/dpc-covid19-ita-andamento-nazionale-latest.json,98060919,155366333,0,0,0.832121327783331,0,0,98060919,155366333
Italy,2022-11-06,253427252,253427252,0,https://raw.githubusercontent.com/pcm-dpc/COVID-19/master/dati-json/dpc-covid19-ita-andamento-nazionale-latest.json,98060919,155366333,0,0,0.832121327783331,0,0,98060919,155366333
Italy,2022-11-07,253427252,253427252,0,https://raw.githubusercontent.com/pcm-dpc/COVID-19/master/dati-json/dpc-covid19-ita-andamento-nazionale-latest.json,98060919,155366333,0,0,0.832121327783331,0,0,98060919,155366333
Italy,2022-11-08,253427252,253427252,0,https://raw.githubusercontent.com/pcm-dpc/COVID-19/master/dati-json/dpc-covid19-ita-andamento-nazionale-latest.json,98060919,155366333,0,0,0.832121327783331,0,0,98060919,155366333
Italy,2022-11-09,253427252,253427252,0,https://raw.githubusercontent.com/pcm-dpc/COVID-19/master/dati-json/dpc-covid19-ita-andamento-nazionale-latest.json,98060919,155366333,0,0,0.832121327783331,0,0,98060919,155366333
Italy,2022-11-10,253427252,253427252,0,https://raw.githubusercontent.com/pcm-dpc/COVID-19/master/dati-json/dpc-covid19-ita-andamento-nazionale-latest.json,98060919,155366333,0,0,0.832121327783331,0,0,98060919,155366333
Italy,2022-11-11,254586854,254586854,1159602,https://raw.githubusercontent.com/pcm-dpc/COVID-19/master/dati-json/dpc-covid19-ita-andamento-nazionale-latest.json,98277175,156309679,216256,943346,0.8135084278916387,216256,943346,98277175,156309679
Italy,2022-11-12,254586854,254586854,0,https://raw.githubusercontent.com/pcm-dpc/COVID-19/master/dati-json/dpc-covid19-ita-andamento-nazionale-latest.json,98277175,156309679,0,0,0.8135084278916387,0,0,98277175,156309679
Italy,2022-11-13,254586854,254586854,0,https://raw.githubusercontent.com/pcm-dpc/COVID-19/master/dati-json/dpc-covid19-ita-andamento-nazionale-latest.json,98277175,156309679,0,0,0.8135084278916387,0,0,98277175,156309679
Italy,2022-11-14,254586854,254586854,0,https://raw.githubusercontent.com/pcm-dpc/COVID-19/master/dati-json/dpc-covid19-ita-andamento-nazionale-latest.json,98277175,156309679,0,0,0.8135084278916387,0,0,98277175,156309679
Italy,2022-11-15,254586854,254586854,0,https://raw.githubusercontent.com/pcm-dpc/COVID-19/master/dati-json/dpc-covid19-ita-andamento-nazionale-latest.json,98277175,156309679,0,0,0.8135084278916387,0,0,98277175,156309679
Italy,2022-11-16,254586854,254586854,0,https://raw.githubusercontent.com/pcm-dpc/COVID-19/master/dati-json/dpc-covid19-ita-andamento-nazionale-latest.json,98277175,156309679,0,0,0.8135084278916387,0,0,98277175,156309679
Italy,2022-11-17,254586854,254586854,0,https://raw.githubusercontent.com/pcm-dpc/COVID-19/master/dati-json/dpc-covid19-ita-andamento-nazionale-latest.json,98277175,156309679,0,0,0.8135084278916387,0,0,98277175,156309679
Italy,2022-11-18,255780377,255780377,1193523,https://raw.githubusercontent.com/pcm-dpc/COVID-19/master/dati-json/dpc-covid19-ita-andamento-nazionale-latest.json,98486966,157293411,209791,983732,0.824225423389411,209791,983732,98486966,157293411
Italy,2022-11-19,255780377,255780377,0,https://raw.githubusercontent.com/pcm-dpc/COVID-19/master/dati-json/dpc-covid19-ita-andamento-nazionale-latest.json,98486966,157293411,0,0,0.824225423389411,0,0,98486966,157293411
Italy,2022-11-20,255780377,255780377,0,https://raw.githubusercontent.com/pcm-dpc/COVID-19/master/dati-json/dpc-covid19-ita-andamento-nazionale-latest.json,98486966,157293411,0,0,0.824225423389411,0,0,98486966,157293411
Italy,2022-11-21,255780377,255780377,0,https://raw.githubusercontent.com/pcm-dpc/COVID-19/master/dati-json/dpc-covid19-ita-andamento-nazionale-latest.json,98486966,157293411,0,0,0.824225423389411,0,0,98486966,157293411
Italy,2022-11-22,255780377,255780377,0,https://raw.githubusercontent.com/pcm-dpc/COVID-19/master/dati-json/dpc-covid19-ita-andamento-nazionale-latest.json,98486966,157293411,0,0,0.824225423389411,0,0,98486966,157293411
Italy,2022-11-23,255780377,255780377,0,https://raw.githubusercontent.com/pcm-dpc/COVID-19/master/dati-json/dpc-covid19-ita-andamento-nazionale-latest.json,98486966,157293411,0,0,0.824225423389411,0,0,98486966,157293411
Italy,2022-11-24,255780377,255780377,0,https://raw.githubusercontent.com/pcm-dpc/COVID-19/master/dati-json/dpc-covid19-ita-andamento-nazionale-latest.json,98486966,157293411,0,0,0.824225423389411,0,0,98486966,157293411
Italy,2022-11-25,257057363,257057363,1276986,https://raw.githubusercontent.com/pcm-dpc/COVID-19/master/dati-json/dpc-covid19-ita-andamento-nazionale-latest.json,98700942,158356421,213976,1063010,0.8324366907702981,213976,1063010,98700942,158356421
Italy,2022-11-26,257057363,257057363,0,https://raw.githubusercontent.com/pcm-dpc/COVID-19/master/dati-json/dpc-covid19-ita-andamento-nazionale-latest.json,98700942,158356421,0,0,0.8324366907702981,0,0,98700942,158356421
Italy,2022-11-27,257057363,257057363,0,https://raw.githubusercontent.com/pcm-dpc/COVID-19/master/dati-json/dpc-covid19-ita-andamento-nazionale-latest.json,98700942,158356421,0,0,0.8324366907702981,0,0,98700942,158356421
Italy,2022-11-28,257057363,257057363,0,https://raw.githubusercontent.com/pcm-dpc/COVID-19/master/dati-json/dpc-covid19-ita-andamento-nazionale-latest.json,98700942,158356421,0,0,0.8324366907702981,0,0,98700942,158356421
Italy,2022-11-29,257057363,257057363,0,https://raw.githubusercontent.com/pcm-dpc/COVID-19/master/dati-json/dpc-covid19-ita-andamento-nazionale-latest.json,98700942,158356421,0,0,0.8324366907702981,0,0,98700942,158356421
Italy,2022-11-30,257057363,257057363,0,https://raw.githubusercontent.com/pcm-dpc/COVID-19/master/dati-json/dpc-covid19-ita-andamento-nazionale-latest.json,98700942,158356421,0,0,0.8324366907702981,0,0,98700942,158356421
Italy,2022-12-01,257057363,257057363,0,https://raw.githubusercontent.com/pcm-dpc/COVID-19/master/dati-json/dpc-covid19-ita-andamento-nazionale-latest.json,98700942,158356421,0,0,0.8324366907702981,0,0,98700942,158356421
Italy,2022-12-02,258382332,258382332,1324969,https://raw.githubusercontent.com/pcm-dpc/COVID-19/master/dati-json/dpc-covid19-ita-andamento-nazionale-latest.json,98917043,159465289,216101,1108868,0.8369010897613454,216101,1108868,98917043,159465289
Italy,2022-12-03,258382332,258382332,0,https://raw.githubusercontent.com/pcm-dpc/COVID-19/master/dati-json/dpc-covid19-ita-andamento-nazionale-latest.json,98917043,159465289,0,0,0.8369010897613454,0,0,98917043,159465289
Italy,2022-12-04,258382332,258382332,0,https://raw.githubusercontent.com/pcm-dpc/COVID-19/master/dati-json/dpc-covid19-ita-andamento-nazionale-latest.json,98917043,159465289,0,0,0.8369010897613454,0,0,98917043,159465289
Italy,2022-12-05,258382332,258382332,0,https://raw.githubusercontent.com/pcm-dpc/COVID-19/master/dati-json/dpc-covid19-ita-andamento-nazionale-latest.json,98917043,159465289,0,0,0.8369010897613454,0,0,98917043,159465289
Italy,2022-12-06,258382332,258382332,0,https://raw.githubusercontent.com/pcm-dpc/COVID-19/master/dati-json/dpc-covid19-ita-andamento-nazionale-latest.json,98917043,159465289,0,0,0.8369010897613454,0,0,98917043,159465289
Italy,2022-12-07,258382332,258382332,0,https://raw.githubusercontent.com/pcm-dpc/COVID-19/master/dati-json/dpc-covid19-ita-andamento-nazionale-latest.json,98917043,159465289,0,0,0.8369010897613454,0,0,98917043,159465289
Italy,2022-12-08,258382332,258382332,0,https://raw.githubusercontent.com/pcm-dpc/COVID-19/master/dati-json/dpc-covid19-ita-andamento-nazionale-latest.json,98917043,159465289,0,0,0.8369010897613454,0,0,98917043,159465289
Italy,2022-12-09,259639054,259639054,1256722,https://raw.githubusercontent.com/pcm-dpc/COVID-19/master/dati-json/dpc-covid19-ita-andamento-nazionale-latest.json,99117448,160521606,200405,1056317,0.8405335467987352,200405,1056317,99117448,160521606
Italy,2022-12-10,259639054,259639054,0,https://raw.githubusercontent.com/pcm-dpc/COVID-19/master/dati-json/dpc-covid19-ita-andamento-nazionale-latest.json,99117448,160521606,0,0,0.8405335467987352,0,0,99117448,160521606
Italy,2022-12-11,259639054,259639054,0,https://raw.githubusercontent.com/pcm-dpc/COVID-19/master/dati-json/dpc-covid19-ita-andamento-nazionale-latest.json,99117448,160521606,0,0,0.8405335467987352,0,0,99117448,160521606
Italy,2022-12-12,259639054,259639054,0,https://raw.githubusercontent.com/pcm-dpc/COVID-19/master/dati-json/dpc-covid19-ita-andamento-nazionale-latest.json,99117448,160521606,0,0,0.8405335467987352,0,0,99117448,160521606
Italy,2022-12-13,259639054,259639054,0,https://raw.githubusercontent.com/pcm-dpc/COVID-19/master/dati-json/dpc-covid19-ita-andamento-nazionale-latest.json,99117448,160521606,0,0,0.8405335467987352,0,0,99117448,160521606
Italy,2022-12-14,259639054,259639054,0,https://raw.githubusercontent.com/pcm-dpc/COVID-19/master/dati-json/dpc-covid19-ita-andamento-nazionale-latest.json,99117448,160521606,0,0,0.8405335467987352,0,0,99117448,160521606
Italy,2022-12-15,259639054,259639054,0,https://raw.githubusercontent.com/pcm-dpc/COVID-19/master/dati-json/dpc-covid19-ita-andamento-nazionale-latest.json,99117448,160521606,0,0,0.8405335467987352,0,0,99117448,160521606
Italy,2022-12-16,260732261,260732261,1093207,https://raw.githubusercontent.com/pcm-dpc/COVID-19/master/dati-json/dpc-covid19-ita-andamento-nazionale-latest.json,99305353,161426908,187905,905302,0.8281158097231357,187905,905302,99305353,161426908
Italy,2022-12-17,260732261,260732261,0,https://raw.githubusercontent.com/pcm-dpc/COVID-19/master/dati-json/dpc-covid19-ita-andamento-nazionale-latest.json,99305353,161426908,0,0,0.8281158097231357,0,0,99305353,161426908
Italy,2022-12-18,260732261,260732261,0,https://raw.githubusercontent.com/pcm-dpc/COVID-19/master/dati-json/dpc-covid19-ita-andamento-nazionale-latest.json,99305353,161426908,0,0,0.8281158097231357,0,0,99305353,161426908
Italy,2022-12-19,260732261,260732261,0,https://raw.githubusercontent.com/pcm-dpc/COVID-19/master/dati-json/dpc-covid19-ita-andamento-nazionale-latest.json,99305353,161426908,0,0,0.8281158097231357,0,0,99305353,161426908
Italy,2022-12-20,260732261,260732261,0,https://raw.githubusercontent.com/pcm-dpc/COVID-19/master/dati-json/dpc-covid19-ita-andamento-nazionale-latest.json,99305353,161426908,0,0,0.8281158097231357,0,0,99305353,161426908
Italy,2022-12-21,260732261,260732261,0,https://raw.githubusercontent.com/pcm-dpc/COVID-19/master/dati-json/dpc-covid19-ita-andamento-nazionale-latest.json,99305353,161426908,0,0,0.8281158097231357,0,0,99305353,161426908
Italy,2022-12-22,260732261,260732261,0,https://raw.githubusercontent.com/pcm-dpc/COVID-19/master/dati-json/dpc-covid19-ita-andamento-nazionale-latest.json,99305353,161426908,0,0,0.8281158097231357,0,0,99305353,161426908
Italy,2022-12-23,261751623,261751623,1019362,https://raw.githubusercontent.com/pcm-dpc/COVID-19/master/dati-json/dpc-covid19-ita-andamento-nazionale-latest.json,99486201,162265422,180848,838514,0.8225870691667926,180848,838514,99486201,162265422
Italy,2022-12-24,261751623,261751623,0,https://raw.githubusercontent.com/pcm-dpc/COVID-19/master/dati-json/dpc-covid19-ita-andamento-nazionale-latest.json,99486201,162265422,0,0,0.8225870691667926,0,0,99486201,162265422
Italy,2022-12-25,261751623,261751623,0,https://raw.githubusercontent.com/pcm-dpc/COVID-19/master/dati-json/dpc-covid19-ita-andamento-nazionale-latest.json,99486201,162265422,0,0,0.8225870691667926,0,0,99486201,162265422
Italy,2022-12-26,261751623,261751623,0,https://raw.githubusercontent.com/pcm-dpc/COVID-19/master/dati-json/dpc-covid19-ita-andamento-nazionale-latest.json,99486201,162265422,0,0,0.8225870691667926,0,0,99486201,162265422
Italy,2022-12-27,261751623,261751623,0,https://raw.githubusercontent.com/pcm-dpc/COVID-19/master/dati-json/dpc-covid19-ita-andamento-nazionale-latest.json,99486201,162265422,0,0,0.8225870691667926,0,0,99486201,162265422
Italy,2022-12-28,261751623,261751623,0,https://raw.githubusercontent.com/pcm-dpc/COVID-19/master/dati-json/dpc-covid19-ita-andamento-nazionale-latest.json,99486201,162265422,0,0,0.8225870691667926,0,0,99486201,162265422
Italy,2022-12-29,261751623,261751623,0,https://raw.githubusercontent.com/pcm-dpc/COVID-19/master/dati-json/dpc-covid19-ita-andamento-nazionale-latest.json,99486201,162265422,0,0,0.8225870691667926,0,0,99486201,162265422
Italy,2022-12-30,262558741,262558741,807118,https://raw.githubusercontent.com/pcm-dpc/COVID-19/master/dati-json/dpc-covid19-ita-andamento-nazionale-latest.json,99615709,162943032,129508,677610,0.8395426691016679,129508,677610,99615709,162943032
Italy,2022-12-31,262558741,262558741,0,https://raw.githubusercontent.com/pcm-dpc/COVID-19/master/dati-json/dpc-covid19-ita-andamento-nazionale-latest.json,99615709,162943032,0,0,0.8395426691016679,0,0,99615709,162943032
Italy,2023-01-01,262558741,262558741,0,https://raw.githubusercontent.com/pcm-dpc/COVID-19/master/dati-json/dpc-covid19-ita-andamento-nazionale-latest.json,99615709,162943032,0,0,0.8395426691016679,0,0,99615709,162943032
Italy,2023-01-02,262558741,262558741,0,https://raw.githubusercontent.com/pcm-dpc/COVID-19/master/dati-json/dpc-covid19-ita-andamento-nazionale-latest.json,99615709,162943032,0,0,0.8395426691016679,0,0,99615709,162943032
Italy,2023-01-03,262558741,262558741,0,https://raw.githubusercontent.com/pcm-dpc/COVID-19/master/dati-json/dpc-covid19-ita-andamento-nazionale-latest.json,99615709,162943032,0,0,0.8395426691016679,0,0,99615709,162943032
Italy,2023-01-04,262558741,262558741,0,https://raw.githubusercontent.com/pcm-dpc/COVID-19/master/dati-json/dpc-covid19-ita-andamento-nazionale-latest.json,99615709,162943032,0,0,0.8395426691016679,0,0,99615709,162943032
Italy,2023-01-05,262558741,262558741,0,https://raw.githubusercontent.com/pcm-dpc/COVID-19/master/dati-json/dpc-covid19-ita-andamento-nazionale-latest.json,99615709,162943032,0,0,0.8395426691016679,0,0,99615709,162943032
Italy,2023-01-06,263414564,263414564,855823,https://raw.githubusercontent.com/pcm-dpc/COVID-19/master/dati-json/dpc-covid19-ita-andamento-nazionale-latest.json,99757274,163657290,141565,714258,0.8345861235325529,141565,714258,99757274,163657290
Italy,2023-01-07,263414564,263414564,0,https://raw.githubusercontent.com/pcm-dpc/COVID-19/master/dati-json/dpc-covid19-ita-andamento-nazionale-latest.json,99757274,163657290,0,0,0.8345861235325529,0,0,99757274,163657290
Italy,2023-01-08,263414564,263414564,0,https://raw.githubusercontent.com/pcm-dpc/COVID-19/master/dati-json/dpc-covid19-ita-andamento-nazionale-latest.json,99757274,163657290,0,0,0.8345861235325529,0,0,99757274,163657290
Italy,2023-01-09,263414564,263414564,0,https://raw.githubusercontent.com/pcm-dpc/COVID-19/master/dati-json/dpc-covid19-ita-andamento-nazionale-latest.json,99757274,163657290,0,0,0.8345861235325529,0,0,99757274,163657290
Italy,2023-01-10,263414564,263414564,0,https://raw.githubusercontent.com/pcm-dpc/COVID-19/master/dati-json/dpc-covid19-ita-andamento-nazionale-latest.json,99757274,163657290,0,0,0.8345861235325529,0,0,99757274,163657290
Italy,2023-01-11,263414564,263414564,0,https://raw.githubusercontent.com/pcm-dpc/COVID-19/master/dati-json/dpc-covid19-ita-andamento-nazionale-latest.json,99757274,163657290,0,0,0.8345861235325529,0,0,99757274,163657290
Italy,2023-01-12,263414564,263414564,0,https://raw.githubusercontent.com/pcm-dpc/COVID-19/master/dati-json/dpc-covid19-ita-andamento-nazionale-latest.json,99757274,163657290,0,0,0.8345861235325529,0,0,99757274,163657290
Italy,2023-01-13,264182282,264182282,767718,https://raw.githubusercontent.com/pcm-dpc/COVID-19/master/dati-json/dpc-covid19-ita-andamento-nazionale-latest.json,99908634,164273648,151360,616358,0.8028442735483602,151360,616358,99908634,164273648
Italy,2023-01-14,264182282,264182282,0,https://raw.githubusercontent.com/pcm-dpc/COVID-19/master/dati-json/dpc-covid19-ita-andamento-nazionale-latest.json,99908634,164273648,0,0,0.8028442735483602,0,0,99908634,164273648
Italy,2023-01-15,264182282,264182282,0,https://raw.githubusercontent.com/pcm-dpc/COVID-19/master/dati-json/dpc-covid19-ita-andamento-nazionale-latest.json,99908634,164273648,0,0,0.8028442735483602,0,0,99908634,164273648
Italy,2023-01-16,264182282,264182282,0,https://raw.githubusercontent.com/pcm-dpc/COVID-19/master/dati-json/dpc-covid19-ita-andamento-nazionale-latest.json,99908634,164273648,0,0,0.8028442735483602,0,0,99908634,164273648
Italy,2023-01-17,264182282,264182282,0,https://raw.githubusercontent.com/pcm-dpc/COVID-19/master/dati-json/dpc-covid19-ita-andamento-nazionale-latest.json,99908634,164273648,0,0,0.8028442735483602,0,0,99908634,164273648
Italy,2023-01-18,264182282,264182282,0,https://raw.githubusercontent.com/pcm-dpc/COVID-19/master/dati-json/dpc-covid19-ita-andamento-nazionale-latest.json,99908634,164273648,0,0,0.8028442735483602,0,0,99908634,164273648
Italy,2023-01-19,264182282,264182282,0,https://raw.githubusercontent.com/pcm-dpc/COVID-19/master/dati-json/dpc-covid19-ita-andamento-nazionale-latest.json,99908634,164273648,0,0,0.8028442735483602,0,0,99908634,164273648
Italy,2023-01-20,264869515,264869515,687233,https://raw.githubusercontent.com/pcm-dpc/COVID-19/master/dati-json/dpc-covid19-ita-andamento-nazionale-latest.json,100054995,164814520,146361,540872,0.7870285623653114,146361,540872,100054995,164814520
Italy,2023-01-21,264869515,264869515,0,https://raw.githubusercontent.com/pcm-dpc/COVID-19/master/dati-json/dpc-covid19-ita-andamento-nazionale-latest.json,100054995,164814520,0,0,0.7870285623653114,0,0,100054995,164814520
Italy,2023-01-22,264869515,264869515,0,https://raw.githubusercontent.com/pcm-dpc/COVID-19/master/dati-json/dpc-covid19-ita-andamento-nazionale-latest.json,100054995,164814520,0,0,0.7870285623653114,0,0,100054995,164814520
Italy,2023-01-23,264869515,264869515,0,https://raw.githubusercontent.com/pcm-dpc/COVID-19/master/dati-json/dpc-covid19-ita-andamento-nazionale-latest.json,100054995,164814520,0,0,0.7870285623653114,0,0,100054995,164814520
Italy,2023-01-24,264869515,264869515,0,https://raw.githubusercontent.com/pcm-dpc/COVID-19/master/dati-json/dpc-covid19-ita-andamento-nazionale-latest.json,100054995,164814520,0,0,0.7870285623653114,0,0,100054995,164814520
Italy,2023-01-25,264869515,264869515,0,https://raw.githubusercontent.com/pcm-dpc/COVID-19/master/dati-json/dpc-covid19-ita-andamento-nazionale-latest.json,100054995,164814520,0,0,0.7870285623653114,0,0,100054995,164814520
Italy,2023-01-26,264869515,264869515,0,https://raw.githubusercontent.com/pcm-dpc/COVID-19/master/dati-json/dpc-covid19-ita-andamento-nazionale-latest.json,100054995,164814520,0,0,0.7870285623653114,0,0,100054995,164814520
Italy,2023-01-27,265478247,265478247,608732,https://raw.githubusercontent.com/pcm-dpc/COVID-19/master/dati-json/dpc-covid19-ita-andamento-nazionale-latest.json,100194934,165283313,139939,468793,0.7701139417674773,139939,468793,100194934,165283313
Italy,2023-01-28,265478247,265478247,0,https://raw.githubusercontent.com/pcm-dpc/COVID-19/master/dati-json/dpc-covid19-ita-andamento-nazionale-latest.json,100194934,165283313,0,0,0.7701139417674773,0,0,100194934,165283313
Italy,2023-01-29,265478247,265478247,0,https://raw.githubusercontent.com/pcm-dpc/COVID-19/master/dati-json/dpc-covid19-ita-andamento-nazionale-latest.json,100194934,165283313,0,0,0.7701139417674773,0,0,100194934,165283313
Italy,2023-01-30,265478247,265478247,0,https://raw.githubusercontent.com/pcm-dpc/COVID-19/master/dati-json/dpc-covid19-ita-andamento-nazionale-latest.json,100194934,165283313,0,0,0.7701139417674773,0,0,100194934,165283313
Italy,2023-01-31,265478247,265478247,0,https://raw.githubusercontent.com/pcm-dpc/COVID-19/master/dati-json/dpc-covid19-ita-andamento-nazionale-latest.json,100194934,165283313,0,0,0.7701139417674773,0,0,100194934,165283313
Italy,2023-02-01,265478247,265478247,0,https://raw.githubusercontent.com/pcm-dpc/COVID-19/master/dati-json/dpc-covid19-ita-andamento-nazionale-latest.json,100194934,165283313,0,0,0.7701139417674773,0,0,100194934,165283313
Italy,2023-02-02,265478247,265478247,0,https://raw.githubusercontent.com/pcm-dpc/COVID-19/master/dati-json/dpc-covid19-ita-andamento-nazionale-latest.json,100194934,165283313,0,0,0.7701139417674773,0,0,100194934,165283313
Italy,2023-02-03,266073786,266073786,595539,https://raw.githubusercontent.com/pcm-dpc/COVID-19/master/dati-json/dpc-covid19-ita-andamento-nazionale-latest.json,100317128,165756658,122194,473345,0.7948178037038717,122194,473345,100317128,165756658
Italy,2023-02-04,266073786,266073786,0,https://raw.githubusercontent.com/pcm-dpc/COVID-19/master/dati-json/dpc-covid19-ita-andamento-nazionale-latest.json,100317128,165756658,0,0,0.7948178037038717,0,0,100317128,165756658
Italy,2023-02-05,266073786,266073786,0,https://raw.githubusercontent.com/pcm-dpc/COVID-19/master/dati-json/dpc-covid19-ita-andamento-nazionale-latest.json,100317128,165756658,0,0,0.7948178037038717,0,0,100317128,165756658
Italy,2023-02-06,266073786,266073786,0,https://raw.githubusercontent.com/pcm-dpc/COVID-19/master/dati-json/dpc-covid19-ita-andamento-nazionale-latest.json,100317128,165756658,0,0,0.7948178037038717,0,0,100317128,165756658
Italy,2023-02-07,266073786,266073786,0,https://raw.githubusercontent.com/pcm-dpc/COVID-19/master/dati-json/dpc-covid19-ita-andamento-nazionale-latest.json,100317128,165756658,0,0,0.7948178037038717,0,0,100317128,165756658
Italy,2023-02-08,266073786,266073786,0,https://raw.githubusercontent.com/pcm-dpc/COVID-19/master/dati-json/dpc-covid19-ita-andamento-nazionale-latest.json,100317128,165756658,0,0,0.7948178037038717,0,0,100317128,165756658
Italy,2023-02-09,266073786,266073786,0,https://raw.githubusercontent.com/pcm-dpc/COVID-19/master/dati-json/dpc-covid19-ita-andamento-nazionale-latest.json,100317128,165756658,0,0,0.7948178037038717,0,0,100317128,165756658
Italy,2023-02-10,266620812,266620812,547026,https://raw.githubusercontent.com/pcm-dpc/COVID-19/master/dati-json/dpc-covid19-ita-andamento-nazionale-latest.json,100437822,166182990,120694,426332,0.7793633209390413,120694,426332,100437822,166182990
Italy,2023-02-11,266620812,266620812,0,https://raw.githubusercontent.com/pcm-dpc/COVID-19/master/dati-json/dpc-covid19-ita-andamento-nazionale-latest.json,100437822,166182990,0,0,0.7793633209390413,0,0,100437822,166182990
Italy,2023-02-12,266620812,266620812,0,https://raw.githubusercontent.com/pcm-dpc/COVID-19/master/dati-json/dpc-covid19-ita-andamento-nazionale-latest.json,100437822,166182990,0,0,0.7793633209390413,0,0,100437822,166182990
Italy,2023-02-13,266620812,266620812,0,https://raw.githubusercontent.com/pcm-dpc/COVID-19/master/dati-json/dpc-covid19-ita-andamento-nazionale-latest.json,100437822,166182990,0,0,0.7793633209390413,0,0,100437822,166182990
Italy,2023-02-14,266620812,266620812,0,https://raw.githubusercontent.com/pcm-dpc/COVID-19/master/dati-json/dpc-covid19-ita-andamento-nazionale-latest.json,100437822,166182990,0,0,0.7793633209390413,0,0,100437822,166182990
Lithuania,2021-03-24,2303779,2303779,9131,https://e.infogram.com/57e5b447-c2ca-40da-aedb-cbf97df68a8e?parent_url=https%3A%2F%2Fosp.stat.gov.lt%2Fpraejusios-paros-covid-19-statistika&src=embed#async_embed,2255040,48739,8227,904,0.09900339502792685,8227,904,2255040,48739
Lithuania,2021-03-25,2312965,2312965,9186,https://e.infogram.com/57e5b447-c2ca-40da-aedb-cbf97df68a8e?parent_url=https%3A%2F%2Fosp.stat.gov.lt%2Fpraejusios-paros-covid-19-statistika&src=embed#async_embed,2263054,49911,8014,1172,0.1275854561288918,8014,1172,2263054,49911
Lithuania,2021-03-26,2322847,2322847,9882,https://e.infogram.com/57e5b447-c2ca-40da-aedb-cbf97df68a8e?parent_url=https%3A%2F%2Fosp.stat.gov.lt%2Fpraejusios-paros-covid-19-statistika&src=embed#async_embed,2271964,50883,8910,972,0.09836065573770492,8910,972,2271964,50883
Lithuania,2021-03-27,2335804,2335804,12957,https://e.infogram.com/57e5b447-c2ca-40da-aedb-cbf97df68a8e?parent_url=https%3A%2F%2Fosp.stat.gov.lt%2Fpraejusios-paros-covid-19-statistika&src=embed#async_embed,2281732,54072,9768,3189,0.2461217874507988,9768,3189,2281732,54072
Lithuania,2021-03-28,2344310,2344310,8506,https://e.infogram.com/57e5b447-c2ca-40da-aedb-cbf97df68a8e?parent_url=https%3A%2F%2Fosp.stat.gov.lt%2Fpraejusios-paros-covid-19-statistika&src=embed#async_embed,2289122,55188,7390,1116,0.13120150482012696,7390,1116,2289122,55188
Lithuania,2021-03-29,2349847,2349847,5537,https://e.infogram.com/57e5b447-c2ca-40da-aedb-cbf97df68a8e?parent_url=https%3A%2F%2Fosp.stat.gov.lt%2Fpraejusios-paros-covid-19-statistika&src=embed#async_embed,2293605,56242,4483,1054,0.19035578833303232,4483,1054,2293605,56242
Lithuania,2021-03-30,2360989,2360989,11142,https://e.infogram.com/57e5b447-c2ca-40da-aedb-cbf97df68a8e?parent_url=https%3A%2F%2Fosp.stat.gov.lt%2Fpraejusios-paros-covid-19-statistika&src=embed#async_embed,2301236,59753,7631,3511,0.3151139831269072,7631,3511,2301236,59753
Lithuania,2021-03-31,2375342,2375342,14353,https://e.infogram.com/57e5b447-c2ca-40da-aedb-cbf97df68a8e?parent_url=https%3A%2F%2Fosp.stat.gov.lt%2Fpraejusios-paros-covid-19-statistika&src=embed#async_embed,2311399,63943,10163,4190,0.29192503309412665,10163,4190,2311399,63943
Lithuania,2021-04-01,2389769,2389769,14427,https://e.infogram.com/57e5b447-c2ca-40da-aedb-cbf97df68a8e?parent_url=https%3A%2F%2Fosp.stat.gov.lt%2Fpraejusios-paros-covid-19-statistika&src=embed#async_embed,2321216,68553,9817,4610,0.31953975185416233,9817,4610,2321216,68553
Lithuania,2021-04-02,2404822,2404822,15053,https://e.infogram.com/57e5b447-c2ca-40da-aedb-cbf97df68a8e?parent_url=https%3A%2F%2Fosp.stat.gov.lt%2Fpraejusios-paros-covid-19-statistika&src=embed#async_embed,2331493,73329,10277,4776,0.31727894771806286,10277,4776,2331493,73329
Lithuania,2021-04-03,2420206,2420206,15384,https://e.infogram.com/57e5b447-c2ca-40da-aedb-cbf97df68a8e?parent_url=https%3A%2F%2Fosp.stat.gov.lt%2Fpraejusios-paros-covid-19-statistika&src=embed#async_embed,2341967,78239,10474,4910,0.31916276651066045,10474,4910,2341967,78239
Lithuania,2021-04-04,2428457,2428457,8251,https://e.infogram.com/57e5b447-c2ca-40da-aedb-cbf97df68a8e?parent_url=https%3A%2F%2Fosp.stat.gov.lt%2Fpraejusios-paros-covid-19-statistika&src=embed#async_embed,2347588,80869,5621,2630,0.3187492425160587,5621,2630,2347588,80869
Lithuania,2021-04-05,2433337,2433337,4880,https://e.infogram.com/57e5b447-c2ca-40da-aedb-cbf97df68a8e?parent_url=https%3A%2F%2Fosp.stat.gov.lt%2Fpraejusios-paros-covid-19-statistika&src=embed#async_embed,2351362,81975,3774,1106,0.2266393442622951,3774,1106,2351362,81975
Lithuania,2021-04-06,2439009,2439009,5672,https://e.infogram.com/57e5b447-c2ca-40da-aedb-cbf97df68a8e?parent_url=https%3A%2F%2Fosp.stat.gov.lt%2Fpraejusios-paros-covid-19-statistika&src=embed#async_embed,2355155,83854,3793,1879,0.33127644569816644,3793,1879,2355155,83854
Lithuania,2021-04-07,2454232,2454232,15223,https://e.infogram.com/57e5b447-c2ca-40da-aedb-cbf97df68a8e?parent_url=https%3A%2F%2Fosp.stat.gov.lt%2Fpraejusios-paros-covid-19-statistika&src=embed#async_embed,2364123,90109,8968,6255,0.41089141430729814,8968,6255,2364123,90109
Lithuania,2021-04-08,2471587,2471587,17355,https://e.infogram.com/57e5b447-c2ca-40da-aedb-cbf97df68a8e?parent_url=https%3A%2F%2Fosp.stat.gov.lt%2Fpraejusios-paros-covid-19-statistika&src=embed#async_embed,2374575,97012,10452,6903,0.39775280898876403,10452,6903,2374575,97012
Lithuania,2021-04-09,2489297,2489297,17710,https://e.infogram.com/57e5b447-c2ca-40da-aedb-cbf97df68a8e?parent_url=https%3A%2F%2Fosp.stat.gov.lt%2Fpraejusios-paros-covid-19-statistika&src=embed#async_embed,2385962,103335,11387,6323,0.357029926595144,11387,6323,2385962,103335
Lithuania,2021-04-10,2507855,2507855,18558,https://e.infogram.com/57e5b447-c2ca-40da-aedb-cbf97df68a8e?parent_url=https%3A%2F%2Fosp.stat.gov.lt%2Fpraejusios-paros-covid-19-statistika&src=embed#async_embed,2397265,110590,11303,7255,0.39093652333225565,11303,7255,2397265,110590
Lithuania,2021-04-11,2519087,2519087,11232,https://e.infogram.com/57e5b447-c2ca-40da-aedb-cbf97df68a8e?parent_url=https%3A%2F%2Fosp.stat.gov.lt%2Fpraejusios-paros-covid-19-statistika&src=embed#async_embed,2404313,114774,7048,4184,0.37250712250712253,7048,4184,2404313,114774
Lithuania,2021-04-12,2527967,2527967,8880,https://e.infogram.com/57e5b447-c2ca-40da-aedb-cbf97df68a8e?parent_url=https%3A%2F%2Fosp.stat.gov.lt%2Fpraejusios-paros-covid-19-statistika&src=embed#async_embed,2410591,117376,6278,2602,0.293018018018018,6278,2602,2410591,117376
Lithuania,2021-04-13,2546234,2546234,18267,https://e.infogram.com/57e5b447-c2ca-40da-aedb-cbf97df68a8e?parent_url=https%3A%2F%2Fosp.stat.gov.lt%2Fpraejusios-paros-covid-19-statistika&src=embed#async_embed,2421284,124950,10693,7574,0.4146274703016368,10693,7574,2421284,124950
Lithuania,2021-04-14,2567678,2567678,21444,https://e.infogram.com/57e5b447-c2ca-40da-aedb-cbf97df68a8e?parent_url=https%3A%2F%2Fosp.stat.gov.lt%2Fpraejusios-paros-covid-19-statistika&src=embed#async_embed,2434983,132695,13699,7745,0.36117328856556613,13699,7745,2434983,132695
Lithuania,2021-04-15,2586250,2586250,18572,https://e.infogram.com/57e5b447-c2ca-40da-aedb-cbf97df68a8e?parent_url=https%3A%2F%2Fosp.stat.gov.lt%2Fpraejusios-paros-covid-19-statistika&src=embed#async_embed,2445668,140582,10685,7887,0.42467154856773637,10685,7887,2445668,140582
Lithuania,2021-04-16,2606339,2606339,20089,https://e.infogram.com/57e5b447-c2ca-40da-aedb-cbf97df68a8e?parent_url=https%3A%2F%2Fosp.stat.gov.lt%2Fpraejusios-paros-covid-19-statistika&src=embed#async_embed,2457663,148676,11995,8094,0.4029070635671263,11995,8094,2457663,148676
Lithuania,2021-04-17,2626203,2626203,19864,https://e.infogram.com/57e5b447-c2ca-40da-aedb-cbf97df68a8e?parent_url=https%3A%2F%2Fosp.stat.gov.lt%2Fpraejusios-paros-covid-19-statistika&src=embed#async_embed,2469184,157019,11521,8343,0.42000604107933953,11521,8343,2469184,157019
Lithuania,2021-04-18,2641378,2641378,15175,https://e.infogram.com/57e5b447-c2ca-40da-aedb-cbf97df68a8e?parent_url=https%3A%2F%2Fosp.stat.gov.lt%2Fpraejusios-paros-covid-19-statistika&src=embed#async_embed,2478901,162477,9717,5458,0.359670510708402,9717,5458,2478901,162477
Lithuania,2021-04-19,2650048,2650048,8670,https://e.infogram.com/57e5b447-c2ca-40da-aedb-cbf97df68a8e?parent_url=https%3A%2F%2Fosp.stat.gov.lt%2Fpraejusios-paros-covid-19-statistika&src=embed#async_embed,2484198,165850,5297,3373,0.38904267589388697,5297,3373,2484198,165850
Lithuania,2021-04-20,2669941,2669941,19893,https://e.infogram.com/57e5b447-c2ca-40da-aedb-cbf97df68a8e?parent_url=https%3A%2F%2Fosp.stat.gov.lt%2Fpraejusios-paros-covid-19-statistika&src=embed#async_embed,2494915,175026,10717,9176,0.46126778263710855,10717,9176,2494915,175026
Lithuania,2021-04-21,2669941,2669941,0,https://e.infogram.com/57e5b447-c2ca-40da-aedb-cbf97df68a8e?parent_url=https%3A%2F%2Fosp.stat.gov.lt%2Fpraejusios-paros-covid-19-statistika&src=embed#async_embed,2494915,175026,0,0,0.46126778263710855,0,0,2494915,175026
Lithuania,2021-04-22,2669941,2669941,0,https://e.infogram.com/57e5b447-c2ca-40da-aedb-cbf97df68a8e?parent_url=https%3A%2F%2Fosp.stat.gov.lt%2Fpraejusios-paros-covid-19-statistika&src=embed#async_embed,2494915,175026,0,0,0.46126778263710855,0,0,2494915,175026
Lithuania,2021-04-23,2669941,2669941,0,https://e.infogram.com/57e5b447-c2ca-40da-aedb-cbf97df68a8e?parent_url=https%3A%2F%2Fosp.stat.gov.lt%2Fpraejusios-paros-covid-19-statistika&src=embed#async_embed,2494915,175026,0,0,0.46126778263710855,0,0,2494915,175026
Lithuania,2021-04-24,2669941,2669941,0,https://e.infogram.com/57e5b447-c2ca-40da-aedb-cbf97df68a8e?parent_url=https%3A%2F%2Fosp.stat.gov.lt%2Fpraejusios-paros-covid-19-statistika&src=embed#async_embed,2494915,175026,0,0,0.46126778263710855,0,0,2494915,175026
Lithuania,2021-04-25,2669941,2669941,0,https://e.infogram.com/57e5b447-c2ca-40da-aedb-cbf97df68a8e?parent_url=https%3A%2F%2Fosp.stat.gov.lt%2Fpraejusios-paros-covid-19-statistika&src=embed#async_embed,2494915,175026,0,0,0.46126778263710855,0,0,2494915,175026
Lithuania,2021-04-26,2669941,2669941,0,https://e.infogram.com/57e5b447-c2ca-40da-aedb-cbf97df68a8e?parent_url=https%3A%2F%2Fosp.stat.gov.lt%2Fpraejusios-paros-covid-19-statistika&src=embed#async_embed,2494915,175026,0,0,0.46126778263710855,0,0,2494915,175026
Lithuania,2021-04-27,2818527,2818527,148586,https://e.infogram.com/57e5b447-c2ca-40da-aedb-cbf97df68a8e?parent_url=https%3A%2F%2Fosp.stat.gov.lt%2Fpraejusios-paros-covid-19-statistika&src=embed#async_embed,2494915,175026,0,0,0.46126778263710855,80048,68538,2574963,243564
Lithuania,2021-04-28,2818527,2818527,0,https://e.infogram.com/57e5b447-c2ca-40da-aedb-cbf97df68a8e?parent_url=https%3A%2F%2Fosp.stat.gov.lt%2Fpraejusios-paros-covid-19-statistika&src=embed#async_embed,2494915,175026,0,0,0.46126778263710855,0,0,2574963,243564
Lithuania,2021-04-29,2818527,2818527,0,https://e.infogram.com/57e5b447-c2ca-40da-aedb-cbf97df68a8e?parent_url=https%3A%2F%2Fosp.stat.gov.lt%2Fpraejusios-paros-covid-19-statistika&src=embed#async_embed,2494915,175026,0,0,0.46126778263710855,0,0,2574963,243564
Lithuania,2021-04-30,2818527,2818527,0,https://e.infogram.com/57e5b447-c2ca-40da-aedb-cbf97df68a8e?parent_url=https%3A%2F%2Fosp.stat.gov.lt%2Fpraejusios-paros-covid-19-statistika&src=embed#async_embed,2494915,175026,0,0,0.46126778263710855,0,0,2574963,243564
Lithuania,2021-05-01,2818527,2818527,0,https://e.infogram.com/57e5b447-c2ca-40da-aedb-cbf97df68a8e?parent_url=https%3A%2F%2Fosp.stat.gov.lt%2Fpraejusios-paros-covid-19-statistika&src=embed#async_embed,2494915,175026,0,0,0.46126778263710855,0,0,2574963,243564
Lithuania,2021-05-02,2818527,2818527,0,https://e.infogram.com/57e5b447-c2ca-40da-aedb-cbf97df68a8e?parent_url=https%3A%2F%2Fosp.stat.gov.lt%2Fpraejusios-paros-covid-19-statistika&src=embed#async_embed,2494915,175026,0,0,0.46126778263710855,0,0,2574963,243564
Lithuania,2021-05-03,2818527,2818527,0,https://e.infogram.com/57e5b447-c2ca-40da-aedb-cbf97df68a8e?parent_url=https%3A%2F%2Fosp.stat.gov.lt%2Fpraejusios-paros-covid-19-statistika&src=embed#async_embed,2494915,175026,0,0,0.46126778263710855,0,0,2574963,243564
Lithuania,2021-05-04,2818527,2818527,0,https://e.infogram.com/57e5b447-c2ca-40da-aedb-cbf97df68a8e?parent_url=https%3A%2F%2Fosp.stat.gov.lt%2Fpraejusios-paros-covid-19-statistika&src=embed#async_embed,2494915,175026,0,0,0.46126778263710855,0,0,2574963,243564
Lithuania,2021-05-05,2818527,2818527,0,https://e.infogram.com/57e5b447-c2ca-40da-aedb-cbf97df68a8e?parent_url=https%3A%2F%2Fosp.stat.gov.lt%2Fpraejusios-paros-covid-19-statistika&src=embed#async_embed,2494915,175026,0,0,0.46126778263710855,0,0,2574963,243564
Lithuania,2021-05-06,2818527,2818527,0,https://e.infogram.com/57e5b447-c2ca-40da-aedb-cbf97df68a8e?parent_url=https%3A%2F%2Fosp.stat.gov.lt%2Fpraejusios-paros-covid-19-statistika&src=embed#async_embed,2494915,175026,0,0,0.46126778263710855,0,0,2574963,243564
Lithuania,2021-05-07,2818527,2818527,0,https://e.infogram.com/57e5b447-c2ca-40da-aedb-cbf97df68a8e?parent_url=https%3A%2F%2Fosp.stat.gov.lt%2Fpraejusios-paros-covid-19-statistika&src=embed#async_embed,2494915,175026,0,0,0.46126778263710855,0,0,2574963,243564
Lithuania,2021-05-08,2818527,2818527,0,https://e.infogram.com/57e5b447-c2ca-40da-aedb-cbf97df68a8e?parent_url=https%3A%2F%2Fosp.stat.gov.lt%2Fpraejusios-paros-covid-19-statistika&src=embed#async_embed,2494915,175026,0,0,0.46126778263710855,0,0,2574963,243564
Lithuania,2021-05-09,3066452,3066452,247925,https://e.infogram.com/57e5b447-c2ca-40da-aedb-cbf97df68a8e?parent_url=https%3A%2F%2Fosp.stat.gov.lt%2Fpraejusios-paros-covid-19-statistika&src=embed#async_embed,2494915,175026,0,0,0.46126778263710855,133565,114360,2708528,357924
Lithuania,2021-05-10,3066452,3066452,0,https://e.infogram.com/57e5b447-c2ca-40da-aedb-cbf97df68a8e?parent_url=https%3A%2F%2Fosp.stat.gov.lt%2Fpraejusios-paros-covid-19-statistika&src=embed#async_embed,2494915,175026,0,0,0.46126778263710855,0,0,2708528,357924
Lithuania,2021-05-11,3114785,3114785,48333,https://e.infogram.com/57e5b447-c2ca-40da-aedb-cbf97df68a8e?parent_url=https%3A%2F%2Fosp.stat.gov.lt%2Fpraejusios-paros-covid-19-statistika&src=embed#async_embed,2494915,175026,0,0,0.46126778263710855,26039,22294,2734567,380218
Lithuania,2021-05-12,3114785,3114785,0,https://e.infogram.com/57e5b447-c2ca-40da-aedb-cbf97df68a8e?parent_url=https%3A%2F%2Fosp.stat.gov.lt%2Fpraejusios-paros-covid-19-statistika&src=embed#async_embed,2494915,175026,0,0,0.46126778263710855,0,0,2734567,380218
Lithuania,2021-05-13,3114785,3114785,0,https://e.infogram.com/57e5b447-c2ca-40da-aedb-cbf97df68a8e?parent_url=https%3A%2F%2Fosp.stat.gov.lt%2Fpraejusios-paros-covid-19-statistika&src=embed#async_embed,2494915,175026,0,0,0.46126778263710855,0,0,2734567,380218
Lithuania,2021-05-14,3114785,3114785,0,https://e.infogram.com/57e5b447-c2ca-40da-aedb-cbf97df68a8e?parent_url=https%3A%2F%2Fosp.stat.gov.lt%2Fpraejusios-paros-covid-19-statistika&src=embed#async_embed,2494915,175026,0,0,0.46126778263710855,0,0,2734567,380218
Lithuania,2021-05-15,3200240,3200240,85455,https://e.infogram.com/57e5b447-c2ca-40da-aedb-cbf97df68a8e?parent_url=https%3A%2F%2Fosp.stat.gov.lt%2Fpraejusios-paros-covid-19-statistika&src=embed#async_embed,2494915,175026,0,0,0.46126778263710855,46037,39418,2780604,419636
Lithuania,2021-05-16,3200240,3200240,0,https://e.infogram.com/57e5b447-c2ca-40da-aedb-cbf97df68a8e?parent_url=https%3A%2F%2Fosp.stat.gov.lt%2Fpraejusios-paros-covid-19-statistika&src=embed#async_embed,2494915,175026,0,0,0.46126778263710855,0,0,2780604,419636
Lithuania,2021-05-17,3225539,3225539,25299,https://e.infogram.com/57e5b447-c2ca-40da-aedb-cbf97df68a8e?parent_url=https%3A%2F%2Fosp.stat.gov.lt%2Fpraejusios-paros-covid-19-statistika&src=embed#async_embed,2494915,175026,0,0,0.46126778263710855,13629,11670,2794233,431306
Lithuania,2021-05-18,3225539,3225539,0,https://e.infogram.com/57e5b447-c2ca-40da-aedb-cbf97df68a8e?parent_url=https%3A%2F%2Fosp.stat.gov.lt%2Fpraejusios-paros-covid-19-statistika&src=embed#async_embed,2494915,175026,0,0,0.46126778263710855,0,0,2794233,431306
Lithuania,2021-05-19,3248813,3248813,23274,https://e.infogram.com/57e5b447-c2ca-40da-aedb-cbf97df68a8e?parent_url=https%3A%2F%2Fosp.stat.gov.lt%2Fpraejusios-paros-covid-19-statistika&src=embed#async_embed,2857438,391375,362523,216349,0.3737423817355132,14576,8698,2808809,440004
Lithuania,2021-05-20,3278878,3278878,30065,https://e.infogram.com/57e5b447-c2ca-40da-aedb-cbf97df68a8e?parent_url=https%3A%2F%2Fosp.stat.gov.lt%2Fpraejusios-paros-covid-19-statistika&src=embed#async_embed,2877262,401616,19824,10241,0.34062863795110593,19824,10241,2828633,450245
Lithuania,2021-05-21,3299318,3299318,20440,https://e.infogram.com/57e5b447-c2ca-40da-aedb-cbf97df68a8e?parent_url=https%3A%2F%2Fosp.stat.gov.lt%2Fpraejusios-paros-covid-19-statistika&src=embed#async_embed,2890942,408376,13680,6760,0.33072407045009783,13680,6760,2842313,457005
Lithuania,2021-05-22,3326083,3326083,26765,https://e.infogram.com/57e5b447-c2ca-40da-aedb-cbf97df68a8e?parent_url=https%3A%2F%2Fosp.stat.gov.lt%2Fpraejusios-paros-covid-19-statistika&src=embed#async_embed,2910693,415390,19751,7014,0.26205865869605827,19751,7014,2862064,464019
Lithuania,2021-05-23,3336463,3336463,10380,https://e.infogram.com/57e5b447-c2ca-40da-aedb-cbf97df68a8e?parent_url=https%3A%2F%2Fosp.stat.gov.lt%2Fpraejusios-paros-covid-19-statistika&src=embed#async_embed,2918151,418312,7458,2922,0.2815028901734104,7458,2922,2869522,466941
Lithuania,2021-05-24,3342360,3342360,5897,https://e.infogram.com/57e5b447-c2ca-40da-aedb-cbf97df68a8e?parent_url=https%3A%2F%2Fosp.stat.gov.lt%2Fpraejusios-paros-covid-19-statistika&src=embed#async_embed,2921301,421059,3150,2747,0.4658300830930982,3150,2747,2872672,469688
Lithuania,2021-05-25,3362757,3362757,20397,https://e.infogram.com/57e5b447-c2ca-40da-aedb-cbf97df68a8e?parent_url=https%3A%2F%2Fosp.stat.gov.lt%2Fpraejusios-paros-covid-19-statistika&src=embed#async_embed,2931594,431163,10293,10104,0.49536696573025446,10293,10104,2882965,479792
Lithuania,2021-05-26,3389285,3389285,26528,https://e.infogram.com/57e5b447-c2ca-40da-aedb-cbf97df68a8e?parent_url=https%3A%2F%2Fosp.stat.gov.lt%2Fpraejusios-paros-covid-19-statistika&src=embed#async_embed,2949292,439993,17698,8830,0.3328558504221954,17698,8830,2900663,488622
Lithuania,2021-05-27,3416169,3416169,26884,https://e.infogram.com/57e5b447-c2ca-40da-aedb-cbf97df68a8e?parent_url=https%3A%2F%2Fosp.stat.gov.lt%2Fpraejusios-paros-covid-19-statistika&src=embed#async_embed,2969165,447004,19873,7011,0.26078708525517036,19873,7011,2920536,495633
Lithuania,2021-05-28,3438548,3438548,22379,https://e.infogram.com/57e5b447-c2ca-40da-aedb-cbf97df68a8e?parent_url=https%3A%2F%2Fosp.stat.gov.lt%2Fpraejusios-paros-covid-19-statistika&src=embed#async_embed,2984755,453793,15590,6789,0.3033647616068636,15590,6789,2936126,502422
Lithuania,2021-05-29,3464015,3464015,25467,https://e.infogram.com/57e5b447-c2ca-40da-aedb-cbf97df68a8e?parent_url=https%3A%2F%2Fosp.stat.gov.lt%2Fpraejusios-paros-covid-19-statistika&src=embed#async_embed,3000383,463632,15628,9839,0.3863431106922684,15628,9839,2951754,512261
Lithuania,2021-05-30,3474616,3474616,10601,https://e.infogram.com/57e5b447-c2ca-40da-aedb-cbf97df68a8e?parent_url=https%3A%2F%2Fosp.stat.gov.lt%2Fpraejusios-paros-covid-19-statistika&src=embed#async_embed,3006318,468298,5935,4666,0.440147155928686,5935,4666,2957689,516927
Lithuania,2021-05-31,3480438,3480438,5822,https://e.infogram.com/57e5b447-c2ca-40da-aedb-cbf97df68a8e?parent_url=https%3A%2F%2Fosp.stat.gov.lt%2Fpraejusios-paros-covid-19-statistika&src=embed#async_embed,3008817,471621,2499,3323,0.5707660597732738,2499,3323,2960188,520250
Lithuania,2021-06-01,3503963,3503963,23525,https://e.infogram.com/57e5b447-c2ca-40da-aedb-cbf97df68a8e?parent_url=https%3A%2F%2Fosp.stat.gov.lt%2Fpraejusios-paros-covid-19-statistika&src=embed#async_embed,3022592,481371,13775,9750,0.41445270988310307,13775,9750,2973963,530000
Lithuania,2021-06-02,3529137,3529137,25174,https://e.infogram.com/57e5b447-c2ca-40da-aedb-cbf97df68a8e?parent_url=https%3A%2F%2Fosp.stat.gov.lt%2Fpraejusios-paros-covid-19-statistika&src=embed#async_embed,3040405,488732,17813,7361,0.2924048621593708,17813,7361,2991776,537361
Lithuania,2021-06-03,3553949,3553949,24812,https://e.infogram.com/57e5b447-c2ca-40da-aedb-cbf97df68a8e?parent_url=https%3A%2F%2Fosp.stat.gov.lt%2Fpraejusios-paros-covid-19-statistika&src=embed#async_embed,3059231,494718,18826,5986,0.2412542318233113,18826,5986,3010602,543347
Lithuania,2021-06-04,3577838,3577838,23889,https://e.infogram.com/57e5b447-c2ca-40da-aedb-cbf97df68a8e?parent_url=https%3A%2F%2Fosp.stat.gov.lt%2Fpraejusios-paros-covid-19-statistika&src=embed#async_embed,3076086,501752,16855,7034,0.29444514211561806,16855,7034,3027457,550381
Lithuania,2021-06-05,3599328,3599328,21490,https://e.infogram.com/57e5b447-c2ca-40da-aedb-cbf97df68a8e?parent_url=https%3A%2F%2Fosp.stat.gov.lt%2Fpraejusios-paros-covid-19-statistika&src=embed#async_embed,3088688,510640,12602,8888,0.4135877152163797,12602,8888,3040059,559269
Lithuania,2021-06-06,3610554,3610554,11226,https://e.infogram.com/57e5b447-c2ca-40da-aedb-cbf97df68a8e?parent_url=https%3A%2F%2Fosp.stat.gov.lt%2Fpraejusios-paros-covid-19-statistika&src=embed#async_embed,3095287,515267,6599,4627,0.41216818100837344,6599,4627,3046658,563896
Lithuania,2021-06-07,3615913,3615913,5359,https://e.infogram.com/57e5b447-c2ca-40da-aedb-cbf97df68a8e?parent_url=https%3A%2F%2Fosp.stat.gov.lt%2Fpraejusios-paros-covid-19-statistika&src=embed#async_embed,3097663,518250,2376,2983,0.5566337003172234,2376,2983,3049034,566879
Lithuania,2021-06-08,3634155,3634155,18242,https://e.infogram.com/57e5b447-c2ca-40da-aedb-cbf97df68a8e?parent_url=https%3A%2F%2Fosp.stat.gov.lt%2Fpraejusios-paros-covid-19-statistika&src=embed#async_embed,3107807,526348,10144,8098,0.4439206227387348,10144,8098,3059178,574977
Lithuania,2021-06-09,3657762,3657762,23607,https://e.infogram.com/57e5b447-c2ca-40da-aedb-cbf97df68a8e?parent_url=https%3A%2F%2Fosp.stat.gov.lt%2Fpraejusios-paros-covid-19-statistika&src=embed#async_embed,3125498,532264,17691,5916,0.2506036345151862,17691,5916,3076869,580893
Lithuania,2021-06-10,3680457,3680457,22695,https://e.infogram.com/57e5b447-c2ca-40da-aedb-cbf97df68a8e?parent_url=https%3A%2F%2Fosp.stat.gov.lt%2Fpraejusios-paros-covid-19-statistika&src=embed#async_embed,3142134,538323,16636,6059,0.266975104648601,16636,6059,3093505,586952
Lithuania,2021-06-11,3701531,3701531,21074,https://e.infogram.com/57e5b447-c2ca-40da-aedb-cbf97df68a8e?parent_url=https%3A%2F%2Fosp.stat.gov.lt%2Fpraejusios-paros-covid-19-statistika&src=embed#async_embed,3156388,545143,14254,6820,0.32362152415298473,14254,6820,3107759,593772
Lithuania,2021-06-12,3722345,3722345,20814,https://e.infogram.com/57e5b447-c2ca-40da-aedb-cbf97df68a8e?parent_url=https%3A%2F%2Fosp.stat.gov.lt%2Fpraejusios-paros-covid-19-statistika&src=embed#async_embed,3168538,553807,12150,8664,0.4162582876909772,12150,8664,3119909,602436
Lithuania,2021-06-13,3730752,3730752,8407,https://e.infogram.com/57e5b447-c2ca-40da-aedb-cbf97df68a8e?parent_url=https%3A%2F%2Fosp.stat.gov.lt%2Fpraejusios-paros-covid-19-statistika&src=embed#async_embed,3172899,557853,4361,4046,0.48126561199000834,4361,4046,3124270,606482
Lithuania,2021-06-14,3735065,3735065,4313,https://e.infogram.com/57e5b447-c2ca-40da-aedb-cbf97df68a8e?parent_url=https%3A%2F%2Fosp.stat.gov.lt%2Fpraejusios-paros-covid-19-statistika&src=embed#async_embed,3174956,560109,2057,2256,0.5230697890099698,2057,2256,3126327,608738
Lithuania,2021-06-15,3750830,3750830,15765,https://e.infogram.com/57e5b447-c2ca-40da-aedb-cbf97df68a8e?parent_url=https%3A%2F%2Fosp.stat.gov.lt%2Fpraejusios-paros-covid-19-statistika&src=embed#async_embed,3183361,567469,8405,7360,0.4668569616238503,8405,7360,3134732,616098
Lithuania,2021-06-16,3765215,3765215,14385,https://e.infogram.com/57e5b447-c2ca-40da-aedb-cbf97df68a8e?parent_url=https%3A%2F%2Fosp.stat.gov.lt%2Fpraejusios-paros-covid-19-statistika&src=embed#async_embed,3192975,572240,9614,4771,0.3316649287452207,9614,4771,3144346,620869
Lithuania,2021-06-17,3776991,3776991,11776,https://e.infogram.com/57e5b447-c2ca-40da-aedb-cbf97df68a8e?parent_url=https%3A%2F%2Fosp.stat.gov.lt%2Fpraejusios-paros-covid-19-statistika&src=embed#async_embed,3200421,576570,7446,4330,0.36769701086956524,7446,4330,3151792,625199
Lithuania,2021-06-18,3789030,3789030,12039,https://e.infogram.com/57e5b447-c2ca-40da-aedb-cbf97df68a8e?parent_url=https%3A%2F%2Fosp.stat.gov.lt%2Fpraejusios-paros-covid-19-statistika&src=embed#async_embed,3206797,582233,6376,5663,0.4703879059722568,6376,5663,3158168,630862
Lithuania,2021-06-19,3803596,3803596,14566,https://e.infogram.com/57e5b447-c2ca-40da-aedb-cbf97df68a8e?parent_url=https%3A%2F%2Fosp.stat.gov.lt%2Fpraejusios-paros-covid-19-statistika&src=embed#async_embed,3212949,590647,6152,8414,0.5776465742139228,6152,8414,3164320,639276
Lithuania,2021-06-20,3811078,3811078,7482,https://e.infogram.com/57e5b447-c2ca-40da-aedb-cbf97df68a8e?parent_url=https%3A%2F%2Fosp.stat.gov.lt%2Fpraejusios-paros-covid-19-statistika&src=embed#async_embed,3216715,594363,3766,3716,0.49665864742047583,3766,3716,3168086,642992
Lithuania,2021-06-21,3814520,3814520,3442,https://e.infogram.com/57e5b447-c2ca-40da-aedb-cbf97df68a8e?parent_url=https%3A%2F%2Fosp.stat.gov.lt%2Fpraejusios-paros-covid-19-statistika&src=embed#async_embed,3218576,595944,1861,1581,0.4593259732713539,1861,1581,3169947,644573
Lithuania,2021-06-22,3825102,3825102,10582,https://e.infogram.com/57e5b447-c2ca-40da-aedb-cbf97df68a8e?parent_url=https%3A%2F%2Fosp.stat.gov.lt%2Fpraejusios-paros-covid-19-statistika&src=embed#async_embed,3223887,601215,5311,5271,0.4981099981099981,5311,5271,3175258,649844
Lithuania,2021-06-23,3835962,3835962,10860,https://e.infogram.com/57e5b447-c2ca-40da-aedb-cbf97df68a8e?parent_url=https%3A%2F%2Fosp.stat.gov.lt%2Fpraejusios-paros-covid-19-statistika&src=embed#async_embed,3230631,605331,6744,4116,0.37900552486187844,6744,4116,3182002,653960
Lithuania,2021-06-24,3846685,3846685,10723,https://e.infogram.com/57e5b447-c2ca-40da-aedb-cbf97df68a8e?parent_url=https%3A%2F%2Fosp.stat.gov.lt%2Fpraejusios-paros-covid-19-statistika&src=embed#async_embed,3236295,610390,5664,5059,0.4717896111162921,5664,5059,3187666,659019
Lithuania,2021-06-25,3851728,3851728,5043,https://e.infogram.com/57e5b447-c2ca-40da-aedb-cbf97df68a8e?parent_url=https%3A%2F%2Fosp.stat.gov.lt%2Fpraejusios-paros-covid-19-statistika&src=embed#async_embed,3239113,612615,2818,2225,0.4412056315685108,2818,2225,3190484,661244
Lithuania,2021-06-26,3864165,3864165,12437,https://e.infogram.com/57e5b447-c2ca-40da-aedb-cbf97df68a8e?parent_url=https%3A%2F%2Fosp.stat.gov.lt%2Fpraejusios-paros-covid-19-statistika&src=embed#async_embed,3244061,620104,4948,7489,0.6021548604969044,4948,7489,3195432,668733
Lithuania,2021-06-27,3870496,3870496,6331,https://e.infogram.com/57e5b447-c2ca-40da-aedb-cbf97df68a8e?parent_url=https%3A%2F%2Fosp.stat.gov.lt%2Fpraejusios-paros-covid-19-statistika&src=embed#async_embed,3247308,623188,3247,3084,0.48712683620281155,3247,3084,3198679,671817
Lithuania,2021-06-28,3874278,3874278,3782,https://e.infogram.com/57e5b447-c2ca-40da-aedb-cbf97df68a8e?parent_url=https%3A%2F%2Fosp.stat.gov.lt%2Fpraejusios-paros-covid-19-statistika&src=embed#async_embed,3249364,624914,2056,1726,0.45637228979375993,2056,1726,3200735,673543
Lithuania,2021-06-29,3885715,3885715,11437,https://e.infogram.com/57e5b447-c2ca-40da-aedb-cbf97df68a8e?parent_url=https%3A%2F%2Fosp.stat.gov.lt%2Fpraejusios-paros-covid-19-statistika&src=embed#async_embed,3255049,630666,5685,5752,0.5029290897962753,5685,5752,3206420,679295
Lithuania,2021-06-30,3896037,3896037,10322,https://e.infogram.com/57e5b447-c2ca-40da-aedb-cbf97df68a8e?parent_url=https%3A%2F%2Fosp.stat.gov.lt%2Fpraejusios-paros-covid-19-statistika&src=embed#async_embed,3261408,634629,6359,3963,0.3839372214687076,6359,3963,3212779,683258
Lithuania,2021-07-01,3904874,3904874,8837,https://e.infogram.com/57e5b447-c2ca-40da-aedb-cbf97df68a8e?parent_url=https%3A%2F%2Fosp.stat.gov.lt%2Fpraejusios-paros-covid-19-statistika&src=embed#async_embed,3266274,638600,4866,3971,0.44936064275206516,4866,3971,3217645,687229
Lithuania,2021-07-02,3913805,3913805,8931,https://e.infogram.com/57e5b447-c2ca-40da-aedb-cbf97df68a8e?parent_url=https%3A%2F%2Fosp.stat.gov.lt%2Fpraejusios-paros-covid-19-statistika&src=embed#async_embed,3270883,642922,4609,4322,0.4839323703952525,4609,4322,3222254,691551
Lithuania,2021-07-03,3926253,3926253,12448,https://e.infogram.com/57e5b447-c2ca-40da-aedb-cbf97df68a8e?parent_url=https%3A%2F%2Fosp.stat.gov.lt%2Fpraejusios-paros-covid-19-statistika&src=embed#async_embed,3276166,650087,5283,7165,0.575594473007712,5283,7165,3227537,698716
Lithuania,2021-07-04,3932272,3932272,6019,https://e.infogram.com/57e5b447-c2ca-40da-aedb-cbf97df68a8e?parent_url=https%3A%2F%2Fosp.stat.gov.lt%2Fpraejusios-paros-covid-19-statistika&src=embed#async_embed,3279131,653141,2965,3054,0.5073932546934706,2965,3054,3230502,701770
Lithuania,2021-07-05,3935252,3935252,2980,https://e.infogram.com/57e5b447-c2ca-40da-aedb-cbf97df68a8e?parent_url=https%3A%2F%2Fosp.stat.gov.lt%2Fpraejusios-paros-covid-19-statistika&src=embed#async_embed,3280904,654348,1773,1207,0.40503355704697985,1773,1207,3232275,702977
Lithuania,2021-07-06,3946341,3946341,11089,https://e.infogram.com/57e5b447-c2ca-40da-aedb-cbf97df68a8e?parent_url=https%3A%2F%2Fosp.stat.gov.lt%2Fpraejusios-paros-covid-19-statistika&src=embed#async_embed,3287084,659257,6180,4909,0.4426909550004509,6180,4909,3238455,707886
Lithuania,2021-07-07,3950624,3950624,4283,https://e.infogram.com/57e5b447-c2ca-40da-aedb-cbf97df68a8e?parent_url=https%3A%2F%2Fosp.stat.gov.lt%2Fpraejusios-paros-covid-19-statistika&src=embed#async_embed,3289787,660837,2703,1580,0.3689003035255662,2703,1580,3241158,709466
Lithuania,2021-07-08,3959797,3959797,9173,https://e.infogram.com/57e5b447-c2ca-40da-aedb-cbf97df68a8e?parent_url=https%3A%2F%2Fosp.stat.gov.lt%2Fpraejusios-paros-covid-19-statistika&src=embed#async_embed,3295381,664416,5594,3579,0.39016679385152075,5594,3579,3246752,713045
Lithuania,2021-07-09,3970218,3970218,10421,https://e.infogram.com/57e5b447-c2ca-40da-aedb-cbf97df68a8e?parent_url=https%3A%2F%2Fosp.stat.gov.lt%2Fpraejusios-paros-covid-19-statistika&src=embed#async_embed,3301885,668333,6504,3917,0.375875635735534,6504,3917,3253256,716962
Lithuania,2021-07-10,3980451,3980451,10233,https://e.infogram.com/57e5b447-c2ca-40da-aedb-cbf97df68a8e?parent_url=https%3A%2F%2Fosp.stat.gov.lt%2Fpraejusios-paros-covid-19-statistika&src=embed#async_embed,3307189,673262,5304,4929,0.4816769275872178,5304,4929,3258560,721891
Lithuania,2021-07-11,3986710,3986710,6259,https://e.infogram.com/57e5b447-c2ca-40da-aedb-cbf97df68a8e?parent_url=https%3A%2F%2Fosp.stat.gov.lt%2Fpraejusios-paros-covid-19-statistika&src=embed#async_embed,3311445,675265,4256,2003,0.32001917239175587,4256,2003,3262816,723894
Lithuania,2021-07-12,3989619,3989619,2909,https://e.infogram.com/57e5b447-c2ca-40da-aedb-cbf97df68a8e?parent_url=https%3A%2F%2Fosp.stat.gov.lt%2Fpraejusios-paros-covid-19-statistika&src=embed#async_embed,3313174,676445,1729,1180,0.40563767617738056,1729,1180,3264545,725074
Lithuania,2021-07-13,4000227,4000227,10608,https://e.infogram.com/57e5b447-c2ca-40da-aedb-cbf97df68a8e?parent_url=https%3A%2F%2Fosp.stat.gov.lt%2Fpraejusios-paros-covid-19-statistika&src=embed#async_embed,3319715,680512,6541,4067,0.3833898944193062,6541,4067,3271086,729141
Lithuania,2021-07-14,4009402,4009402,9175,https://e.infogram.com/57e5b447-c2ca-40da-aedb-cbf97df68a8e?parent_url=https%3A%2F%2Fosp.stat.gov.lt%2Fpraejusios-paros-covid-19-statistika&src=embed#async_embed,3325694,683708,5979,3196,0.3483378746594005,5979,3196,3277065,732337
Lithuania,2021-07-15,4018055,4018055,8653,https://e.infogram.com/57e5b447-c2ca-40da-aedb-cbf97df68a8e?parent_url=https%3A%2F%2Fosp.stat.gov.lt%2Fpraejusios-paros-covid-19-statistika&src=embed#async_embed,3331505,686550,5811,2842,0.3284410031203051,5811,2842,3282876,735179
Lithuania,2021-07-16,4026379,4026379,8324,https://e.infogram.com/57e5b447-c2ca-40da-aedb-cbf97df68a8e?parent_url=https%3A%2F%2Fosp.stat.gov.lt%2Fpraejusios-paros-covid-19-statistika&src=embed#async_embed,3337047,689332,5542,2782,0.33421432003844304,5542,2782,3288418,737961
Lithuania,2021-07-17,4037307,4037307,10928,https://e.infogram.com/57e5b447-c2ca-40da-aedb-cbf97df68a8e?parent_url=https%3A%2F%2Fosp.stat.gov.lt%2Fpraejusios-paros-covid-19-statistika&src=embed#async_embed,3343002,694305,5955,4973,0.45506954612005857,5955,4973,3294373,742934
Lithuania,2021-07-18,4044206,4044206,6899,https://e.infogram.com/57e5b447-c2ca-40da-aedb-cbf97df68a8e?parent_url=https%3A%2F%2Fosp.stat.gov.lt%2Fpraejusios-paros-covid-19-statistika&src=embed#async_embed,3347470,696736,4468,2431,0.35236990868241774,4468,2431,3298841,745365
Lithuania,2021-07-19,4047497,4047497,3291,https://e.infogram.com/57e5b447-c2ca-40da-aedb-cbf97df68a8e?parent_url=https%3A%2F%2Fosp.stat.gov.lt%2Fpraejusios-paros-covid-19-statistika&src=embed#async_embed,3349792,697705,2322,969,0.2944393801276208,2322,969,3301163,746334
Lithuania,2021-07-20,4058306,4058306,10809,https://e.infogram.com/57e5b447-c2ca-40da-aedb-cbf97df68a8e?parent_url=https%3A%2F%2Fosp.stat.gov.lt%2Fpraejusios-paros-covid-19-statistika&src=embed#async_embed,3356278,702028,6486,4323,0.3999444907021926,6486,4323,3307649,750657
Lithuania,2021-07-21,4067522,4067522,9216,https://e.infogram.com/57e5b447-c2ca-40da-aedb-cbf97df68a8e?parent_url=https%3A%2F%2Fosp.stat.gov.lt%2Fpraejusios-paros-covid-19-statistika&src=embed#async_embed,3362492,705030,6214,3002,0.3257378472222222,6214,3002,3313863,753659
Lithuania,2021-07-22,4077351,4077351,9829,https://e.infogram.com/57e5b447-c2ca-40da-aedb-cbf97df68a8e?parent_url=https%3A%2F%2Fosp.stat.gov.lt%2Fpraejusios-paros-covid-19-statistika&src=embed#async_embed,3368821,708530,6329,3500,0.35608912402075493,6329,3500,3320192,757159
Lithuania,2021-07-23,4087839,4087839,10488,https://e.infogram.com/57e5b447-c2ca-40da-aedb-cbf97df68a8e?parent_url=https%3A%2F%2Fosp.stat.gov.lt%2Fpraejusios-paros-covid-19-statistika&src=embed#async_embed,3375219,712620,6398,4090,0.38996948893974065,6398,4090,3326590,761249
Lithuania,2021-07-24,4101220,4101220,13381,https://e.infogram.com/57e5b447-c2ca-40da-aedb-cbf97df68a8e?parent_url=https%3A%2F%2Fosp.stat.gov.lt%2Fpraejusios-paros-covid-19-statistika&src=embed#async_embed,3381579,719641,6360,7021,0.5246992003587175,6360,7021,3332950,768270
Lithuania,2021-07-25,4108642,4108642,7422,https://e.infogram.com/57e5b447-c2ca-40da-aedb-cbf97df68a8e?parent_url=https%3A%2F%2Fosp.stat.gov.lt%2Fpraejusios-paros-covid-19-statistika&src=embed#async_embed,3385951,722691,4372,3050,0.410940447318782,4372,3050,3337322,771320
Lithuania,2021-07-26,4113004,4113004,4362,https://e.infogram.com/57e5b447-c2ca-40da-aedb-cbf97df68a8e?parent_url=https%3A%2F%2Fosp.stat.gov.lt%2Fpraejusios-paros-covid-19-statistika&src=embed#async_embed,3388250,724754,2299,2063,0.4729481889041724,2299,2063,3339621,773383
Lithuania,2021-07-27,4127300,4127300,14296,https://e.infogram.com/57e5b447-c2ca-40da-aedb-cbf97df68a8e?parent_url=https%3A%2F%2Fosp.stat.gov.lt%2Fpraejusios-paros-covid-19-statistika&src=embed#async_embed,3394695,732605,6445,7851,0.5491745942921097,6445,7851,3346066,781234
Lithuania,2021-07-28,4140501,4140501,13201,https://e.infogram.com/57e5b447-c2ca-40da-aedb-cbf97df68a8e?parent_url=https%3A%2F%2Fosp.stat.gov.lt%2Fpraejusios-paros-covid-19-statistika&src=embed#async_embed,3401031,739470,6336,6865,0.5200363608817514,6336,6865,3352402,788099
Lithuania,2021-07-29,4155591,4155591,15090,https://e.infogram.com/57e5b447-c2ca-40da-aedb-cbf97df68a8e?parent_url=https%3A%2F%2Fosp.stat.gov.lt%2Fpraejusios-paros-covid-19-statistika&src=embed#async_embed,3408241,747350,7210,7880,0.5222001325381047,7210,7880,3359612,795979
Lithuania,2021-07-30,4169442,4169442,13851,https://e.infogram.com/57e5b447-c2ca-40da-aedb-cbf97df68a8e?parent_url=https%3A%2F%2Fosp.stat.gov.lt%2Fpraejusios-paros-covid-19-statistika&src=embed#async_embed,3414627,754815,6386,7465,0.5389502562991841,6386,7465,3365998,803444
Lithuania,2021-07-31,4186084,4186084,16642,https://e.infogram.com/57e5b447-c2ca-40da-aedb-cbf97df68a8e?parent_url=https%3A%2F%2Fosp.stat.gov.lt%2Fpraejusios-paros-covid-19-statistika&src=embed#async_embed,3421823,764261,7196,9446,0.5676000480711453,7196,9446,3373194,812890
Lithuania,2021-08-01,4194522,4194522,8438,https://e.infogram.com/57e5b447-c2ca-40da-aedb-cbf97df68a8e?parent_url=https%3A%2F%2Fosp.stat.gov.lt%2Fpraejusios-paros-covid-19-statistika&src=embed#async_embed,3425793,768729,3970,4468,0.5295093624081536,3970,4468,3377164,817358
Lithuania,2021-08-02,4200878,4200878,6356,https://e.infogram.com/57e5b447-c2ca-40da-aedb-cbf97df68a8e?parent_url=https%3A%2F%2Fosp.stat.gov.lt%2Fpraejusios-paros-covid-19-statistika&src=embed#async_embed,3429180,771698,3387,2969,0.4671176840780365,3387,2969,3380551,820327
Lithuania,2021-08-03,4217916,4217916,17038,https://e.infogram.com/57e5b447-c2ca-40da-aedb-cbf97df68a8e?parent_url=https%3A%2F%2Fosp.stat.gov.lt%2Fpraejusios-paros-covid-19-statistika&src=embed#async_embed,3436096,781820,6916,10122,0.5940838126540674,6916,10122,3387467,830449
Lithuania,2021-08-04,4234181,4234181,16265,https://e.infogram.com/57e5b447-c2ca-40da-aedb-cbf97df68a8e?parent_url=https%3A%2F%2Fosp.stat.gov.lt%2Fpraejusios-paros-covid-19-statistika&src=embed#async_embed,3443285,790896,7189,9076,0.5580079926221949,7189,9076,3394656,839525
Lithuania,2021-08-05,4243681,4243681,9500,https://e.infogram.com/57e5b447-c2ca-40da-aedb-cbf97df68a8e?parent_url=https%3A%2F%2Fosp.stat.gov.lt%2Fpraejusios-paros-covid-19-statistika&src=embed#async_embed,3445755,797926,2470,7030,0.74,2470,7030,3397126,846555
Lithuania,2021-08-06,4266048,4266048,22367,https://e.infogram.com/57e5b447-c2ca-40da-aedb-cbf97df68a8e?parent_url=https%3A%2F%2Fosp.stat.gov.lt%2Fpraejusios-paros-covid-19-statistika&src=embed#async_embed,3457146,808902,11391,10976,0.4907229400456029,11391,10976,3408517,857531
Lithuania,2021-08-07,4284323,4284323,18275,https://e.infogram.com/57e5b447-c2ca-40da-aedb-cbf97df68a8e?parent_url=https%3A%2F%2Fosp.stat.gov.lt%2Fpraejusios-paros-covid-19-statistika&src=embed#async_embed,3464707,819616,7561,10714,0.586265389876881,7561,10714,3416078,868245
Lithuania,2021-08-08,4293554,4293554,9231,https://e.infogram.com/57e5b447-c2ca-40da-aedb-cbf97df68a8e?parent_url=https%3A%2F%2Fosp.stat.gov.lt%2Fpraejusios-paros-covid-19-statistika&src=embed#async_embed,3469270,824284,4563,4668,0.5056873578160546,4563,4668,3420641,872913
Lithuania,2021-08-09,4300084,4300084,6530,https://e.infogram.com/57e5b447-c2ca-40da-aedb-cbf97df68a8e?parent_url=https%3A%2F%2Fosp.stat.gov.lt%2Fpraejusios-paros-covid-19-statistika&src=embed#async_embed,3472389,827695,3119,3411,0.5223583460949464,3119,3411,3423760,876324
Lithuania,2021-08-10,4300084,4300084,0,https://e.infogram.com/57e5b447-c2ca-40da-aedb-cbf97df68a8e?parent_url=https%3A%2F%2Fosp.stat.gov.lt%2Fpraejusios-paros-covid-19-statistika&src=embed#async_embed,3472389,827695,0,0,0.5223583460949464,0,0,3423760,876324
Lithuania,2021-08-11,4333184,4333184,33100,https://e.infogram.com/57e5b447-c2ca-40da-aedb-cbf97df68a8e?parent_url=https%3A%2F%2Fosp.stat.gov.lt%2Fpraejusios-paros-covid-19-statistika&src=embed#async_embed,3486720,846464,14331,18769,0.5670392749244713,14331,18769,3438091,895093
Lithuania,2021-08-12,4348901,4348901,15717,https://e.infogram.com/57e5b447-c2ca-40da-aedb-cbf97df68a8e?parent_url=https%3A%2F%2Fosp.stat.gov.lt%2Fpraejusios-paros-covid-19-statistika&src=embed#async_embed,3493620,855281,6900,8817,0.5609849207864096,6900,8817,3444991,903910
Lithuania,2021-08-13,4364265,4364265,15364,https://e.infogram.com/57e5b447-c2ca-40da-aedb-cbf97df68a8e?parent_url=https%3A%2F%2Fosp.stat.gov.lt%2Fpraejusios-paros-covid-19-statistika&src=embed#async_embed,3500348,863917,6728,8636,0.5620932048945587,6728,8636,3451719,912546
Lithuania,2021-08-14,4383144,4383144,18879,https://e.infogram.com/57e5b447-c2ca-40da-aedb-cbf97df68a8e?parent_url=https%3A%2F%2Fosp.stat.gov.lt%2Fpraejusios-paros-covid-19-statistika&src=embed#async_embed,3508617,874527,8269,10610,0.5620001059378145,8269,10610,3459988,923156
Lithuania,2021-08-15,4393390,4393390,10246,https://e.infogram.com/57e5b447-c2ca-40da-aedb-cbf97df68a8e?parent_url=https%3A%2F%2Fosp.stat.gov.lt%2Fpraejusios-paros-covid-19-statistika&src=embed#async_embed,3514063,879327,5446,4800,0.4684755026351747,5446,4800,3465434,927956
Lithuania,2021-08-16,4399563,4399563,6173,https://e.infogram.com/57e5b447-c2ca-40da-aedb-cbf97df68a8e?parent_url=https%3A%2F%2Fosp.stat.gov.lt%2Fpraejusios-paros-covid-19-statistika&src=embed#async_embed,3516973,882590,2910,3263,0.5285922566013284,2910,3263,3468344,931219
Lithuania,2021-08-17,4414444,4414444,14881,https://e.infogram.com/57e5b447-c2ca-40da-aedb-cbf97df68a8e?parent_url=https%3A%2F%2Fosp.stat.gov.lt%2Fpraejusios-paros-covid-19-statistika&src=embed#async_embed,3523320,891124,6347,8534,0.5734829648545124,6347,8534,3474691,939753
Lithuania,2021-08-18,4432026,4432026,17582,https://e.infogram.com/57e5b447-c2ca-40da-aedb-cbf97df68a8e?parent_url=https%3A%2F%2Fosp.stat.gov.lt%2Fpraejusios-paros-covid-19-statistika&src=embed#async_embed,3531841,900185,8521,9061,0.5153566147195996,8521,9061,3483212,948814
Lithuania,2021-08-19,4447907,4447907,15881,https://e.infogram.com/57e5b447-c2ca-40da-aedb-cbf97df68a8e?parent_url=https%3A%2F%2Fosp.stat.gov.lt%2Fpraejusios-paros-covid-19-statistika&src=embed#async_embed,3539721,908186,7880,8001,0.503809583779359,7880,8001,3491092,956815
Lithuania,2021-08-20,4464278,4464278,16371,https://e.infogram.com/57e5b447-c2ca-40da-aedb-cbf97df68a8e?parent_url=https%3A%2F%2Fosp.stat.gov.lt%2Fpraejusios-paros-covid-19-statistika&src=embed#async_embed,3547746,916532,8025,8346,0.5098039215686274,8025,8346,3499117,965161
Lithuania,2021-08-21,4481699,4481699,17421,https://e.infogram.com/57e5b447-c2ca-40da-aedb-cbf97df68a8e?parent_url=https%3A%2F%2Fosp.stat.gov.lt%2Fpraejusios-paros-covid-19-statistika&src=embed#async_embed,3555364,926335,7618,9803,0.5627116698237759,7618,9803,3506735,974964
Lithuania,2021-08-22,4491026,4491026,9327,https://e.infogram.com/57e5b447-c2ca-40da-aedb-cbf97df68a8e?parent_url=https%3A%2F%2Fosp.stat.gov.lt%2Fpraejusios-paros-covid-19-statistika&src=embed#async_embed,3560135,930891,4771,4556,0.488474321861263,4771,4556,3511506,979520
Lithuania,2021-08-23,4497200,4497200,6174,https://e.infogram.com/57e5b447-c2ca-40da-aedb-cbf97df68a8e?parent_url=https%3A%2F%2Fosp.stat.gov.lt%2Fpraejusios-paros-covid-19-statistika&src=embed#async_embed,3563440,933760,3305,2869,0.4646906381600259,3305,2869,3514811,982389
Lithuania,2021-08-24,4513698,4513698,16498,https://e.infogram.com/57e5b447-c2ca-40da-aedb-cbf97df68a8e?parent_url=https%3A%2F%2Fosp.stat.gov.lt%2Fpraejusios-paros-covid-19-statistika&src=embed#async_embed,3570766,942932,7326,9172,0.555946175293975,7326,9172,3522137,991561
Lithuania,2021-08-25,4528234,4528234,14536,https://e.infogram.com/57e5b447-c2ca-40da-aedb-cbf97df68a8e?parent_url=https%3A%2F%2Fosp.stat.gov.lt%2Fpraejusios-paros-covid-19-statistika&src=embed#async_embed,3578217,950017,7451,7085,0.4874105668684645,7451,7085,3529588,998646
Lithuania,2021-08-26,4542899,4542899,14665,https://e.infogram.com/57e5b447-c2ca-40da-aedb-cbf97df68a8e?parent_url=https%3A%2F%2Fosp.stat.gov.lt%2Fpraejusios-paros-covid-19-statistika&src=embed#async_embed,3585840,957059,7623,7042,0.4801909307875895,7623,7042,3537211,1005688
Lithuania,2021-08-27,4542899,4542899,0,https://e.infogram.com/57e5b447-c2ca-40da-aedb-cbf97df68a8e?parent_url=https%3A%2F%2Fosp.stat.gov.lt%2Fpraejusios-paros-covid-19-statistika&src=embed#async_embed,3585840,957059,0,0,0.4801909307875895,0,0,3537211,1005688
Lithuania,2021-08-28,4542899,4542899,0,https://e.infogram.com/57e5b447-c2ca-40da-aedb-cbf97df68a8e?parent_url=https%3A%2F%2Fosp.stat.gov.lt%2Fpraejusios-paros-covid-19-statistika&src=embed#async_embed,3585840,957059,0,0,0.4801909307875895,0,0,3537211,1005688
Lithuania,2021-08-29,4542899,4542899,0,https://e.infogram.com/57e5b447-c2ca-40da-aedb-cbf97df68a8e?parent_url=https%3A%2F%2Fosp.stat.gov.lt%2Fpraejusios-paros-covid-19-statistika&src=embed#async_embed,3585840,957059,0,0,0.4801909307875895,0,0,3537211,1005688
Lithuania,2021-08-30,4542899,4542899,0,https://e.infogram.com/57e5b447-c2ca-40da-aedb-cbf97df68a8e?parent_url=https%3A%2F%2Fosp.stat.gov.lt%2Fpraejusios-paros-covid-19-statistika&src=embed#async_embed,3585840,957059,0,0,0.4801909307875895,0,0,3537211,1005688
Lithuania,2021-08-31,4542899,4542899,0,https://e.infogram.com/57e5b447-c2ca-40da-aedb-cbf97df68a8e?parent_url=https%3A%2F%2Fosp.stat.gov.lt%2Fpraejusios-paros-covid-19-statistika&src=embed#async_embed,3585840,957059,0,0,0.4801909307875895,0,0,3537211,1005688
Lithuania,2021-09-01,4542899,4542899,0,https://e.infogram.com/57e5b447-c2ca-40da-aedb-cbf97df68a8e?parent_url=https%3A%2F%2Fosp.stat.gov.lt%2Fpraejusios-paros-covid-19-statistika&src=embed#async_embed,3585840,957059,0,0,0.4801909307875895,0,0,3537211,1005688
Lithuania,2021-09-02,4542899,4542899,0,https://e.infogram.com/57e5b447-c2ca-40da-aedb-cbf97df68a8e?parent_url=https%3A%2F%2Fosp.stat.gov.lt%2Fpraejusios-paros-covid-19-statistika&src=embed#async_embed,3585840,957059,0,0,0.4801909307875895,0,0,3537211,1005688
Lithuania,2021-09-03,4542899,4542899,0,https://e.infogram.com/57e5b447-c2ca-40da-aedb-cbf97df68a8e?parent_url=https%3A%2F%2Fosp.stat.gov.lt%2Fpraejusios-paros-covid-19-statistika&src=embed#async_embed,3585840,957059,0,0,0.4801909307875895,0,0,3537211,1005688
Lithuania,2021-09-04,4542899,4542899,0,https://e.infogram.com/57e5b447-c2ca-40da-aedb-cbf97df68a8e?parent_url=https%3A%2F%2Fosp.stat.gov.lt%2Fpraejusios-paros-covid-19-statistika&src=embed#async_embed,3585840,957059,0,0,0.4801909307875895,0,0,3537211,1005688
Lithuania,2021-09-05,4542899,4542899,0,https://e.infogram.com/57e5b447-c2ca-40da-aedb-cbf97df68a8e?parent_url=https%3A%2F%2Fosp.stat.gov.lt%2Fpraejusios-paros-covid-19-statistika&src=embed#async_embed,3585840,957059,0,0,0.4801909307875895,0,0,3537211,1005688
Lithuania,2021-09-06,4542899,4542899,0,https://e.infogram.com/57e5b447-c2ca-40da-aedb-cbf97df68a8e?parent_url=https%3A%2F%2Fosp.stat.gov.lt%2Fpraejusios-paros-covid-19-statistika&src=embed#async_embed,3585840,957059,0,0,0.4801909307875895,0,0,3537211,1005688
Lithuania,2021-09-07,4542899,4542899,0,https://e.infogram.com/57e5b447-c2ca-40da-aedb-cbf97df68a8e?parent_url=https%3A%2F%2Fosp.stat.gov.lt%2Fpraejusios-paros-covid-19-statistika&src=embed#async_embed,3585840,957059,0,0,0.4801909307875895,0,0,3537211,1005688
Lithuania,2021-09-08,4542899,4542899,0,https://e.infogram.com/57e5b447-c2ca-40da-aedb-cbf97df68a8e?parent_url=https%3A%2F%2Fosp.stat.gov.lt%2Fpraejusios-paros-covid-19-statistika&src=embed#async_embed,3585840,957059,0,0,0.4801909307875895,0,0,3537211,1005688
Lithuania,2021-09-09,4542899,4542899,0,https://e.infogram.com/57e5b447-c2ca-40da-aedb-cbf97df68a8e?parent_url=https%3A%2F%2Fosp.stat.gov.lt%2Fpraejusios-paros-covid-19-statistika&src=embed#async_embed,3585840,957059,0,0,0.4801909307875895,0,0,3537211,1005688
Lithuania,2021-09-10,4542899,4542899,0,https://e.infogram.com/57e5b447-c2ca-40da-aedb-cbf97df68a8e?parent_url=https%3A%2F%2Fosp.stat.gov.lt%2Fpraejusios-paros-covid-19-statistika&src=embed#async_embed,3585840,957059,0,0,0.4801909307875895,0,0,3537211,1005688
Lithuania,2021-09-11,4542899,4542899,0,https://e.infogram.com/57e5b447-c2ca-40da-aedb-cbf97df68a8e?parent_url=https%3A%2F%2Fosp.stat.gov.lt%2Fpraejusios-paros-covid-19-statistika&src=embed#async_embed,3585840,957059,0,0,0.4801909307875895,0,0,3537211,1005688
Lithuania,2021-09-12,4542899,4542899,0,https://e.infogram.com/57e5b447-c2ca-40da-aedb-cbf97df68a8e?parent_url=https%3A%2F%2Fosp.stat.gov.lt%2Fpraejusios-paros-covid-19-statistika&src=embed#async_embed,3585840,957059,0,0,0.4801909307875895,0,0,3537211,1005688
Lithuania,2021-09-13,4542899,4542899,0,https://e.infogram.com/57e5b447-c2ca-40da-aedb-cbf97df68a8e?parent_url=https%3A%2F%2Fosp.stat.gov.lt%2Fpraejusios-paros-covid-19-statistika&src=embed#async_embed,3585840,957059,0,0,0.4801909307875895,0,0,3537211,1005688
Lithuania,2021-09-14,4542899,4542899,0,https://e.infogram.com/57e5b447-c2ca-40da-aedb-cbf97df68a8e?parent_url=https%3A%2F%2Fosp.stat.gov.lt%2Fpraejusios-paros-covid-19-statistika&src=embed#async_embed,3585840,957059,0,0,0.4801909307875895,0,0,3537211,1005688
Lithuania,2021-09-15,4542899,4542899,0,https://e.infogram.com/57e5b447-c2ca-40da-aedb-cbf97df68a8e?parent_url=https%3A%2F%2Fosp.stat.gov.lt%2Fpraejusios-paros-covid-19-statistika&src=embed#async_embed,3585840,957059,0,0,0.4801909307875895,0,0,3537211,1005688
Lithuania,2021-09-16,4542899,4542899,0,https://e.infogram.com/57e5b447-c2ca-40da-aedb-cbf97df68a8e?parent_url=https%3A%2F%2Fosp.stat.gov.lt%2Fpraejusios-paros-covid-19-statistika&src=embed#async_embed,3585840,957059,0,0,0.4801909307875895,0,0,3537211,1005688
Lithuania,2021-09-17,4542899,4542899,0,https://e.infogram.com/57e5b447-c2ca-40da-aedb-cbf97df68a8e?parent_url=https%3A%2F%2Fosp.stat.gov.lt%2Fpraejusios-paros-covid-19-statistika&src=embed#async_embed,3585840,957059,0,0,0.4801909307875895,0,0,3537211,1005688
Lithuania,2021-09-18,4542899,4542899,0,https://e.infogram.com/57e5b447-c2ca-40da-aedb-cbf97df68a8e?parent_url=https%3A%2F%2Fosp.stat.gov.lt%2Fpraejusios-paros-covid-19-statistika&src=embed#async_embed,3585840,957059,0,0,0.4801909307875895,0,0,3537211,1005688
Lithuania,2021-09-19,4542899,4542899,0,https://e.infogram.com/57e5b447-c2ca-40da-aedb-cbf97df68a8e?parent_url=https%3A%2F%2Fosp.stat.gov.lt%2Fpraejusios-paros-covid-19-statistika&src=embed#async_embed,3585840,957059,0,0,0.4801909307875895,0,0,3537211,1005688
Lithuania,2021-09-20,4542899,4542899,0,https://e.infogram.com/57e5b447-c2ca-40da-aedb-cbf97df68a8e?parent_url=https%3A%2F%2Fosp.stat.gov.lt%2Fpraejusios-paros-covid-19-statistika&src=embed#async_embed,3585840,957059,0,0,0.4801909307875895,0,0,3537211,1005688
Lithuania,2021-09-21,4542899,4542899,0,https://e.infogram.com/57e5b447-c2ca-40da-aedb-cbf97df68a8e?parent_url=https%3A%2F%2Fosp.stat.gov.lt%2Fpraejusios-paros-covid-19-statistika&src=embed#async_embed,3585840,957059,0,0,0.4801909307875895,0,0,3537211,1005688
Lithuania,2021-09-22,4542899,4542899,0,https://e.infogram.com/57e5b447-c2ca-40da-aedb-cbf97df68a8e?parent_url=https%3A%2F%2Fosp.stat.gov.lt%2Fpraejusios-paros-covid-19-statistika&src=embed#async_embed,3585840,957059,0,0,0.4801909307875895,0,0,3537211,1005688
Lithuania,2021-09-23,4542899,4542899,0,https://e.infogram.com/57e5b447-c2ca-40da-aedb-cbf97df68a8e?parent_url=https%3A%2F%2Fosp.stat.gov.lt%2Fpraejusios-paros-covid-19-statistika&src=embed#async_embed,3585840,957059,0,0,0.4801909307875895,0,0,3537211,1005688
Lithuania,2021-09-24,4542899,4542899,0,https://e.infogram.com/57e5b447-c2ca-40da-aedb-cbf97df68a8e?parent_url=https%3A%2F%2Fosp.stat.gov.lt%2Fpraejusios-paros-covid-19-statistika&src=embed#async_embed,3585840,957059,0,0,0.4801909307875895,0,0,3537211,1005688
Lithuania,2021-09-25,4542899,4542899,0,https://e.infogram.com/57e5b447-c2ca-40da-aedb-cbf97df68a8e?parent_url=https%3A%2F%2Fosp.stat.gov.lt%2Fpraejusios-paros-covid-19-statistika&src=embed#async_embed,3585840,957059,0,0,0.4801909307875895,0,0,3537211,1005688
Lithuania,2021-09-26,4542899,4542899,0,https://e.infogram.com/57e5b447-c2ca-40da-aedb-cbf97df68a8e?parent_url=https%3A%2F%2Fosp.stat.gov.lt%2Fpraejusios-paros-covid-19-statistika&src=embed#async_embed,3585840,957059,0,0,0.4801909307875895,0,0,3537211,1005688
Lithuania,2021-09-27,4542899,4542899,0,https://e.infogram.com/57e5b447-c2ca-40da-aedb-cbf97df68a8e?parent_url=https%3A%2F%2Fosp.stat.gov.lt%2Fpraejusios-paros-covid-19-statistika&src=embed#async_embed,3585840,957059,0,0,0.4801909307875895,0,0,3537211,1005688
Lithuania,2021-09-28,4542899,4542899,0,https://e.infogram.com/57e5b447-c2ca-40da-aedb-cbf97df68a8e?parent_url=https%3A%2F%2Fosp.stat.gov.lt%2Fpraejusios-paros-covid-19-statistika&src=embed#async_embed,3585840,957059,0,0,0.4801909307875895,0,0,3537211,1005688
Lithuania,2021-09-29,4542899,4542899,0,https://e.infogram.com/57e5b447-c2ca-40da-aedb-cbf97df68a8e?parent_url=https%3A%2F%2Fosp.stat.gov.lt%2Fpraejusios-paros-covid-19-statistika&src=embed#async_embed,3585840,957059,0,0,0.4801909307875895,0,0,3537211,1005688
Lithuania,2021-09-30,4542899,4542899,0,https://e.infogram.com/57e5b447-c2ca-40da-aedb-cbf97df68a8e?parent_url=https%3A%2F%2Fosp.stat.gov.lt%2Fpraejusios-paros-covid-19-statistika&src=embed#async_embed,3585840,957059,0,0,0.4801909307875895,0,0,3537211,1005688
Lithuania,2021-10-01,4542899,4542899,0,https://e.infogram.com/57e5b447-c2ca-40da-aedb-cbf97df68a8e?parent_url=https%3A%2F%2Fosp.stat.gov.lt%2Fpraejusios-paros-covid-19-statistika&src=embed#async_embed,3585840,957059,0,0,0.4801909307875895,0,0,3537211,1005688
Lithuania,2021-10-02,4542899,4542899,0,https://e.infogram.com/57e5b447-c2ca-40da-aedb-cbf97df68a8e?parent_url=https%3A%2F%2Fosp.stat.gov.lt%2Fpraejusios-paros-covid-19-statistika&src=embed#async_embed,3585840,957059,0,0,0.4801909307875895,0,0,3537211,1005688
Lithuania,2021-10-03,4542899,4542899,0,https://e.infogram.com/57e5b447-c2ca-40da-aedb-cbf97df68a8e?parent_url=https%3A%2F%2Fosp.stat.gov.lt%2Fpraejusios-paros-covid-19-statistika&src=embed#async_embed,3585840,957059,0,0,0.4801909307875895,0,0,3537211,1005688
Lithuania,2021-10-04,4542899,4542899,0,https://e.infogram.com/57e5b447-c2ca-40da-aedb-cbf97df68a8e?parent_url=https%3A%2F%2Fosp.stat.gov.lt%2Fpraejusios-paros-covid-19-statistika&src=embed#async_embed,3585840,957059,0,0,0.4801909307875895,0,0,3537211,1005688
Lithuania,2021-10-05,4542899,4542899,0,https://e.infogram.com/57e5b447-c2ca-40da-aedb-cbf97df68a8e?parent_url=https%3A%2F%2Fosp.stat.gov.lt%2Fpraejusios-paros-covid-19-statistika&src=embed#async_embed,3585840,957059,0,0,0.4801909307875895,0,0,3537211,1005688
Lithuania,2021-10-06,4542899,4542899,0,https://e.infogram.com/57e5b447-c2ca-40da-aedb-cbf97df68a8e?parent_url=https%3A%2F%2Fosp.stat.gov.lt%2Fpraejusios-paros-covid-19-statistika&src=embed#async_embed,3585840,957059,0,0,0.4801909307875895,0,0,3537211,1005688
Lithuania,2021-10-07,4542899,4542899,0,https://e.infogram.com/57e5b447-c2ca-40da-aedb-cbf97df68a8e?parent_url=https%3A%2F%2Fosp.stat.gov.lt%2Fpraejusios-paros-covid-19-statistika&src=embed#async_embed,3585840,957059,0,0,0.4801909307875895,0,0,3537211,1005688
Lithuania,2021-10-08,4542899,4542899,0,https://e.infogram.com/57e5b447-c2ca-40da-aedb-cbf97df68a8e?parent_url=https%3A%2F%2Fosp.stat.gov.lt%2Fpraejusios-paros-covid-19-statistika&src=embed#async_embed,3585840,957059,0,0,0.4801909307875895,0,0,3537211,1005688
Lithuania,2021-10-09,4542899,4542899,0,https://e.infogram.com/57e5b447-c2ca-40da-aedb-cbf97df68a8e?parent_url=https%3A%2F%2Fosp.stat.gov.lt%2Fpraejusios-paros-covid-19-statistika&src=embed#async_embed,3585840,957059,0,0,0.4801909307875895,0,0,3537211,1005688
Lithuania,2021-10-10,4542899,4542899,0,https://e.infogram.com/57e5b447-c2ca-40da-aedb-cbf97df68a8e?parent_url=https%3A%2F%2Fosp.stat.gov.lt%2Fpraejusios-paros-covid-19-statistika&src=embed#async_embed,3585840,957059,0,0,0.4801909307875895,0,0,3537211,1005688
Lithuania,2021-10-11,4542899,4542899,0,https://e.infogram.com/57e5b447-c2ca-40da-aedb-cbf97df68a8e?parent_url=https%3A%2F%2Fosp.stat.gov.lt%2Fpraejusios-paros-covid-19-statistika&src=embed#async_embed,3585840,957059,0,0,0.4801909307875895,0,0,3537211,1005688
Lithuania,2021-10-12,4542899,4542899,0,https://e.infogram.com/57e5b447-c2ca-40da-aedb-cbf97df68a8e?parent_url=https%3A%2F%2Fosp.stat.gov.lt%2Fpraejusios-paros-covid-19-statistika&src=embed#async_embed,3585840,957059,0,0,0.4801909307875895,0,0,3537211,1005688
Lithuania,2021-10-13,4542899,4542899,0,https://e.infogram.com/57e5b447-c2ca-40da-aedb-cbf97df68a8e?parent_url=https%3A%2F%2Fosp.stat.gov.lt%2Fpraejusios-paros-covid-19-statistika&src=embed#async_embed,3585840,957059,0,0,0.4801909307875895,0,0,3537211,1005688
Lithuania,2021-10-14,4542899,4542899,0,https://e.infogram.com/57e5b447-c2ca-40da-aedb-cbf97df68a8e?parent_url=https%3A%2F%2Fosp.stat.gov.lt%2Fpraejusios-paros-covid-19-statistika&src=embed#async_embed,3585840,957059,0,0,0.4801909307875895,0,0,3537211,1005688
Lithuania,2021-10-15,4542899,4542899,0,https://e.infogram.com/57e5b447-c2ca-40da-aedb-cbf97df68a8e?parent_url=https%3A%2F%2Fosp.stat.gov.lt%2Fpraejusios-paros-covid-19-statistika&src=embed#async_embed,3585840,957059,0,0,0.4801909307875895,0,0,3537211,1005688
Lithuania,2021-10-16,4542899,4542899,0,https://e.infogram.com/57e5b447-c2ca-40da-aedb-cbf97df68a8e?parent_url=https%3A%2F%2Fosp.stat.gov.lt%2Fpraejusios-paros-covid-19-statistika&src=embed#async_embed,3585840,957059,0,0,0.4801909307875895,0,0,3537211,1005688
Lithuania,2021-10-17,4542899,4542899,0,https://e.infogram.com/57e5b447-c2ca-40da-aedb-cbf97df68a8e?parent_url=https%3A%2F%2Fosp.stat.gov.lt%2Fpraejusios-paros-covid-19-statistika&src=embed#async_embed,3585840,957059,0,0,0.4801909307875895,0,0,3537211,1005688
Lithuania,2021-10-18,4542899,4542899,0,https://e.infogram.com/57e5b447-c2ca-40da-aedb-cbf97df68a8e?parent_url=https%3A%2F%2Fosp.stat.gov.lt%2Fpraejusios-paros-covid-19-statistika&src=embed#async_embed,3585840,957059,0,0,0.4801909307875895,0,0,3537211,1005688
Lithuania,2021-10-19,4542899,4542899,0,https://e.infogram.com/57e5b447-c2ca-40da-aedb-cbf97df68a8e?parent_url=https%3A%2F%2Fosp.stat.gov.lt%2Fpraejusios-paros-covid-19-statistika&src=embed#async_embed,3585840,957059,0,0,0.4801909307875895,0,0,3537211,1005688
Lithuania,2021-10-20,4542899,4542899,0,https://e.infogram.com/57e5b447-c2ca-40da-aedb-cbf97df68a8e?parent_url=https%3A%2F%2Fosp.stat.gov.lt%2Fpraejusios-paros-covid-19-statistika&src=embed#async_embed,3585840,957059,0,0,0.4801909307875895,0,0,3537211,1005688
Lithuania,2021-10-21,4542899,4542899,0,https://e.infogram.com/57e5b447-c2ca-40da-aedb-cbf97df68a8e?parent_url=https%3A%2F%2Fosp.stat.gov.lt%2Fpraejusios-paros-covid-19-statistika&src=embed#async_embed,3585840,957059,0,0,0.4801909307875895,0,0,3537211,1005688
Lithuania,2021-10-22,4542899,4542899,0,https://e.infogram.com/57e5b447-c2ca-40da-aedb-cbf97df68a8e?parent_url=https%3A%2F%2Fosp.stat.gov.lt%2Fpraejusios-paros-covid-19-statistika&src=embed#async_embed,3585840,957059,0,0,0.4801909307875895,0,0,3537211,1005688
Lithuania,2021-10-23,4542899,4542899,0,https://e.infogram.com/57e5b447-c2ca-40da-aedb-cbf97df68a8e?parent_url=https%3A%2F%2Fosp.stat.gov.lt%2Fpraejusios-paros-covid-19-statistika&src=embed#async_embed,3585840,957059,0,0,0.4801909307875895,0,0,3537211,1005688
Lithuania,2021-10-24,4542899,4542899,0,https://e.infogram.com/57e5b447-c2ca-40da-aedb-cbf97df68a8e?parent_url=https%3A%2F%2Fosp.stat.gov.lt%2Fpraejusios-paros-covid-19-statistika&src=embed#async_embed,3585840,957059,0,0,0.4801909307875895,0,0,3537211,1005688
Lithuania,2021-10-25,4542899,4542899,0,https://e.infogram.com/57e5b447-c2ca-40da-aedb-cbf97df68a8e?parent_url=https%3A%2F%2Fosp.stat.gov.lt%2Fpraejusios-paros-covid-19-statistika&src=embed#async_embed,3585840,957059,0,0,0.4801909307875895,0,0,3537211,1005688
Lithuania,2021-10-26,4542899,4542899,0,https://e.infogram.com/57e5b447-c2ca-40da-aedb-cbf97df68a8e?parent_url=https%3A%2F%2Fosp.stat.gov.lt%2Fpraejusios-paros-covid-19-statistika&src=embed#async_embed,3585840,957059,0,0,0.4801909307875895,0,0,3537211,1005688
Lithuania,2021-10-27,4542899,4542899,0,https://e.infogram.com/57e5b447-c2ca-40da-aedb-cbf97df68a8e?parent_url=https%3A%2F%2Fosp.stat.gov.lt%2Fpraejusios-paros-covid-19-statistika&src=embed#async_embed,3585840,957059,0,0,0.4801909307875895,0,0,3537211,1005688
Lithuania,2021-10-28,4542899,4542899,0,https://e.infogram.com/57e5b447-c2ca-40da-aedb-cbf97df68a8e?parent_url=https%3A%2F%2Fosp.stat.gov.lt%2Fpraejusios-paros-covid-19-statistika&src=embed#async_embed,3585840,957059,0,0,0.4801909307875895,0,0,3537211,1005688
Lithuania,2021-10-29,4542899,4542899,0,https://e.infogram.com/57e5b447-c2ca-40da-aedb-cbf97df68a8e?parent_url=https%3A%2F%2Fosp.stat.gov.lt%2Fpraejusios-paros-covid-19-statistika&src=embed#async_embed,3585840,957059,0,0,0.4801909307875895,0,0,3537211,1005688
Lithuania,2021-10-30,4542899,4542899,0,https://e.infogram.com/57e5b447-c2ca-40da-aedb-cbf97df68a8e?parent_url=https%3A%2F%2Fosp.stat.gov.lt%2Fpraejusios-paros-covid-19-statistika&src=embed#async_embed,3585840,957059,0,0,0.4801909307875895,0,0,3537211,1005688
Lithuania,2021-10-31,4542899,4542899,0,https://e.infogram.com/57e5b447-c2ca-40da-aedb-cbf97df68a8e?parent_url=https%3A%2F%2Fosp.stat.gov.lt%2Fpraejusios-paros-covid-19-statistika&src=embed#async_embed,3585840,957059,0,0,0.4801909307875895,0,0,3537211,1005688
Lithuania,2021-11-01,4542899,4542899,0,https://e.infogram.com/57e5b447-c2ca-40da-aedb-cbf97df68a8e?parent_url=https%3A%2F%2Fosp.stat.gov.lt%2Fpraejusios-paros-covid-19-statistika&src=embed#async_embed,3585840,957059,0,0,0.4801909307875895,0,0,3537211,1005688
Lithuania,2021-11-02,4542899,4542899,0,https://e.infogram.com/57e5b447-c2ca-40da-aedb-cbf97df68a8e?parent_url=https%3A%2F%2Fosp.stat.gov.lt%2Fpraejusios-paros-covid-19-statistika&src=embed#async_embed,3585840,957059,0,0,0.4801909307875895,0,0,3537211,1005688
Lithuania,2021-11-03,4542899,4542899,0,https://e.infogram.com/57e5b447-c2ca-40da-aedb-cbf97df68a8e?parent_url=https%3A%2F%2Fosp.stat.gov.lt%2Fpraejusios-paros-covid-19-statistika&src=embed#async_embed,3585840,957059,0,0,0.4801909307875895,0,0,3537211,1005688
Lithuania,2021-11-04,4542899,4542899,0,https://e.infogram.com/57e5b447-c2ca-40da-aedb-cbf97df68a8e?parent_url=https%3A%2F%2Fosp.stat.gov.lt%2Fpraejusios-paros-covid-19-statistika&src=embed#async_embed,3585840,957059,0,0,0.4801909307875895,0,0,3537211,1005688
Lithuania,2021-11-05,4542899,4542899,0,https://e.infogram.com/57e5b447-c2ca-40da-aedb-cbf97df68a8e?parent_url=https%3A%2F%2Fosp.stat.gov.lt%2Fpraejusios-paros-covid-19-statistika&src=embed#async_embed,57,5,-3585783,-957054,0.21067319826795458,0,0,3537211,1005688
Lithuania,2021-11-06,4542899,4542899,0,https://e.infogram.com/57e5b447-c2ca-40da-aedb-cbf97df68a8e?parent_url=https%3A%2F%2Fosp.stat.gov.lt%2Fpraejusios-paros-covid-19-statistika&src=embed#async_embed,65,5,8,0,0,0,0,3537211,1005688
Lithuania,2021-11-07,4542899,4542899,0,https://e.infogram.com/57e5b447-c2ca-40da-aedb-cbf97df68a8e?parent_url=https%3A%2F%2Fosp.stat.gov.lt%2Fpraejusios-paros-covid-19-statistika&src=embed#async_embed,62,6,-3,1,0,0,0,3537211,1005688
Lithuania,2021-11-08,4542899,4542899,0,https://e.infogram.com/57e5b447-c2ca-40da-aedb-cbf97df68a8e?parent_url=https%3A%2F%2Fosp.stat.gov.lt%2Fpraejusios-paros-covid-19-statistika&src=embed#async_embed,66,6,4,0,0,0,0,3537211,1005688
Lithuania,2021-11-09,4542899,4542899,0,https://e.infogram.com/57e5b447-c2ca-40da-aedb-cbf97df68a8e?parent_url=https%3A%2F%2Fosp.stat.gov.lt%2Fpraejusios-paros-covid-19-statistika&src=embed#async_embed,63,6,-3,0,-0,0,-0,3537211,1005688
Lithuania,2021-11-10,4542899,4542899,0,https://e.infogram.com/57e5b447-c2ca-40da-aedb-cbf97df68a8e?parent_url=https%3A%2F%2Fosp.stat.gov.lt%2Fpraejusios-paros-covid-19-statistika&src=embed#async_embed,118,82,55,76,0.5801526717557252,0,0,3537211,1005688
Lithuania,2021-11-11,4542899,4542899,0,https://e.infogram.com/57e5b447-c2ca-40da-aedb-cbf97df68a8e?parent_url=https%3A%2F%2Fosp.stat.gov.lt%2Fpraejusios-paros-covid-19-statistika&src=embed#async_embed,109,81,-9,-1,0.1,0,0,3537211,1005688
Lithuania,2021-11-12,4542899,4542899,0,https://e.infogram.com/57e5b447-c2ca-40da-aedb-cbf97df68a8e?parent_url=https%3A%2F%2Fosp.stat.gov.lt%2Fpraejusios-paros-covid-19-statistika&src=embed#async_embed,122,83,13,2,0.13333333333333333,0,0,3537211,1005688
Lithuania,2021-11-13,4542899,4542899,0,https://e.infogram.com/57e5b447-c2ca-40da-aedb-cbf97df68a8e?parent_url=https%3A%2F%2Fosp.stat.gov.lt%2Fpraejusios-paros-covid-19-statistika&src=embed#async_embed,120,83,-2,0,-0,0,-0,3537211,1005688
Lithuania,2021-11-14,4542899,4542899,0,https://e.infogram.com/57e5b447-c2ca-40da-aedb-cbf97df68a8e?parent_url=https%3A%2F%2Fosp.stat.gov.lt%2Fpraejusios-paros-covid-19-statistika&src=embed#async_embed,123,88,3,5,0.625,0,0,3537211,1005688
Lithuania,2021-11-15,4542899,4542899,0,https://e.infogram.com/57e5b447-c2ca-40da-aedb-cbf97df68a8e?parent_url=https%3A%2F%2Fosp.stat.gov.lt%2Fpraejusios-paros-covid-19-statistika&src=embed#async_embed,125,85,2,-3,0.625,0,0,3537211,1005688
Lithuania,2021-11-16,4542899,4542899,0,https://e.infogram.com/57e5b447-c2ca-40da-aedb-cbf97df68a8e?parent_url=https%3A%2F%2Fosp.stat.gov.lt%2Fpraejusios-paros-covid-19-statistika&src=embed#async_embed,127,87,2,2,0.5,0,0,3537211,1005688
Lithuania,2021-11-17,4542899,4542899,0,https://e.infogram.com/57e5b447-c2ca-40da-aedb-cbf97df68a8e?parent_url=https%3A%2F%2Fosp.stat.gov.lt%2Fpraejusios-paros-covid-19-statistika&src=embed#async_embed,126,92,-1,5,0.5,0,0,3537211,1005688
Lithuania,2021-11-18,6212691,6212691,1669792,https://e.infogram.com/57e5b447-c2ca-40da-aedb-cbf97df68a8e?parent_url=https%3A%2F%2Fosp.stat.gov.lt%2Fpraejusios-paros-covid-19-statistika&src=embed#async_embed,122,86,-4,-6,0.6,667917,1001875,4205128,2007563
Lithuania,2021-11-19,6212691,6212691,0,https://e.infogram.com/57e5b447-c2ca-40da-aedb-cbf97df68a8e?parent_url=https%3A%2F%2Fosp.stat.gov.lt%2Fpraejusios-paros-covid-19-statistika&src=embed#async_embed,119,85,-3,-1,0.25,0,0,4205128,2007563
Lithuania,2021-11-20,6246740,6246740,34049,https://e.infogram.com/57e5b447-c2ca-40da-aedb-cbf97df68a8e?parent_url=https%3A%2F%2Fosp.stat.gov.lt%2Fpraejusios-paros-covid-19-statistika&src=embed#async_embed,113,84,-6,-1,0.14285714285714285,29185,4864,4234313,2012427
Lithuania,2021-11-21,6253725,6253725,6985,https://e.infogram.com/57e5b447-c2ca-40da-aedb-cbf97df68a8e?parent_url=https%3A%2F%2Fosp.stat.gov.lt%2Fpraejusios-paros-covid-19-statistika&src=embed#async_embed,109,82,-4,-2,0.3333333333333333,4657,2328,4238970,2014755
Lithuania,2021-11-22,6277688,6277688,23963,https://e.infogram.com/57e5b447-c2ca-40da-aedb-cbf97df68a8e?parent_url=https%3A%2F%2Fosp.stat.gov.lt%2Fpraejusios-paros-covid-19-statistika&src=embed#async_embed,106,74,-3,-8,0.7272727272727273,6535,17428,4245505,2032183
Lithuania,2021-11-23,6299718,6299718,22030,https://e.infogram.com/57e5b447-c2ca-40da-aedb-cbf97df68a8e?parent_url=https%3A%2F%2Fosp.stat.gov.lt%2Fpraejusios-paros-covid-19-statistika&src=embed#async_embed,111,83,5,9,0.6428571428571429,7868,14162,4253373,2046345
Lithuania,2021-11-24,6322354,6322354,22636,https://e.infogram.com/57e5b447-c2ca-40da-aedb-cbf97df68a8e?parent_url=https%3A%2F%2Fosp.stat.gov.lt%2Fpraejusios-paros-covid-19-statistika&src=embed#async_embed,113,83,2,0,0,22636,0,4276009,2046345
Lithuania,2021-11-25,6346778,6346778,24424,https://e.infogram.com/57e5b447-c2ca-40da-aedb-cbf97df68a8e?parent_url=https%3A%2F%2Fosp.stat.gov.lt%2Fpraejusios-paros-covid-19-statistika&src=embed#async_embed,103,83,-10,0,-0,24424,-0,4300433,2046345
Lithuania,2021-11-26,6346778,6346778,0,https://e.infogram.com/57e5b447-c2ca-40da-aedb-cbf97df68a8e?parent_url=https%3A%2F%2Fosp.stat.gov.lt%2Fpraejusios-paros-covid-19-statistika&src=embed#async_embed,103,83,0,0,-0,0,-0,4300433,2046345
Lithuania,2021-11-27,6346778,6346778,0,https://e.infogram.com/57e5b447-c2ca-40da-aedb-cbf97df68a8e?parent_url=https%3A%2F%2Fosp.stat.gov.lt%2Fpraejusios-paros-covid-19-statistika&src=embed#async_embed,117,86,14,3,0.17647058823529413,0,0,4300433,2046345
Lithuania,2021-11-28,6388335,6388335,41557,https://e.infogram.com/57e5b447-c2ca-40da-aedb-cbf97df68a8e?parent_url=https%3A%2F%2Fosp.stat.gov.lt%2Fpraejusios-paros-covid-19-statistika&src=embed#async_embed,99,72,-18,-14,0.4375,23376,18181,4323809,2064526
Lithuania,2021-11-29,6413618,6413618,25283,https://e.infogram.com/57e5b447-c2ca-40da-aedb-cbf97df68a8e?parent_url=https%3A%2F%2Fosp.stat.gov.lt%2Fpraejusios-paros-covid-19-statistika&src=embed#async_embed,99,74,0,2,1,0,25283,4323809,2089809
Lithuania,2021-11-30,6441360,6441360,27742,https://e.infogram.com/57e5b447-c2ca-40da-aedb-cbf97df68a8e?parent_url=https%3A%2F%2Fosp.stat.gov.lt%2Fpraejusios-paros-covid-19-statistika&src=embed#async_embed,105,75,6,1,0.14285714285714285,23779,3963,4347588,2093772
Lithuania,2021-12-01,6441360,6441360,0,https://e.infogram.com/57e5b447-c2ca-40da-aedb-cbf97df68a8e?parent_url=https%3A%2F%2Fosp.stat.gov.lt%2Fpraejusios-paros-covid-19-statistika&src=embed#async_embed,4680965,1760395,4680860,1760320,0.273291539748928,0,0,4347588,2093772
Lithuania,2021-12-02,6460165,6460165,18805,https://e.infogram.com/57e5b447-c2ca-40da-aedb-cbf97df68a8e?parent_url=https%3A%2F%2Fosp.stat.gov.lt%2Fpraejusios-paros-covid-19-statistika&src=embed#async_embed,4697444,1762721,16479,2326,0.1236905078436586,16479,2326,4364067,2096098
Lithuania,2021-12-03,6478456,6478456,18291,https://e.infogram.com/57e5b447-c2ca-40da-aedb-cbf97df68a8e?parent_url=https%3A%2F%2Fosp.stat.gov.lt%2Fpraejusios-paros-covid-19-statistika&src=embed#async_embed,4712966,1765490,15522,2769,0.1513859275053305,15522,2769,4379589,2098867
Lithuania,2021-12-04,6494088,6494088,15632,https://e.infogram.com/57e5b447-c2ca-40da-aedb-cbf97df68a8e?parent_url=https%3A%2F%2Fosp.stat.gov.lt%2Fpraejusios-paros-covid-19-statistika&src=embed#async_embed,4725003,1769085,12037,3595,0.22997697031729786,12037,3595,4391626,2102462
Lithuania,2021-12-05,6503917,6503917,9829,https://e.infogram.com/57e5b447-c2ca-40da-aedb-cbf97df68a8e?parent_url=https%3A%2F%2Fosp.stat.gov.lt%2Fpraejusios-paros-covid-19-statistika&src=embed#async_embed,4733336,1770581,8333,1496,0.15220266558144266,8333,1496,4399959,2103958
Lithuania,2021-12-06,6507749,6507749,3832,https://e.infogram.com/57e5b447-c2ca-40da-aedb-cbf97df68a8e?parent_url=https%3A%2F%2Fosp.stat.gov.lt%2Fpraejusios-paros-covid-19-statistika&src=embed#async_embed,4736570,1771179,3234,598,0.15605427974947808,3234,598,4403193,2104556
Lithuania,2021-12-07,6527061,6527061,19312,https://e.infogram.com/57e5b447-c2ca-40da-aedb-cbf97df68a8e?parent_url=https%3A%2F%2Fosp.stat.gov.lt%2Fpraejusios-paros-covid-19-statistika&src=embed#async_embed,4749619,1777442,13049,6263,0.3243061309030654,13049,6263,4416242,2110819
Lithuania,2021-12-08,6549516,6549516,22455,https://e.infogram.com/57e5b447-c2ca-40da-aedb-cbf97df68a8e?parent_url=https%3A%2F%2Fosp.stat.gov.lt%2Fpraejusios-paros-covid-19-statistika&src=embed#async_embed,4767721,1781795,18102,4353,0.19385437541750167,18102,4353,4434344,2115172
Lithuania,2021-12-09,6569514,6569514,19998,https://e.infogram.com/57e5b447-c2ca-40da-aedb-cbf97df68a8e?parent_url=https%3A%2F%2Fosp.stat.gov.lt%2Fpraejusios-paros-covid-19-statistika&src=embed#async_embed,4783734,1785780,16013,3985,0.19926992699269927,16013,3985,4450357,2119157
Lithuania,2021-12-10,6590068,6590068,20554,https://e.infogram.com/57e5b447-c2ca-40da-aedb-cbf97df68a8e?parent_url=https%3A%2F%2Fosp.stat.gov.lt%2Fpraejusios-paros-covid-19-statistika&src=embed#async_embed,4798643,1791425,14909,5645,0.27464240537121726,14909,5645,4465266,2124802
Lithuania,2021-12-11,6608687,6608687,18619,https://e.infogram.com/57e5b447-c2ca-40da-aedb-cbf97df68a8e?parent_url=https%3A%2F%2Fosp.stat.gov.lt%2Fpraejusios-paros-covid-19-statistika&src=embed#async_embed,4811244,1797443,12601,6018,0.32321821794940653,12601,6018,4477867,2130820
Lithuania,2021-12-12,6618601,6618601,9914,https://e.infogram.com/57e5b447-c2ca-40da-aedb-cbf97df68a8e?parent_url=https%3A%2F%2Fosp.stat.gov.lt%2Fpraejusios-paros-covid-19-statistika&src=embed#async_embed,4819430,1799171,8186,1728,0.1742989711519064,8186,1728,4486053,2132548
Lithuania,2021-12-13,6624596,6624596,5995,https://e.infogram.com/57e5b447-c2ca-40da-aedb-cbf97df68a8e?parent_url=https%3A%2F%2Fosp.stat.gov.lt%2Fpraejusios-paros-covid-19-statistika&src=embed#async_embed,4824147,1800449,4717,1278,0.21317764804003336,4717,1278,4490770,2133826
Lithuania,2021-12-14,6642674,6642674,18078,https://e.infogram.com/57e5b447-c2ca-40da-aedb-cbf97df68a8e?parent_url=https%3A%2F%2Fosp.stat.gov.lt%2Fpraejusios-paros-covid-19-statistika&src=embed#async_embed,4836015,1806659,11868,6210,0.3435114503816794,11868,6210,4502638,2140036
Lithuania,2021-12-15,6664917,6664917,22243,https://e.infogram.com/57e5b447-c2ca-40da-aedb-cbf97df68a8e?parent_url=https%3A%2F%2Fosp.stat.gov.lt%2Fpraejusios-paros-covid-19-statistika&src=embed#async_embed,4854375,1810542,18360,3883,0.17457177539001034,18360,3883,4520998,2143919
Lithuania,2021-12-16,6684877,6684877,19960,https://e.infogram.com/57e5b447-c2ca-40da-aedb-cbf97df68a8e?parent_url=https%3A%2F%2Fosp.stat.gov.lt%2Fpraejusios-paros-covid-19-statistika&src=embed#async_embed,4870741,1814136,16366,3594,0.18006012024048096,16366,3594,4537364,2147513
Lithuania,2021-12-17,6704366,6704366,19489,https://e.infogram.com/57e5b447-c2ca-40da-aedb-cbf97df68a8e?parent_url=https%3A%2F%2Fosp.stat.gov.lt%2Fpraejusios-paros-covid-19-statistika&src=embed#async_embed,4885043,1819323,14302,5187,0.2661501359741393,14302,5187,4551666,2152700
Lithuania,2021-12-18,6722478,6722478,18112,https://e.infogram.com/57e5b447-c2ca-40da-aedb-cbf97df68a8e?parent_url=https%3A%2F%2Fosp.stat.gov.lt%2Fpraejusios-paros-covid-19-statistika&src=embed#async_embed,4897636,1824842,12593,5519,0.30471510600706714,12593,5519,4564259,2158219
Lithuania,2021-12-19,6732420,6732420,9942,https://e.infogram.com/57e5b447-c2ca-40da-aedb-cbf97df68a8e?parent_url=https%3A%2F%2Fosp.stat.gov.lt%2Fpraejusios-paros-covid-19-statistika&src=embed#async_embed,4905241,1827179,7605,2337,0.23506336753168378,7605,2337,4571864,2160556
Lithuania,2021-12-20,6737481,6737481,5061,https://e.infogram.com/57e5b447-c2ca-40da-aedb-cbf97df68a8e?parent_url=https%3A%2F%2Fosp.stat.gov.lt%2Fpraejusios-paros-covid-19-statistika&src=embed#async_embed,4909412,1828069,4171,890,0.17585457419482317,4171,890,4576035,2161446
Lithuania,2021-12-21,6756730,6756730,19249,https://e.infogram.com/57e5b447-c2ca-40da-aedb-cbf97df68a8e?parent_url=https%3A%2F%2Fosp.stat.gov.lt%2Fpraejusios-paros-covid-19-statistika&src=embed#async_embed,4921847,1834883,12435,6814,0.3539924151903995,12435,6814,4588470,2168260
Lithuania,2021-12-22,6777433,6777433,20703,https://e.infogram.com/57e5b447-c2ca-40da-aedb-cbf97df68a8e?parent_url=https%3A%2F%2Fosp.stat.gov.lt%2Fpraejusios-paros-covid-19-statistika&src=embed#async_embed,4938134,1839299,16287,4416,0.21330241993913926,16287,4416,4604757,2172676
Lithuania,2021-12-23,6799410,6799410,21977,https://e.infogram.com/57e5b447-c2ca-40da-aedb-cbf97df68a8e?parent_url=https%3A%2F%2Fosp.stat.gov.lt%2Fpraejusios-paros-covid-19-statistika&src=embed#async_embed,4955519,1843891,17385,4592,0.20894571597579287,17385,4592,4622142,2177268
Lithuania,2021-12-24,6817299,6817299,17889,https://e.infogram.com/57e5b447-c2ca-40da-aedb-cbf97df68a8e?parent_url=https%3A%2F%2Fosp.stat.gov.lt%2Fpraejusios-paros-covid-19-statistika&src=embed#async_embed,4968487,1848812,12968,4921,0.27508524791771477,12968,4921,4635110,2182189
Lithuania,2021-12-25,6825938,6825938,8639,https://e.infogram.com/57e5b447-c2ca-40da-aedb-cbf97df68a8e?parent_url=https%3A%2F%2Fosp.stat.gov.lt%2Fpraejusios-paros-covid-19-statistika&src=embed#async_embed,4975891,1850047,7404,1235,0.14295636068989467,7404,1235,4642514,2183424
Lithuania,2021-12-26,6831144,6831144,5206,https://e.infogram.com/57e5b447-c2ca-40da-aedb-cbf97df68a8e?parent_url=https%3A%2F%2Fosp.stat.gov.lt%2Fpraejusios-paros-covid-19-statistika&src=embed#async_embed,4980013,1851131,4122,1084,0.20822128313484442,4122,1084,4646636,2184508
Lithuania,2021-12-27,6836379,6836379,5235,https://e.infogram.com/57e5b447-c2ca-40da-aedb-cbf97df68a8e?parent_url=https%3A%2F%2Fosp.stat.gov.lt%2Fpraejusios-paros-covid-19-statistika&src=embed#async_embed,4984030,1852349,4017,1218,0.23266475644699142,4017,1218,4650653,2185726
Lithuania,2021-12-28,6853614,6853614,17235,https://e.infogram.com/57e5b447-c2ca-40da-aedb-cbf97df68a8e?parent_url=https%3A%2F%2Fosp.stat.gov.lt%2Fpraejusios-paros-covid-19-statistika&src=embed#async_embed,4993167,1860447,9137,8098,0.4698578474035393,9137,8098,4659790,2193824
Lithuania,2021-12-29,6870127,6870127,16513,https://e.infogram.com/57e5b447-c2ca-40da-aedb-cbf97df68a8e?parent_url=https%3A%2F%2Fosp.stat.gov.lt%2Fpraejusios-paros-covid-19-statistika&src=embed#async_embed,5004823,1865304,11656,4857,0.2941318960818749,11656,4857,4671446,2198681
Lithuania,2021-12-30,6885129,6885129,15002,https://e.infogram.com/57e5b447-c2ca-40da-aedb-cbf97df68a8e?parent_url=https%3A%2F%2Fosp.stat.gov.lt%2Fpraejusios-paros-covid-19-statistika&src=embed#async_embed,5015089,1870040,10266,4736,0.3156912411678443,10266,4736,4681712,2203417
Lithuania,2021-12-31,6901204,6901204,16075,https://e.infogram.com/57e5b447-c2ca-40da-aedb-cbf97df68a8e?parent_url=https%3A%2F%2Fosp.stat.gov.lt%2Fpraejusios-paros-covid-19-statistika&src=embed#async_embed,5025323,1875881,10234,5841,0.3633592534992224,10234,5841,4691946,2209258
Lithuania,2022-01-01,6917989,6917989,16785,https://e.infogram.com/57e5b447-c2ca-40da-aedb-cbf97df68a8e?parent_url=https%3A%2F%2Fosp.stat.gov.lt%2Fpraejusios-paros-covid-19-statistika&src=embed#async_embed,5036679,1881310,11356,5429,0.3234435507893953,11356,5429,4703302,2214687
Lithuania,2022-01-02,6924426,6924426,6437,https://e.infogram.com/57e5b447-c2ca-40da-aedb-cbf97df68a8e?parent_url=https%3A%2F%2Fosp.stat.gov.lt%2Fpraejusios-paros-covid-19-statistika&src=embed#async_embed,5041995,1882431,5316,1121,0.17414944850085443,5316,1121,4708618,2215808
Lithuania,2022-01-03,6931815,6931815,7389,https://e.infogram.com/57e5b447-c2ca-40da-aedb-cbf97df68a8e?parent_url=https%3A%2F%2Fosp.stat.gov.lt%2Fpraejusios-paros-covid-19-statistika&src=embed#async_embed,5047587,1884228,5592,1797,0.24319935038570847,5592,1797,4714210,2217605
Lithuania,2022-01-04,6953338,6953338,21523,https://e.infogram.com/57e5b447-c2ca-40da-aedb-cbf97df68a8e?parent_url=https%3A%2F%2Fosp.stat.gov.lt%2Fpraejusios-paros-covid-19-statistika&src=embed#async_embed,5059601,1893737,12014,9509,0.4418064396227292,12014,9509,4726224,2227114
Lithuania,2022-01-05,6974006,6974006,20668,https://e.infogram.com/57e5b447-c2ca-40da-aedb-cbf97df68a8e?parent_url=https%3A%2F%2Fosp.stat.gov.lt%2Fpraejusios-paros-covid-19-statistika&src=embed#async_embed,5074569,1899437,14968,5700,0.2757886587962067,14968,5700,4741192,2232814
Lithuania,2022-01-06,6994029,6994029,20023,https://e.infogram.com/57e5b447-c2ca-40da-aedb-cbf97df68a8e?parent_url=https%3A%2F%2Fosp.stat.gov.lt%2Fpraejusios-paros-covid-19-statistika&src=embed#async_embed,5089466,1904563,14897,5126,0.2560055935673975,14897,5126,4756089,2237940
Lithuania,2022-01-07,7015601,7015601,21572,https://e.infogram.com/57e5b447-c2ca-40da-aedb-cbf97df68a8e?parent_url=https%3A%2F%2Fosp.stat.gov.lt%2Fpraejusios-paros-covid-19-statistika&src=embed#async_embed,5105192,1910409,15726,5846,0.27099944372334506,15726,5846,4771815,2243786
Lithuania,2022-01-08,7039384,7039384,23783,https://e.infogram.com/57e5b447-c2ca-40da-aedb-cbf97df68a8e?parent_url=https%3A%2F%2Fosp.stat.gov.lt%2Fpraejusios-paros-covid-19-statistika&src=embed#async_embed,5121433,1917951,16241,7542,0.3171172686372619,16241,7542,4788056,2251328
Lithuania,2022-01-09,7054140,7054140,14756,https://e.infogram.com/57e5b447-c2ca-40da-aedb-cbf97df68a8e?parent_url=https%3A%2F%2Fosp.stat.gov.lt%2Fpraejusios-paros-covid-19-statistika&src=embed#async_embed,5132608,1921532,11175,3581,0.24268094334507997,11175,3581,4799231,2254909
Lithuania,2022-01-10,7063758,7063758,9618,https://e.infogram.com/57e5b447-c2ca-40da-aedb-cbf97df68a8e?parent_url=https%3A%2F%2Fosp.stat.gov.lt%2Fpraejusios-paros-covid-19-statistika&src=embed#async_embed,5140729,1923029,8121,1497,0.15564566437928884,8121,1497,4807352,2256406
Lithuania,2022-01-11,7088166,7088166,24408,https://e.infogram.com/57e5b447-c2ca-40da-aedb-cbf97df68a8e?parent_url=https%3A%2F%2Fosp.stat.gov.lt%2Fpraejusios-paros-covid-19-statistika&src=embed#async_embed,5157805,1930361,17076,7332,0.30039331366764993,17076,7332,4824428,2263738
Lithuania,2022-01-12,7116686,7116686,28520,https://e.infogram.com/57e5b447-c2ca-40da-aedb-cbf97df68a8e?parent_url=https%3A%2F%2Fosp.stat.gov.lt%2Fpraejusios-paros-covid-19-statistika&src=embed#async_embed,5181836,1934850,24031,4489,0.157398316970547,24031,4489,4848459,2268227
Lithuania,2022-01-13,7143442,7143442,26756,https://e.infogram.com/57e5b447-c2ca-40da-aedb-cbf97df68a8e?parent_url=https%3A%2F%2Fosp.stat.gov.lt%2Fpraejusios-paros-covid-19-statistika&src=embed#async_embed,5204351,1939091,22515,4241,0.15850650321423232,22515,4241,4870974,2272468
Lithuania,2022-01-14,7170064,7170064,26622,https://e.infogram.com/57e5b447-c2ca-40da-aedb-cbf97df68a8e?parent_url=https%3A%2F%2Fosp.stat.gov.lt%2Fpraejusios-paros-covid-19-statistika&src=embed#async_embed,5226273,1943791,21922,4700,0.17654571407106903,21922,4700,4892896,2277168
Lithuania,2022-01-15,7195287,7195287,25223,https://e.infogram.com/57e5b447-c2ca-40da-aedb-cbf97df68a8e?parent_url=https%3A%2F%2Fosp.stat.gov.lt%2Fpraejusios-paros-covid-19-statistika&src=embed#async_embed,5245086,1950201,18813,6410,0.25413313245847047,18813,6410,4911709,2283578
Lithuania,2022-01-16,7212246,7212246,16959,https://e.infogram.com/57e5b447-c2ca-40da-aedb-cbf97df68a8e?parent_url=https%3A%2F%2Fosp.stat.gov.lt%2Fpraejusios-paros-covid-19-statistika&src=embed#async_embed,5259527,1952719,14441,2518,0.1484757355976178,14441,2518,4926150,2286096
Lithuania,2022-01-17,7222288,7222288,10042,https://e.infogram.com/57e5b447-c2ca-40da-aedb-cbf97df68a8e?parent_url=https%3A%2F%2Fosp.stat.gov.lt%2Fpraejusios-paros-covid-19-statistika&src=embed#async_embed,5268437,1953851,8910,1132,0.11272654849631547,8910,1132,4935060,2287228
Lithuania,2022-01-18,7247865,7247865,25577,https://e.infogram.com/57e5b447-c2ca-40da-aedb-cbf97df68a8e?parent_url=https%3A%2F%2Fosp.stat.gov.lt%2Fpraejusios-paros-covid-19-statistika&src=embed#async_embed,5287107,1960758,18670,6907,0.2700473081283966,18670,6907,4953730,2294135
Lithuania,2022-01-19,7276753,7276753,28888,https://e.infogram.com/57e5b447-c2ca-40da-aedb-cbf97df68a8e?parent_url=https%3A%2F%2Fosp.stat.gov.lt%2Fpraejusios-paros-covid-19-statistika&src=embed#async_embed,5312101,1964652,24994,3894,0.13479645527554693,24994,3894,4978724,2298029
Lithuania,2022-01-20,7306215,7306215,29462,https://e.infogram.com/57e5b447-c2ca-40da-aedb-cbf97df68a8e?parent_url=https%3A%2F%2Fosp.stat.gov.lt%2Fpraejusios-paros-covid-19-statistika&src=embed#async_embed,5338089,1968126,25988,3474,0.11791460186002307,25988,3474,5004712,2301503
Lithuania,2022-01-21,7334392,7334392,28177,https://e.infogram.com/57e5b447-c2ca-40da-aedb-cbf97df68a8e?parent_url=https%3A%2F%2Fosp.stat.gov.lt%2Fpraejusios-paros-covid-19-statistika&src=embed#async_embed,5361616,1972776,23527,4650,0.1650282145011889,23527,4650,5028239,2306153
Lithuania,2022-01-22,7357810,7357810,23418,https://e.infogram.com/57e5b447-c2ca-40da-aedb-cbf97df68a8e?parent_url=https%3A%2F%2Fosp.stat.gov.lt%2Fpraejusios-paros-covid-19-statistika&src=embed#async_embed,5380578,1977232,18962,4456,0.19028098044239475,18962,4456,5047201,2310609
Lithuania,2022-01-23,7362484,7362484,4674,https://e.infogram.com/57e5b447-c2ca-40da-aedb-cbf97df68a8e?parent_url=https%3A%2F%2Fosp.stat.gov.lt%2Fpraejusios-paros-covid-19-statistika&src=embed#async_embed,5393803,1968681,13225,-8551,0.19028098044239475,3785,889,5050986,2311498
Lithuania,2022-01-24,7375751,7375751,13267,https://e.infogram.com/57e5b447-c2ca-40da-aedb-cbf97df68a8e?parent_url=https%3A%2F%2Fosp.stat.gov.lt%2Fpraejusios-paros-covid-19-statistika&src=embed#async_embed,5405933,1969818,12130,1137,0.08570136428732947,12130,1137,5063116,2312635
Lithuania,2022-01-25,7400435,7400435,24684,https://e.infogram.com/57e5b447-c2ca-40da-aedb-cbf97df68a8e?parent_url=https%3A%2F%2Fosp.stat.gov.lt%2Fpraejusios-paros-covid-19-statistika&src=embed#async_embed,5423966,1976469,18033,6651,0.2694457948468644,18033,6651,5081149,2319286
Lithuania,2022-01-26,7434157,7434157,33722,https://e.infogram.com/57e5b447-c2ca-40da-aedb-cbf97df68a8e?parent_url=https%3A%2F%2Fosp.stat.gov.lt%2Fpraejusios-paros-covid-19-statistika&src=embed#async_embed,5453282,1980875,29316,4406,0.13065654468892712,29316,4406,5110465,2323692
Lithuania,2022-01-27,7434157,7434157,0,https://e.infogram.com/57e5b447-c2ca-40da-aedb-cbf97df68a8e?parent_url=https%3A%2F%2Fosp.stat.gov.lt%2Fpraejusios-paros-covid-19-statistika&src=embed#async_embed,5453282,1980875,0,0,0.13065654468892712,0,0,5110465,2323692
Lithuania,2022-01-28,7434157,7434157,0,https://e.infogram.com/57e5b447-c2ca-40da-aedb-cbf97df68a8e?parent_url=https%3A%2F%2Fosp.stat.gov.lt%2Fpraejusios-paros-covid-19-statistika&src=embed#async_embed,5453282,1980875,0,0,0.13065654468892712,0,0,5110465,2323692
Lithuania,2022-01-29,7434157,7434157,0,https://e.infogram.com/57e5b447-c2ca-40da-aedb-cbf97df68a8e?parent_url=https%3A%2F%2Fosp.stat.gov.lt%2Fpraejusios-paros-covid-19-statistika&src=embed#async_embed,5453282,1980875,0,0,0.13065654468892712,0,0,5110465,2323692
Lithuania,2022-01-30,7434157,7434157,0,https://e.infogram.com/57e5b447-c2ca-40da-aedb-cbf97df68a8e?parent_url=https%3A%2F%2Fosp.stat.gov.lt%2Fpraejusios-paros-covid-19-statistika&src=embed#async_embed,5453282,1980875,0,0,0.13065654468892712,0,0,5110465,2323692
Lithuania,2022-01-31,7434157,7434157,0,https://e.infogram.com/57e5b447-c2ca-40da-aedb-cbf97df68a8e?parent_url=https%3A%2F%2Fosp.stat.gov.lt%2Fpraejusios-paros-covid-19-statistika&src=embed#async_embed,5453282,1980875,0,0,0.13065654468892712,0,0,5110465,2323692
Lithuania,2022-02-01,7434157,7434157,0,https://e.infogram.com/57e5b447-c2ca-40da-aedb-cbf97df68a8e?parent_url=https%3A%2F%2Fosp.stat.gov.lt%2Fpraejusios-paros-covid-19-statistika&src=embed#async_embed,5453282,1980875,0,0,0.13065654468892712,0,0,5110465,2323692
Lithuania,2022-02-02,7434157,7434157,0,https://e.infogram.com/57e5b447-c2ca-40da-aedb-cbf97df68a8e?parent_url=https%3A%2F%2Fosp.stat.gov.lt%2Fpraejusios-paros-covid-19-statistika&src=embed#async_embed,5453282,1980875,0,0,0.13065654468892712,0,0,5110465,2323692
Lithuania,2022-02-03,7434157,7434157,0,https://e.infogram.com/57e5b447-c2ca-40da-aedb-cbf97df68a8e?parent_url=https%3A%2F%2Fosp.stat.gov.lt%2Fpraejusios-paros-covid-19-statistika&src=embed#async_embed,5453282,1980875,0,0,0.13065654468892712,0,0,5110465,2323692
Lithuania,2022-02-04,7434157,7434157,0,https://e.infogram.com/57e5b447-c2ca-40da-aedb-cbf97df68a8e?parent_url=https%3A%2F%2Fosp.stat.gov.lt%2Fpraejusios-paros-covid-19-statistika&src=embed#async_embed,5453282,1980875,0,0,0.13065654468892712,0,0,5110465,2323692
Lithuania,2022-02-05,7434157,7434157,0,https://e.infogram.com/57e5b447-c2ca-40da-aedb-cbf97df68a8e?parent_url=https%3A%2F%2Fosp.stat.gov.lt%2Fpraejusios-paros-covid-19-statistika&src=embed#async_embed,5453282,1980875,0,0,0.13065654468892712,0,0,5110465,2323692
Lithuania,2022-02-06,7434157,7434157,0,https://e.infogram.com/57e5b447-c2ca-40da-aedb-cbf97df68a8e?parent_url=https%3A%2F%2Fosp.stat.gov.lt%2Fpraejusios-paros-covid-19-statistika&src=embed#async_embed,5453282,1980875,0,0,0.13065654468892712,0,0,5110465,2323692
Lithuania,2022-02-07,7434157,7434157,0,https://e.infogram.com/57e5b447-c2ca-40da-aedb-cbf97df68a8e?parent_url=https%3A%2F%2Fosp.stat.gov.lt%2Fpraejusios-paros-covid-19-statistika&src=embed#async_embed,5453282,1980875,0,0,0.13065654468892712,0,0,5110465,2323692
Lithuania,2022-02-08,7434157,7434157,0,https://e.infogram.com/57e5b447-c2ca-40da-aedb-cbf97df68a8e?parent_url=https%3A%2F%2Fosp.stat.gov.lt%2Fpraejusios-paros-covid-19-statistika&src=embed#async_embed,5453282,1980875,0,0,0.13065654468892712,0,0,5110465,2323692
Lithuania,2022-02-09,7434157,7434157,0,https://e.infogram.com/57e5b447-c2ca-40da-aedb-cbf97df68a8e?parent_url=https%3A%2F%2Fosp.stat.gov.lt%2Fpraejusios-paros-covid-19-statistika&src=embed#async_embed,5453282,1980875,0,0,0.13065654468892712,0,0,5110465,2323692
Lithuania,2022-02-10,7434157,7434157,0,https://e.infogram.com/57e5b447-c2ca-40da-aedb-cbf97df68a8e?parent_url=https%3A%2F%2Fosp.stat.gov.lt%2Fpraejusios-paros-covid-19-statistika&src=embed#async_embed,5453282,1980875,0,0,0.13065654468892712,0,0,5110465,2323692
Lithuania,2022-02-11,7434157,7434157,0,https://e.infogram.com/57e5b447-c2ca-40da-aedb-cbf97df68a8e?parent_url=https%3A%2F%2Fosp.stat.gov.lt%2Fpraejusios-paros-covid-19-statistika&src=embed#async_embed,5453282,1980875,0,0,0.13065654468892712,0,0,5110465,2323692
Lithuania,2022-02-12,7434157,7434157,0,https://e.infogram.com/57e5b447-c2ca-40da-aedb-cbf97df68a8e?parent_url=https%3A%2F%2Fosp.stat.gov.lt%2Fpraejusios-paros-covid-19-statistika&src=embed#async_embed,5453282,1980875,0,0,0.13065654468892712,0,0,5110465,2323692
Lithuania,2022-02-13,7434157,7434157,0,https://e.infogram.com/57e5b447-c2ca-40da-aedb-cbf97df68a8e?parent_url=https%3A%2F%2Fosp.stat.gov.lt%2Fpraejusios-paros-covid-19-statistika&src=embed#async_embed,5453282,1980875,0,0,0.13065654468892712,0,0,5110465,2323692
Lithuania,2022-02-14,7434157,7434157,0,https://e.infogram.com/57e5b447-c2ca-40da-aedb-cbf97df68a8e?parent_url=https%3A%2F%2Fosp.stat.gov.lt%2Fpraejusios-paros-covid-19-statistika&src=embed#async_embed,5453282,1980875,0,0,0.13065654468892712,0,0,5110465,2323692
Lithuania,2022-02-15,7434157,7434157,0,https://e.infogram.com/57e5b447-c2ca-40da-aedb-cbf97df68a8e?parent_url=https%3A%2F%2Fosp.stat.gov.lt%2Fpraejusios-paros-covid-19-statistika&src=embed#async_embed,5453282,1980875,0,0,0.13065654468892712,0,0,5110465,2323692
Lithuania,2022-02-16,7434157,7434157,0,https://e.infogram.com/57e5b447-c2ca-40da-aedb-cbf97df68a8e?parent_url=https%3A%2F%2Fosp.stat.gov.lt%2Fpraejusios-paros-covid-19-statistika&src=embed#async_embed,5453282,1980875,0,0,0.13065654468892712,0,0,5110465,2323692
Lithuania,2022-02-17,7434157,7434157,0,https://e.infogram.com/57e5b447-c2ca-40da-aedb-cbf97df68a8e?parent_url=https%3A%2F%2Fosp.stat.gov.lt%2Fpraejusios-paros-covid-19-statistika&src=embed#async_embed,5453282,1980875,0,0,0.13065654468892712,0,0,5110465,2323692
Lithuania,2022-02-18,7434157,7434157,0,https://e.infogram.com/57e5b447-c2ca-40da-aedb-cbf97df68a8e?parent_url=https%3A%2F%2Fosp.stat.gov.lt%2Fpraejusios-paros-covid-19-statistika&src=embed#async_embed,5453282,1980875,0,0,0.13065654468892712,0,0,5110465,2323692
Lithuania,2022-02-19,7434157,7434157,0,https://e.infogram.com/57e5b447-c2ca-40da-aedb-cbf97df68a8e?parent_url=https%3A%2F%2Fosp.stat.gov.lt%2Fpraejusios-paros-covid-19-statistika&src=embed#async_embed,5453282,1980875,0,0,0.13065654468892712,0,0,5110465,2323692
Lithuania,2022-02-20,7434157,7434157,0,https://e.infogram.com/57e5b447-c2ca-40da-aedb-cbf97df68a8e?parent_url=https%3A%2F%2Fosp.stat.gov.lt%2Fpraejusios-paros-covid-19-statistika&src=embed#async_embed,5453282,1980875,0,0,0.13065654468892712,0,0,5110465,2323692
Lithuania,2022-02-21,7434157,7434157,0,https://e.infogram.com/57e5b447-c2ca-40da-aedb-cbf97df68a8e?parent_url=https%3A%2F%2Fosp.stat.gov.lt%2Fpraejusios-paros-covid-19-statistika&src=embed#async_embed,5453282,1980875,0,0,0.13065654468892712,0,0,5110465,2323692
Lithuania,2022-02-22,7434157,7434157,0,https://e.infogram.com/57e5b447-c2ca-40da-aedb-cbf97df68a8e?parent_url=https%3A%2F%2Fosp.stat.gov.lt%2Fpraejusios-paros-covid-19-statistika&src=embed#async_embed,5453282,1980875,0,0,0.13065654468892712,0,0,5110465,2323692
Lithuania,2022-02-23,7434157,7434157,0,https://e.infogram.com/57e5b447-c2ca-40da-aedb-cbf97df68a8e?parent_url=https%3A%2F%2Fosp.stat.gov.lt%2Fpraejusios-paros-covid-19-statistika&src=embed#async_embed,5453282,1980875,0,0,0.13065654468892712,0,0,5110465,2323692
Lithuania,2022-02-24,7434157,7434157,0,https://e.infogram.com/57e5b447-c2ca-40da-aedb-cbf97df68a8e?parent_url=https%3A%2F%2Fosp.stat.gov.lt%2Fpraejusios-paros-covid-19-statistika&src=embed#async_embed,5453282,1980875,0,0,0.13065654468892712,0,0,5110465,2323692
Lithuania,2022-02-25,7434157,7434157,0,https://e.infogram.com/57e5b447-c2ca-40da-aedb-cbf97df68a8e?parent_url=https%3A%2F%2Fosp.stat.gov.lt%2Fpraejusios-paros-covid-19-statistika&src=embed#async_embed,5453282,1980875,0,0,0.13065654468892712,0,0,5110465,2323692
Lithuania,2022-02-26,7434157,7434157,0,https://e.infogram.com/57e5b447-c2ca-40da-aedb-cbf97df68a8e?parent_url=https%3A%2F%2Fosp.stat.gov.lt%2Fpraejusios-paros-covid-19-statistika&src=embed#async_embed,5453282,1980875,0,0,0.13065654468892712,0,0,5110465,2323692
Lithuania,2022-02-27,7434157,7434157,0,https://e.infogram.com/57e5b447-c2ca-40da-aedb-cbf97df68a8e?parent_url=https%3A%2F%2Fosp.stat.gov.lt%2Fpraejusios-paros-covid-19-statistika&src=embed#async_embed,5453282,1980875,0,0,0.13065654468892712,0,0,5110465,2323692
Lithuania,2022-02-28,7434157,7434157,0,https://e.infogram.com/57e5b447-c2ca-40da-aedb-cbf97df68a8e?parent_url=https%3A%2F%2Fosp.stat.gov.lt%2Fpraejusios-paros-covid-19-statistika&src=embed#async_embed,5453282,1980875,0,0,0.13065654468892712,0,0,5110465,2323692
Lithuania,2022-03-01,7434157,7434157,0,https://e.infogram.com/57e5b447-c2ca-40da-aedb-cbf97df68a8e?parent_url=https%3A%2F%2Fosp.stat.gov.lt%2Fpraejusios-paros-covid-19-statistika&src=embed#async_embed,5453282,1980875,0,0,0.13065654468892712,0,0,5110465,2323692
Lithuania,2022-03-02,7434157,7434157,0,https://e.infogram.com/57e5b447-c2ca-40da-aedb-cbf97df68a8e?parent_url=https%3A%2F%2Fosp.stat.gov.lt%2Fpraejusios-paros-covid-19-statistika&src=embed#async_embed,5453282,1980875,0,0,0.13065654468892712,0,0,5110465,2323692
Lithuania,2022-03-03,7434157,7434157,0,https://e.infogram.com/57e5b447-c2ca-40da-aedb-cbf97df68a8e?parent_url=https%3A%2F%2Fosp.stat.gov.lt%2Fpraejusios-paros-covid-19-statistika&src=embed#async_embed,5453282,1980875,0,0,0.13065654468892712,0,0,5110465,2323692
Lithuania,2022-03-04,7434157,7434157,0,https://e.infogram.com/57e5b447-c2ca-40da-aedb-cbf97df68a8e?parent_url=https%3A%2F%2Fosp.stat.gov.lt%2Fpraejusios-paros-covid-19-statistika&src=embed#async_embed,5453282,1980875,0,0,0.13065654468892712,0,0,5110465,2323692
Lithuania,2022-03-05,7434157,7434157,0,https://e.infogram.com/57e5b447-c2ca-40da-aedb-cbf97df68a8e?parent_url=https%3A%2F%2Fosp.stat.gov.lt%2Fpraejusios-paros-covid-19-statistika&src=embed#async_embed,5453282,1980875,0,0,0.13065654468892712,0,0,5110465,2323692
Lithuania,2022-03-06,7434157,7434157,0,https://e.infogram.com/57e5b447-c2ca-40da-aedb-cbf97df68a8e?parent_url=https%3A%2F%2Fosp.stat.gov.lt%2Fpraejusios-paros-covid-19-statistika&src=embed#async_embed,5453282,1980875,0,0,0.13065654468892712,0,0,5110465,2323692
Lithuania,2022-03-07,7434157,7434157,0,https://e.infogram.com/57e5b447-c2ca-40da-aedb-cbf97df68a8e?parent_url=https%3A%2F%2Fosp.stat.gov.lt%2Fpraejusios-paros-covid-19-statistika&src=embed#async_embed,5453282,1980875,0,0,0.13065654468892712,0,0,5110465,2323692
Lithuania,2022-03-08,7434157,7434157,0,https://e.infogram.com/57e5b447-c2ca-40da-aedb-cbf97df68a8e?parent_url=https%3A%2F%2Fosp.stat.gov.lt%2Fpraejusios-paros-covid-19-statistika&src=embed#async_embed,5453282,1980875,0,0,0.13065654468892712,0,0,5110465,2323692
Lithuania,2022-03-09,7434157,7434157,0,https://e.infogram.com/57e5b447-c2ca-40da-aedb-cbf97df68a8e?parent_url=https%3A%2F%2Fosp.stat.gov.lt%2Fpraejusios-paros-covid-19-statistika&src=embed#async_embed,5453282,1980875,0,0,0.13065654468892712,0,0,5110465,2323692
Lithuania,2022-03-10,7434157,7434157,0,https://e.infogram.com/57e5b447-c2ca-40da-aedb-cbf97df68a8e?parent_url=https%3A%2F%2Fosp.stat.gov.lt%2Fpraejusios-paros-covid-19-statistika&src=embed#async_embed,5453282,1980875,0,0,0.13065654468892712,0,0,5110465,2323692
Lithuania,2022-03-11,7434157,7434157,0,https://e.infogram.com/57e5b447-c2ca-40da-aedb-cbf97df68a8e?parent_url=https%3A%2F%2Fosp.stat.gov.lt%2Fpraejusios-paros-covid-19-statistika&src=embed#async_embed,5453282,1980875,0,0,0.13065654468892712,0,0,5110465,2323692
Lithuania,2022-03-12,7434157,7434157,0,https://e.infogram.com/57e5b447-c2ca-40da-aedb-cbf97df68a8e?parent_url=https%3A%2F%2Fosp.stat.gov.lt%2Fpraejusios-paros-covid-19-statistika&src=embed#async_embed,5453282,1980875,0,0,0.13065654468892712,0,0,5110465,2323692
Lithuania,2022-03-13,7434157,7434157,0,https://e.infogram.com/57e5b447-c2ca-40da-aedb-cbf97df68a8e?parent_url=https%3A%2F%2Fosp.stat.gov.lt%2Fpraejusios-paros-covid-19-statistika&src=embed#async_embed,5453282,1980875,0,0,0.13065654468892712,0,0,5110465,2323692
Lithuania,2022-03-14,7434157,7434157,0,https://e.infogram.com/57e5b447-c2ca-40da-aedb-cbf97df68a8e?parent_url=https%3A%2F%2Fosp.stat.gov.lt%2Fpraejusios-paros-covid-19-statistika&src=embed#async_embed,5453282,1980875,0,0,0.13065654468892712,0,0,5110465,2323692
Lithuania,2022-03-15,7434157,7434157,0,https://e.infogram.com/57e5b447-c2ca-40da-aedb-cbf97df68a8e?parent_url=https%3A%2F%2Fosp.stat.gov.lt%2Fpraejusios-paros-covid-19-statistika&src=embed#async_embed,5453282,1980875,0,0,0.13065654468892712,0,0,5110465,2323692
Lithuania,2022-03-16,7434157,7434157,0,https://e.infogram.com/57e5b447-c2ca-40da-aedb-cbf97df68a8e?parent_url=https%3A%2F%2Fosp.stat.gov.lt%2Fpraejusios-paros-covid-19-statistika&src=embed#async_embed,5453282,1980875,0,0,0.13065654468892712,0,0,5110465,2323692
Lithuania,2022-03-17,7434157,7434157,0,https://e.infogram.com/57e5b447-c2ca-40da-aedb-cbf97df68a8e?parent_url=https%3A%2F%2Fosp.stat.gov.lt%2Fpraejusios-paros-covid-19-statistika&src=embed#async_embed,5453282,1980875,0,0,0.13065654468892712,0,0,5110465,2323692
Lithuania,2022-03-18,7434157,7434157,0,https://e.infogram.com/57e5b447-c2ca-40da-aedb-cbf97df68a8e?parent_url=https%3A%2F%2Fosp.stat.gov.lt%2Fpraejusios-paros-covid-19-statistika&src=embed#async_embed,5453282,1980875,0,0,0.13065654468892712,0,0,5110465,2323692
Lithuania,2022-03-19,7434157,7434157,0,https://e.infogram.com/57e5b447-c2ca-40da-aedb-cbf97df68a8e?parent_url=https%3A%2F%2Fosp.stat.gov.lt%2Fpraejusios-paros-covid-19-statistika&src=embed#async_embed,6278589,2073093,825307,92218,0.10050734312416555,0,0,5110465,2323692
Lithuania,2022-03-20,8359222,8359222,925065,https://e.infogram.com/57e5b447-c2ca-40da-aedb-cbf97df68a8e?parent_url=https%3A%2F%2Fosp.stat.gov.lt%2Fpraejusios-paros-covid-19-statistika&src=embed#async_embed,6285613,2073609,7024,516,0.06843501326259947,861758,63307,5972223,2386999
Lithuania,2022-03-21,8364496,8364496,5274,https://e.infogram.com/57e5b447-c2ca-40da-aedb-cbf97df68a8e?parent_url=https%3A%2F%2Fosp.stat.gov.lt%2Fpraejusios-paros-covid-19-statistika&src=embed#async_embed,6290531,2073965,4918,356,0.06750094804702313,4918,356,5977141,2387355
Lithuania,2022-03-22,8376530,8376530,12034,https://e.infogram.com/57e5b447-c2ca-40da-aedb-cbf97df68a8e?parent_url=https%3A%2F%2Fosp.stat.gov.lt%2Fpraejusios-paros-covid-19-statistika&src=embed#async_embed,6301169,2075361,10638,1396,0.11600465348180156,10638,1396,5987779,2388751
Lithuania,2022-03-23,8390159,8390159,13629,https://e.infogram.com/57e5b447-c2ca-40da-aedb-cbf97df68a8e?parent_url=https%3A%2F%2Fosp.stat.gov.lt%2Fpraejusios-paros-covid-19-statistika&src=embed#async_embed,6313734,2076425,12565,1064,0.0780688238315357,12565,1064,6000344,2389815
Lithuania,2022-03-24,8401858,8401858,11699,https://e.infogram.com/57e5b447-c2ca-40da-aedb-cbf97df68a8e?parent_url=https%3A%2F%2Fosp.stat.gov.lt%2Fpraejusios-paros-covid-19-statistika&src=embed#async_embed,6324595,2077263,10861,838,0.07163005385075648,10861,838,6011205,2390653
Lithuania,2022-03-25,8412400,8412400,10542,https://e.infogram.com/57e5b447-c2ca-40da-aedb-cbf97df68a8e?parent_url=https%3A%2F%2Fosp.stat.gov.lt%2Fpraejusios-paros-covid-19-statistika&src=embed#async_embed,6334076,2078324,9481,1061,0.10064503889205084,9481,1061,6020686,2391714
Lithuania,2022-03-26,8422702,8422702,10302,https://e.infogram.com/57e5b447-c2ca-40da-aedb-cbf97df68a8e?parent_url=https%3A%2F%2Fosp.stat.gov.lt%2Fpraejusios-paros-covid-19-statistika&src=embed#async_embed,6343304,2079398,9228,1074,0.10425160163075131,9228,1074,6029914,2392788
Lithuania,2022-03-27,8429499,8429499,6797,https://e.infogram.com/57e5b447-c2ca-40da-aedb-cbf97df68a8e?parent_url=https%3A%2F%2Fosp.stat.gov.lt%2Fpraejusios-paros-covid-19-statistika&src=embed#async_embed,6349597,2079902,6293,504,0.07415036045314109,6293,504,6036207,2393292
Lithuania,2022-03-28,8433349,8433349,3850,https://e.infogram.com/57e5b447-c2ca-40da-aedb-cbf97df68a8e?parent_url=https%3A%2F%2Fosp.stat.gov.lt%2Fpraejusios-paros-covid-19-statistika&src=embed#async_embed,6353070,2080279,3473,377,0.09792207792207792,3473,377,6039680,2393669
Lithuania,2022-03-29,8443368,8443368,10019,https://e.infogram.com/57e5b447-c2ca-40da-aedb-cbf97df68a8e?parent_url=https%3A%2F%2Fosp.stat.gov.lt%2Fpraejusios-paros-covid-19-statistika&src=embed#async_embed,6361751,2081617,8681,1338,0.13354626210200618,8681,1338,6048361,2395007
Lithuania,2022-03-30,8454701,8454701,11333,https://e.infogram.com/57e5b447-c2ca-40da-aedb-cbf97df68a8e?parent_url=https%3A%2F%2Fosp.stat.gov.lt%2Fpraejusios-paros-covid-19-statistika&src=embed#async_embed,6372127,2082574,10376,957,0.08444366010765023,10376,957,6058737,2395964
Lithuania,2022-03-31,8464741,8464741,10040,https://e.infogram.com/57e5b447-c2ca-40da-aedb-cbf97df68a8e?parent_url=https%3A%2F%2Fosp.stat.gov.lt%2Fpraejusios-paros-covid-19-statistika&src=embed#async_embed,6381244,2083497,9117,923,0.09193227091633466,9117,923,6067854,2396887
Lithuania,2022-04-01,8474746,8474746,10005,https://e.infogram.com/57e5b447-c2ca-40da-aedb-cbf97df68a8e?parent_url=https%3A%2F%2Fosp.stat.gov.lt%2Fpraejusios-paros-covid-19-statistika&src=embed#async_embed,6390242,2084504,8998,1007,0.1006496751624188,8998,1007,6076852,2397894
Lithuania,2022-04-02,8482868,8482868,8122,https://e.infogram.com/57e5b447-c2ca-40da-aedb-cbf97df68a8e?parent_url=https%3A%2F%2Fosp.stat.gov.lt%2Fpraejusios-paros-covid-19-statistika&src=embed#async_embed,6397225,2085643,6983,1139,0.14023639497660675,6983,1139,6083835,2399033
Lithuania,2022-04-03,8488676,8488676,5808,https://e.infogram.com/57e5b447-c2ca-40da-aedb-cbf97df68a8e?parent_url=https%3A%2F%2Fosp.stat.gov.lt%2Fpraejusios-paros-covid-19-statistika&src=embed#async_embed,6402602,2086074,5377,431,0.07420798898071625,5377,431,6089212,2399464
Lithuania,2022-04-04,8492118,8492118,3442,https://e.infogram.com/57e5b447-c2ca-40da-aedb-cbf97df68a8e?parent_url=https%3A%2F%2Fosp.stat.gov.lt%2Fpraejusios-paros-covid-19-statistika&src=embed#async_embed,6405809,2086309,3207,235,0.06827425915165601,3207,235,6092419,2399699
Lithuania,2022-04-05,8501327,8501327,9209,https://e.infogram.com/57e5b447-c2ca-40da-aedb-cbf97df68a8e?parent_url=https%3A%2F%2Fosp.stat.gov.lt%2Fpraejusios-paros-covid-19-statistika&src=embed#async_embed,6413666,2087661,7857,1352,0.14681290042349876,7857,1352,6100276,2401051
Lithuania,2022-04-06,8511491,8511491,10164,https://e.infogram.com/57e5b447-c2ca-40da-aedb-cbf97df68a8e?parent_url=https%3A%2F%2Fosp.stat.gov.lt%2Fpraejusios-paros-covid-19-statistika&src=embed#async_embed,6422956,2088535,9290,874,0.08598976780794963,9290,874,6109566,2401925
Lithuania,2022-04-07,8519994,8519994,8503,https://e.infogram.com/57e5b447-c2ca-40da-aedb-cbf97df68a8e?parent_url=https%3A%2F%2Fosp.stat.gov.lt%2Fpraejusios-paros-covid-19-statistika&src=embed#async_embed,6430568,2089426,7612,891,0.10478654592496765,7612,891,6117178,2402816
Lithuania,2022-04-08,8527341,8527341,7347,https://e.infogram.com/57e5b447-c2ca-40da-aedb-cbf97df68a8e?parent_url=https%3A%2F%2Fosp.stat.gov.lt%2Fpraejusios-paros-covid-19-statistika&src=embed#async_embed,6437125,2090216,6557,790,0.10752688172043011,6557,790,6123735,2403606
Lithuania,2022-04-09,8534525,8534525,7184,https://e.infogram.com/57e5b447-c2ca-40da-aedb-cbf97df68a8e?parent_url=https%3A%2F%2Fosp.stat.gov.lt%2Fpraejusios-paros-covid-19-statistika&src=embed#async_embed,6443449,2091076,6324,860,0.11971046770601336,6324,860,6130059,2404466
Lithuania,2022-04-10,8539441,8539441,4916,https://e.infogram.com/57e5b447-c2ca-40da-aedb-cbf97df68a8e?parent_url=https%3A%2F%2Fosp.stat.gov.lt%2Fpraejusios-paros-covid-19-statistika&src=embed#async_embed,6447866,2091575,4417,499,0.10150528885272579,4417,499,6134476,2404965
Lithuania,2022-04-11,8543364,8543364,3923,https://e.infogram.com/57e5b447-c2ca-40da-aedb-cbf97df68a8e?parent_url=https%3A%2F%2Fosp.stat.gov.lt%2Fpraejusios-paros-covid-19-statistika&src=embed#async_embed,6451402,2091962,3536,387,0.0986489931175121,3536,387,6138012,2405352
Lithuania,2022-04-12,8551358,8551358,7994,https://e.infogram.com/57e5b447-c2ca-40da-aedb-cbf97df68a8e?parent_url=https%3A%2F%2Fosp.stat.gov.lt%2Fpraejusios-paros-covid-19-statistika&src=embed#async_embed,6458213,2093145,6811,1183,0.14798598949211908,6811,1183,6144823,2406535
Lithuania,2022-04-13,8560214,8560214,8856,https://e.infogram.com/57e5b447-c2ca-40da-aedb-cbf97df68a8e?parent_url=https%3A%2F%2Fosp.stat.gov.lt%2Fpraejusios-paros-covid-19-statistika&src=embed#async_embed,6466173,2094041,7960,896,0.1011743450767841,7960,896,6152783,2407431
Lithuania,2022-04-14,8567959,8567959,7745,https://e.infogram.com/57e5b447-c2ca-40da-aedb-cbf97df68a8e?parent_url=https%3A%2F%2Fosp.stat.gov.lt%2Fpraejusios-paros-covid-19-statistika&src=embed#async_embed,6472934,2095025,6761,984,0.12704970948999356,6761,984,6159544,2408415
Lithuania,2022-04-15,8574564,8574564,6605,https://e.infogram.com/57e5b447-c2ca-40da-aedb-cbf97df68a8e?parent_url=https%3A%2F%2Fosp.stat.gov.lt%2Fpraejusios-paros-covid-19-statistika&src=embed#async_embed,6478671,2095893,5737,868,0.13141559424678273,5737,868,6165281,2409283
Lithuania,2022-04-16,8580980,8580980,6416,https://e.infogram.com/57e5b447-c2ca-40da-aedb-cbf97df68a8e?parent_url=https%3A%2F%2Fosp.stat.gov.lt%2Fpraejusios-paros-covid-19-statistika&src=embed#async_embed,6483974,2097006,5303,1113,0.17347256857855362,5303,1113,6170584,2410396
Lithuania,2022-04-17,8584943,8584943,3963,https://e.infogram.com/57e5b447-c2ca-40da-aedb-cbf97df68a8e?parent_url=https%3A%2F%2Fosp.stat.gov.lt%2Fpraejusios-paros-covid-19-statistika&src=embed#async_embed,6487433,2097510,3459,504,0.1271763815291446,3459,504,6174043,2410900
Lithuania,2022-04-18,8587721,8587721,2778,https://e.infogram.com/57e5b447-c2ca-40da-aedb-cbf97df68a8e?parent_url=https%3A%2F%2Fosp.stat.gov.lt%2Fpraejusios-paros-covid-19-statistika&src=embed#async_embed,6489812,2097909,2379,399,0.14362850971922247,2379,399,6176422,2411299
Lithuania,2022-04-19,8590802,8590802,3081,https://e.infogram.com/57e5b447-c2ca-40da-aedb-cbf97df68a8e?parent_url=https%3A%2F%2Fosp.stat.gov.lt%2Fpraejusios-paros-covid-19-statistika&src=embed#async_embed,6492437,2098365,2625,456,0.14800389483933787,2625,456,6179047,2411755
Lithuania,2022-04-20,8599096,8599096,8294,https://e.infogram.com/57e5b447-c2ca-40da-aedb-cbf97df68a8e?parent_url=https%3A%2F%2Fosp.stat.gov.lt%2Fpraejusios-paros-covid-19-statistika&src=embed#async_embed,6499420,2099676,6983,1311,0.15806607185917532,6983,1311,6186030,2413066
Lithuania,2022-04-21,8606875,8606875,7779,https://e.infogram.com/57e5b447-c2ca-40da-aedb-cbf97df68a8e?parent_url=https%3A%2F%2Fosp.stat.gov.lt%2Fpraejusios-paros-covid-19-statistika&src=embed#async_embed,6506159,2100716,6739,1040,0.13369327677079315,6739,1040,6192769,2414106
Lithuania,2022-04-22,8613633,8613633,6758,https://e.infogram.com/57e5b447-c2ca-40da-aedb-cbf97df68a8e?parent_url=https%3A%2F%2Fosp.stat.gov.lt%2Fpraejusios-paros-covid-19-statistika&src=embed#async_embed,6512035,2101598,5876,882,0.1305119857946138,5876,882,6198645,2414988
Lithuania,2022-04-23,8619161,8619161,5528,https://e.infogram.com/57e5b447-c2ca-40da-aedb-cbf97df68a8e?parent_url=https%3A%2F%2Fosp.stat.gov.lt%2Fpraejusios-paros-covid-19-statistika&src=embed#async_embed,6516670,2102491,4635,893,0.1615412445730825,4635,893,6203280,2415881
Lithuania,2022-04-24,8623143,8623143,3982,https://e.infogram.com/57e5b447-c2ca-40da-aedb-cbf97df68a8e?parent_url=https%3A%2F%2Fosp.stat.gov.lt%2Fpraejusios-paros-covid-19-statistika&src=embed#async_embed,6520152,2102991,3482,500,0.12556504269211452,3482,500,6206762,2416381
Lithuania,2022-04-25,8625664,8625664,2521,https://e.infogram.com/57e5b447-c2ca-40da-aedb-cbf97df68a8e?parent_url=https%3A%2F%2Fosp.stat.gov.lt%2Fpraejusios-paros-covid-19-statistika&src=embed#async_embed,6522314,2103350,2162,359,0.14240380801269337,2162,359,6208924,2416740
Lithuania,2022-04-26,8632625,8632625,6961,https://e.infogram.com/57e5b447-c2ca-40da-aedb-cbf97df68a8e?parent_url=https%3A%2F%2Fosp.stat.gov.lt%2Fpraejusios-paros-covid-19-statistika&src=embed#async_embed,6528107,2104518,5793,1168,0.1677919839103577,5793,1168,6214717,2417908
Lithuania,2022-04-27,8639757,8639757,7132,https://e.infogram.com/57e5b447-c2ca-40da-aedb-cbf97df68a8e?parent_url=https%3A%2F%2Fosp.stat.gov.lt%2Fpraejusios-paros-covid-19-statistika&src=embed#async_embed,6534431,2105326,6324,808,0.11329220415030847,6324,808,6221041,2418716
Lithuania,2022-04-28,8645449,8645449,5692,https://e.infogram.com/57e5b447-c2ca-40da-aedb-cbf97df68a8e?parent_url=https%3A%2F%2Fosp.stat.gov.lt%2Fpraejusios-paros-covid-19-statistika&src=embed#async_embed,6539331,2106118,4900,792,0.13914265635980325,4900,792,6225941,2419508
Lithuania,2022-04-29,8650424,8650424,4975,https://e.infogram.com/57e5b447-c2ca-40da-aedb-cbf97df68a8e?parent_url=https%3A%2F%2Fosp.stat.gov.lt%2Fpraejusios-paros-covid-19-statistika&src=embed#async_embed,6543662,2106762,4331,644,0.12944723618090453,4331,644,6230272,2420152
Lithuania,2022-04-30,8655183,8655183,4759,https://e.infogram.com/57e5b447-c2ca-40da-aedb-cbf97df68a8e?parent_url=https%3A%2F%2Fosp.stat.gov.lt%2Fpraejusios-paros-covid-19-statistika&src=embed#async_embed,6547641,2107542,3979,780,0.16389997898718217,3979,780,6234251,2420932
Lithuania,2022-05-01,8655183,8655183,0,https://e.infogram.com/57e5b447-c2ca-40da-aedb-cbf97df68a8e?parent_url=https%3A%2F%2Fosp.stat.gov.lt%2Fpraejusios-paros-covid-19-statistika&src=embed#async_embed,6547641,2107542,0,0,0.16389997898718217,0,0,6234251,2420932
Lithuania,2022-05-02,8660045,8660045,4862,https://e.infogram.com/57e5b447-c2ca-40da-aedb-cbf97df68a8e?parent_url=https%3A%2F%2Fosp.stat.gov.lt%2Fpraejusios-paros-covid-19-statistika&src=embed#async_embed,6551703,2108342,4062,800,0.16454134101192924,4062,800,6238313,2421732
Lithuania,2022-05-03,8663049,8663049,3004,https://e.infogram.com/57e5b447-c2ca-40da-aedb-cbf97df68a8e?parent_url=https%3A%2F%2Fosp.stat.gov.lt%2Fpraejusios-paros-covid-19-statistika&src=embed#async_embed,6553574,2109475,1871,1133,0.37716378162450065,1871,1133,6240184,2422865
Lithuania,2022-05-04,8665319,8665319,2270,https://e.infogram.com/57e5b447-c2ca-40da-aedb-cbf97df68a8e?parent_url=https%3A%2F%2Fosp.stat.gov.lt%2Fpraejusios-paros-covid-19-statistika&src=embed#async_embed,6554799,2110520,1225,1045,0.460352422907489,1225,1045,6241409,2423910
Lithuania,2022-05-05,8667181,8667181,1862,https://e.infogram.com/57e5b447-c2ca-40da-aedb-cbf97df68a8e?parent_url=https%3A%2F%2Fosp.stat.gov.lt%2Fpraejusios-paros-covid-19-statistika&src=embed#async_embed,6555706,2111475,907,955,0.5128893662728249,907,955,6242316,2424865
Lithuania,2022-05-06,8669000,8669000,1819,https://e.infogram.com/57e5b447-c2ca-40da-aedb-cbf97df68a8e?parent_url=https%3A%2F%2Fosp.stat.gov.lt%2Fpraejusios-paros-covid-19-statistika&src=embed#async_embed,6556516,2112484,810,1009,0.5547003848268279,810,1009,6243126,2425874
Lithuania,2022-05-07,8669000,8669000,0,https://e.infogram.com/57e5b447-c2ca-40da-aedb-cbf97df68a8e?parent_url=https%3A%2F%2Fosp.stat.gov.lt%2Fpraejusios-paros-covid-19-statistika&src=embed#async_embed,6556516,2112484,0,0,0.5547003848268279,0,0,6243126,2425874
Lithuania,2022-05-08,8669000,8669000,0,https://e.infogram.com/57e5b447-c2ca-40da-aedb-cbf97df68a8e?parent_url=https%3A%2F%2Fosp.stat.gov.lt%2Fpraejusios-paros-covid-19-statistika&src=embed#async_embed,6556516,2112484,0,0,0.5547003848268279,0,0,6243126,2425874
Lithuania,2022-05-09,8671977,8671977,2977,https://e.infogram.com/57e5b447-c2ca-40da-aedb-cbf97df68a8e?parent_url=https%3A%2F%2Fosp.stat.gov.lt%2Fpraejusios-paros-covid-19-statistika&src=embed#async_embed,6557776,2114201,1260,1717,0.576755122606651,1260,1717,6244386,2427591
Lithuania,2022-05-10,8674399,8674399,2422,https://e.infogram.com/57e5b447-c2ca-40da-aedb-cbf97df68a8e?parent_url=https%3A%2F%2Fosp.stat.gov.lt%2Fpraejusios-paros-covid-19-statistika&src=embed#async_embed,6558964,2115435,1188,1234,0.509496284062758,1188,1234,6245574,2428825
Lithuania,2022-05-11,8676096,8676096,1697,https://e.infogram.com/57e5b447-c2ca-40da-aedb-cbf97df68a8e?parent_url=https%3A%2F%2Fosp.stat.gov.lt%2Fpraejusios-paros-covid-19-statistika&src=embed#async_embed,6559659,2116437,695,1002,0.5904537418974661,695,1002,6246269,2429827
Lithuania,2022-05-12,8677919,8677919,1823,https://e.infogram.com/57e5b447-c2ca-40da-aedb-cbf97df68a8e?parent_url=https%3A%2F%2Fosp.stat.gov.lt%2Fpraejusios-paros-covid-19-statistika&src=embed#async_embed,6560437,2117482,778,1045,0.5732309380142622,778,1045,6247047,2430872
Lithuania,2022-05-13,8679400,8679400,1481,https://e.infogram.com/57e5b447-c2ca-40da-aedb-cbf97df68a8e?parent_url=https%3A%2F%2Fosp.stat.gov.lt%2Fpraejusios-paros-covid-19-statistika&src=embed#async_embed,6561130,2118270,693,788,0.5320729237002025,693,788,6247740,2431660
Lithuania,2022-05-14,8679400,8679400,0,https://e.infogram.com/57e5b447-c2ca-40da-aedb-cbf97df68a8e?parent_url=https%3A%2F%2Fosp.stat.gov.lt%2Fpraejusios-paros-covid-19-statistika&src=embed#async_embed,6561130,2118270,0,0,0.5320729237002025,0,0,6247740,2431660
Lithuania,2022-05-15,8679400,8679400,0,https://e.infogram.com/57e5b447-c2ca-40da-aedb-cbf97df68a8e?parent_url=https%3A%2F%2Fosp.stat.gov.lt%2Fpraejusios-paros-covid-19-statistika&src=embed#async_embed,6561130,2118270,0,0,0.5320729237002025,0,0,6247740,2431660
Lithuania,2022-05-16,8682063,8682063,2663,https://e.infogram.com/57e5b447-c2ca-40da-aedb-cbf97df68a8e?parent_url=https%3A%2F%2Fosp.stat.gov.lt%2Fpraejusios-paros-covid-19-statistika&src=embed#async_embed,6561965,2120098,835,1828,0.6864438603079234,835,1828,6248575,2433488
Lithuania,2022-05-17,8684346,8684346,2283,https://e.infogram.com/57e5b447-c2ca-40da-aedb-cbf97df68a8e?parent_url=https%3A%2F%2Fosp.stat.gov.lt%2Fpraejusios-paros-covid-19-statistika&src=embed#async_embed,6562957,2121389,992,1291,0.5654840122645641,992,1291,6249567,2434779
Lithuania,2022-05-18,8685887,8685887,1541,https://e.infogram.com/57e5b447-c2ca-40da-aedb-cbf97df68a8e?parent_url=https%3A%2F%2Fosp.stat.gov.lt%2Fpraejusios-paros-covid-19-statistika&src=embed#async_embed,6563357,2122530,400,1141,0.7404282933160286,400,1141,6249967,2435920
Lithuania,2022-05-19,8687311,8687311,1424,https://e.infogram.com/57e5b447-c2ca-40da-aedb-cbf97df68a8e?parent_url=https%3A%2F%2Fosp.stat.gov.lt%2Fpraejusios-paros-covid-19-statistika&src=embed#async_embed,6563786,2123525,429,995,0.6987359550561798,429,995,6250396,2436915
Lithuania,2022-05-20,8688600,8688600,1289,https://e.infogram.com/57e5b447-c2ca-40da-aedb-cbf97df68a8e?parent_url=https%3A%2F%2Fosp.stat.gov.lt%2Fpraejusios-paros-covid-19-statistika&src=embed#async_embed,6564157,2124443,371,918,0.7121799844840963,371,918,6250767,2437833
Lithuania,2022-05-21,8688600,8688600,0,https://e.infogram.com/57e5b447-c2ca-40da-aedb-cbf97df68a8e?parent_url=https%3A%2F%2Fosp.stat.gov.lt%2Fpraejusios-paros-covid-19-statistika&src=embed#async_embed,6564157,2124443,0,0,0.7121799844840963,0,0,6250767,2437833
Lithuania,2022-05-22,8688600,8688600,0,https://e.infogram.com/57e5b447-c2ca-40da-aedb-cbf97df68a8e?parent_url=https%3A%2F%2Fosp.stat.gov.lt%2Fpraejusios-paros-covid-19-statistika&src=embed#async_embed,6564157,2124443,0,0,0.7121799844840963,0,0,6250767,2437833
Lithuania,2022-05-23,8691050,8691050,2450,https://e.infogram.com/57e5b447-c2ca-40da-aedb-cbf97df68a8e?parent_url=https%3A%2F%2Fosp.stat.gov.lt%2Fpraejusios-paros-covid-19-statistika&src=embed#async_embed,6564762,2126288,605,1845,0.753061224489796,605,1845,6251372,2439678
Lithuania,2022-05-24,8693003,8693003,1953,https://e.infogram.com/57e5b447-c2ca-40da-aedb-cbf97df68a8e?parent_url=https%3A%2F%2Fosp.stat.gov.lt%2Fpraejusios-paros-covid-19-statistika&src=embed#async_embed,6565459,2127544,697,1256,0.6431131592421915,697,1256,6252069,2440934
Lithuania,2022-05-25,8694356,8694356,1353,https://e.infogram.com/57e5b447-c2ca-40da-aedb-cbf97df68a8e?parent_url=https%3A%2F%2Fosp.stat.gov.lt%2Fpraejusios-paros-covid-19-statistika&src=embed#async_embed,6565812,2128544,353,1000,0.7390983000739099,353,1000,6252422,2441934
Lithuania,2022-05-26,8695651,8695651,1295,https://e.infogram.com/57e5b447-c2ca-40da-aedb-cbf97df68a8e?parent_url=https%3A%2F%2Fosp.stat.gov.lt%2Fpraejusios-paros-covid-19-statistika&src=embed#async_embed,6566133,2129518,321,974,0.7521235521235521,321,974,6252743,2442908
Lithuania,2022-05-27,8696934,8696934,1283,https://e.infogram.com/57e5b447-c2ca-40da-aedb-cbf97df68a8e?parent_url=https%3A%2F%2Fosp.stat.gov.lt%2Fpraejusios-paros-covid-19-statistika&src=embed#async_embed,6566474,2130460,341,942,0.7342166796570537,341,942,6253084,2443850
Lithuania,2022-05-28,8696934,8696934,0,https://e.infogram.com/57e5b447-c2ca-40da-aedb-cbf97df68a8e?parent_url=https%3A%2F%2Fosp.stat.gov.lt%2Fpraejusios-paros-covid-19-statistika&src=embed#async_embed,6566474,2130460,0,0,0.7342166796570537,0,0,6253084,2443850
Lithuania,2022-05-29,8696934,8696934,0,https://e.infogram.com/57e5b447-c2ca-40da-aedb-cbf97df68a8e?parent_url=https%3A%2F%2Fosp.stat.gov.lt%2Fpraejusios-paros-covid-19-statistika&src=embed#async_embed,6566474,2130460,0,0,0.7342166796570537,0,0,6253084,2443850
Lithuania,2022-05-30,8699399,8699399,2465,https://e.infogram.com/57e5b447-c2ca-40da-aedb-cbf97df68a8e?parent_url=https%3A%2F%2Fosp.stat.gov.lt%2Fpraejusios-paros-covid-19-statistika&src=embed#async_embed,6567168,2132231,694,1771,0.7184584178498986,694,1771,6253778,2445621
Lithuania,2022-05-31,8701070,8701070,1671,https://e.infogram.com/57e5b447-c2ca-40da-aedb-cbf97df68a8e?parent_url=https%3A%2F%2Fosp.stat.gov.lt%2Fpraejusios-paros-covid-19-statistika&src=embed#async_embed,6567560,2133510,392,1279,0.765409934171155,392,1279,6254170,2446900
Lithuania,2022-06-01,8702355,8702355,1285,https://e.infogram.com/57e5b447-c2ca-40da-aedb-cbf97df68a8e?parent_url=https%3A%2F%2Fosp.stat.gov.lt%2Fpraejusios-paros-covid-19-statistika&src=embed#async_embed,6567856,2134499,296,989,0.7696498054474709,296,989,6254466,2447889
Lithuania,2022-06-02,8703527,8703527,1172,https://e.infogram.com/57e5b447-c2ca-40da-aedb-cbf97df68a8e?parent_url=https%3A%2F%2Fosp.stat.gov.lt%2Fpraejusios-paros-covid-19-statistika&src=embed#async_embed,6568172,2135355,316,856,0.7303754266211604,316,856,6254782,2448745
Lithuania,2022-06-03,8704752,8704752,1225,https://e.infogram.com/57e5b447-c2ca-40da-aedb-cbf97df68a8e?parent_url=https%3A%2F%2Fosp.stat.gov.lt%2Fpraejusios-paros-covid-19-statistika&src=embed#async_embed,6568434,2136318,262,963,0.7861224489795918,262,963,6255044,2449708
Lithuania,2022-06-04,8704752,8704752,0,https://e.infogram.com/57e5b447-c2ca-40da-aedb-cbf97df68a8e?parent_url=https%3A%2F%2Fosp.stat.gov.lt%2Fpraejusios-paros-covid-19-statistika&src=embed#async_embed,6568434,2136318,0,0,0.7861224489795918,0,0,6255044,2449708
Lithuania,2022-06-05,8704752,8704752,0,https://e.infogram.com/57e5b447-c2ca-40da-aedb-cbf97df68a8e?parent_url=https%3A%2F%2Fosp.stat.gov.lt%2Fpraejusios-paros-covid-19-statistika&src=embed#async_embed,6568434,2136318,0,0,0.7861224489795918,0,0,6255044,2449708
Lithuania,2022-06-06,8706452,8706452,1700,https://e.infogram.com/57e5b447-c2ca-40da-aedb-cbf97df68a8e?parent_url=https%3A%2F%2Fosp.stat.gov.lt%2Fpraejusios-paros-covid-19-statistika&src=embed#async_embed,6568923,2137529,489,1211,0.7123529411764706,489,1211,6255533,2450919
Lithuania,2022-06-07,8707785,8707785,1333,https://e.infogram.com/57e5b447-c2ca-40da-aedb-cbf97df68a8e?parent_url=https%3A%2F%2Fosp.stat.gov.lt%2Fpraejusios-paros-covid-19-statistika&src=embed#async_embed,6569307,2138478,384,949,0.7119279819954989,384,949,6255917,2451868
Lithuania,2022-06-08,8708866,8708866,1081,https://e.infogram.com/57e5b447-c2ca-40da-aedb-cbf97df68a8e?parent_url=https%3A%2F%2Fosp.stat.gov.lt%2Fpraejusios-paros-covid-19-statistika&src=embed#async_embed,6569553,2139313,246,835,0.7724329324699353,246,835,6256163,2452703
Lithuania,2022-06-09,8708925,8708925,59,https://e.infogram.com/57e5b447-c2ca-40da-aedb-cbf97df68a8e?parent_url=https%3A%2F%2Fosp.stat.gov.lt%2Fpraejusios-paros-covid-19-statistika&src=embed#async_embed,6569593,2139332,40,19,0.3220338983050847,40,19,6256203,2452722
Lithuania,2022-06-10,8710958,8710958,2033,https://e.infogram.com/57e5b447-c2ca-40da-aedb-cbf97df68a8e?parent_url=https%3A%2F%2Fosp.stat.gov.lt%2Fpraejusios-paros-covid-19-statistika&src=embed#async_embed,6570070,2140888,477,1556,0.765371372356124,477,1556,6256680,2454278
Lithuania,2022-06-11,8710958,8710958,0,https://e.infogram.com/57e5b447-c2ca-40da-aedb-cbf97df68a8e?parent_url=https%3A%2F%2Fosp.stat.gov.lt%2Fpraejusios-paros-covid-19-statistika&src=embed#async_embed,6570070,2140888,0,0,0.765371372356124,0,0,6256680,2454278
Lithuania,2022-06-12,8710958,8710958,0,https://e.infogram.com/57e5b447-c2ca-40da-aedb-cbf97df68a8e?parent_url=https%3A%2F%2Fosp.stat.gov.lt%2Fpraejusios-paros-covid-19-statistika&src=embed#async_embed,6570070,2140888,0,0,0.765371372356124,0,0,6256680,2454278
Lithuania,2022-06-13,8712719,8712719,1761,https://e.infogram.com/57e5b447-c2ca-40da-aedb-cbf97df68a8e?parent_url=https%3A%2F%2Fosp.stat.gov.lt%2Fpraejusios-paros-covid-19-statistika&src=embed#async_embed,6570584,2142135,514,1247,0.7081203861442362,514,1247,6257194,2455525
Lithuania,2022-06-14,8714098,8714098,1379,https://e.infogram.com/57e5b447-c2ca-40da-aedb-cbf97df68a8e?parent_url=https%3A%2F%2Fosp.stat.gov.lt%2Fpraejusios-paros-covid-19-statistika&src=embed#async_embed,6571053,2143045,469,910,0.6598984771573604,469,910,6257663,2456435
Lithuania,2022-06-15,8715061,8715061,963,https://e.infogram.com/57e5b447-c2ca-40da-aedb-cbf97df68a8e?parent_url=https%3A%2F%2Fosp.stat.gov.lt%2Fpraejusios-paros-covid-19-statistika&src=embed#async_embed,6571293,2143768,240,723,0.7507788161993769,240,723,6257903,2457158
Lithuania,2022-06-16,8716045,8716045,984,https://e.infogram.com/57e5b447-c2ca-40da-aedb-cbf97df68a8e?parent_url=https%3A%2F%2Fosp.stat.gov.lt%2Fpraejusios-paros-covid-19-statistika&src=embed#async_embed,6571550,2144495,257,727,0.7388211382113821,257,727,6258160,2457885
Lithuania,2022-06-17,8716879,8716879,834,https://e.infogram.com/57e5b447-c2ca-40da-aedb-cbf97df68a8e?parent_url=https%3A%2F%2Fosp.stat.gov.lt%2Fpraejusios-paros-covid-19-statistika&src=embed#async_embed,6571805,2145074,255,579,0.6942446043165468,255,579,6258415,2458464
Lithuania,2022-06-18,8716879,8716879,0,https://e.infogram.com/57e5b447-c2ca-40da-aedb-cbf97df68a8e?parent_url=https%3A%2F%2Fosp.stat.gov.lt%2Fpraejusios-paros-covid-19-statistika&src=embed#async_embed,6571805,2145074,0,0,0.6942446043165468,0,0,6258415,2458464
Lithuania,2022-06-19,8716879,8716879,0,https://e.infogram.com/57e5b447-c2ca-40da-aedb-cbf97df68a8e?parent_url=https%3A%2F%2Fosp.stat.gov.lt%2Fpraejusios-paros-covid-19-statistika&src=embed#async_embed,6571805,2145074,0,0,0.6942446043165468,0,0,6258415,2458464
Lithuania,2022-06-20,8718193,8718193,1314,https://e.infogram.com/57e5b447-c2ca-40da-aedb-cbf97df68a8e?parent_url=https%3A%2F%2Fosp.stat.gov.lt%2Fpraejusios-paros-covid-19-statistika&src=embed#async_embed,6572139,2146054,334,980,0.745814307458143,334,980,6258749,2459444
Lithuania,2022-06-21,8719443,8719443,1250,https://e.infogram.com/57e5b447-c2ca-40da-aedb-cbf97df68a8e?parent_url=https%3A%2F%2Fosp.stat.gov.lt%2Fpraejusios-paros-covid-19-statistika&src=embed#async_embed,6572421,2147022,282,968,0.7744,282,968,6259031,2460412
Lithuania,2022-06-22,8720399,8720399,956,https://e.infogram.com/57e5b447-c2ca-40da-aedb-cbf97df68a8e?parent_url=https%3A%2F%2Fosp.stat.gov.lt%2Fpraejusios-paros-covid-19-statistika&src=embed#async_embed,6572601,2147798,180,776,0.8117154811715481,180,776,6259211,2461188
Lithuania,2022-06-23,8721708,8721708,1309,https://e.infogram.com/57e5b447-c2ca-40da-aedb-cbf97df68a8e?parent_url=https%3A%2F%2Fosp.stat.gov.lt%2Fpraejusios-paros-covid-19-statistika&src=embed#async_embed,6573048,2148660,447,862,0.6585179526355996,447,862,6259658,2462050
Lithuania,2022-06-24,8721708,8721708,0,https://e.infogram.com/57e5b447-c2ca-40da-aedb-cbf97df68a8e?parent_url=https%3A%2F%2Fosp.stat.gov.lt%2Fpraejusios-paros-covid-19-statistika&src=embed#async_embed,6573048,2148660,0,0,0.6585179526355996,0,0,6259658,2462050
Lithuania,2022-06-25,8721708,8721708,0,https://e.infogram.com/57e5b447-c2ca-40da-aedb-cbf97df68a8e?parent_url=https%3A%2F%2Fosp.stat.gov.lt%2Fpraejusios-paros-covid-19-statistika&src=embed#async_embed,6573048,2148660,0,0,0.6585179526355996,0,0,6259658,2462050
Lithuania,2022-06-26,8721708,8721708,0,https://e.infogram.com/57e5b447-c2ca-40da-aedb-cbf97df68a8e?parent_url=https%3A%2F%2Fosp.stat.gov.lt%2Fpraejusios-paros-covid-19-statistika&src=embed#async_embed,6573048,2148660,0,0,0.6585179526355996,0,0,6259658,2462050
Lithuania,2022-06-27,8723440,8723440,1732,https://e.infogram.com/57e5b447-c2ca-40da-aedb-cbf97df68a8e?parent_url=https%3A%2F%2Fosp.stat.gov.lt%2Fpraejusios-paros-covid-19-statistika&src=embed#async_embed,6573614,2149826,566,1166,0.6732101616628176,566,1166,6260224,2463216
Lithuania,2022-06-28,8725049,8725049,1609,https://e.infogram.com/57e5b447-c2ca-40da-aedb-cbf97df68a8e?parent_url=https%3A%2F%2Fosp.stat.gov.lt%2Fpraejusios-paros-covid-19-statistika&src=embed#async_embed,6573944,2151105,330,1279,0.7949036668738346,330,1279,6260554,2464495
Lithuania,2022-06-29,8726273,8726273,1224,https://e.infogram.com/57e5b447-c2ca-40da-aedb-cbf97df68a8e?parent_url=https%3A%2F%2Fosp.stat.gov.lt%2Fpraejusios-paros-covid-19-statistika&src=embed#async_embed,6574140,2152133,196,1028,0.8398692810457516,196,1028,6260750,2465523
Lithuania,2022-06-30,8727490,8727490,1217,https://e.infogram.com/57e5b447-c2ca-40da-aedb-cbf97df68a8e?parent_url=https%3A%2F%2Fosp.stat.gov.lt%2Fpraejusios-paros-covid-19-statistika&src=embed#async_embed,6574477,2153013,337,880,0.7230895645028759,337,880,6261087,2466403
Lithuania,2022-07-01,8728599,8728599,1109,https://e.infogram.com/57e5b447-c2ca-40da-aedb-cbf97df68a8e?parent_url=https%3A%2F%2Fosp.stat.gov.lt%2Fpraejusios-paros-covid-19-statistika&src=embed#async_embed,6574695,2153904,218,891,0.8034265103697025,218,891,6261305,2467294
Lithuania,2022-07-02,8728599,8728599,0,https://e.infogram.com/57e5b447-c2ca-40da-aedb-cbf97df68a8e?parent_url=https%3A%2F%2Fosp.stat.gov.lt%2Fpraejusios-paros-covid-19-statistika&src=embed#async_embed,6574695,2153904,0,0,0.8034265103697025,0,0,6261305,2467294
Lithuania,2022-07-03,8728599,8728599,0,https://e.infogram.com/57e5b447-c2ca-40da-aedb-cbf97df68a8e?parent_url=https%3A%2F%2Fosp.stat.gov.lt%2Fpraejusios-paros-covid-19-statistika&src=embed#async_embed,6574695,2153904,0,0,0.8034265103697025,0,0,6261305,2467294
Lithuania,2022-07-04,8730402,8730402,1803,https://e.infogram.com/57e5b447-c2ca-40da-aedb-cbf97df68a8e?parent_url=https%3A%2F%2Fosp.stat.gov.lt%2Fpraejusios-paros-covid-19-statistika&src=embed#async_embed,6575246,2155156,551,1252,0.6943982251802552,551,1252,6261856,2468546
Lithuania,2022-07-05,8731855,8731855,1453,https://e.infogram.com/57e5b447-c2ca-40da-aedb-cbf97df68a8e?parent_url=https%3A%2F%2Fosp.stat.gov.lt%2Fpraejusios-paros-covid-19-statistika&src=embed#async_embed,6575581,2156274,335,1118,0.7694425326909842,335,1118,6262191,2469664
Lithuania,2022-07-06,8731855,8731855,0,https://e.infogram.com/57e5b447-c2ca-40da-aedb-cbf97df68a8e?parent_url=https%3A%2F%2Fosp.stat.gov.lt%2Fpraejusios-paros-covid-19-statistika&src=embed#async_embed,6575581,2156274,0,0,0.7694425326909842,0,0,6262191,2469664
Lithuania,2022-07-07,8733554,8733554,1699,https://e.infogram.com/57e5b447-c2ca-40da-aedb-cbf97df68a8e?parent_url=https%3A%2F%2Fosp.stat.gov.lt%2Fpraejusios-paros-covid-19-statistika&src=embed#async_embed,6576063,2157491,482,1217,0.7163037080635668,482,1217,6262673,2470881
Lithuania,2022-07-08,8735146,8735146,1592,https://e.infogram.com/57e5b447-c2ca-40da-aedb-cbf97df68a8e?parent_url=https%3A%2F%2Fosp.stat.gov.lt%2Fpraejusios-paros-covid-19-statistika&src=embed#async_embed,6576334,2158812,271,1321,0.8297738693467337,271,1321,6262944,2472202
Lithuania,2022-07-09,8735146,8735146,0,https://e.infogram.com/57e5b447-c2ca-40da-aedb-cbf97df68a8e?parent_url=https%3A%2F%2Fosp.stat.gov.lt%2Fpraejusios-paros-covid-19-statistika&src=embed#async_embed,6576334,2158812,0,0,0.8297738693467337,0,0,6262944,2472202
Lithuania,2022-07-10,8735146,8735146,0,https://e.infogram.com/57e5b447-c2ca-40da-aedb-cbf97df68a8e?parent_url=https%3A%2F%2Fosp.stat.gov.lt%2Fpraejusios-paros-covid-19-statistika&src=embed#async_embed,6576334,2158812,0,0,0.8297738693467337,0,0,6262944,2472202
Lithuania,2022-07-11,8737038,8737038,1892,https://e.infogram.com/57e5b447-c2ca-40da-aedb-cbf97df68a8e?parent_url=https%3A%2F%2Fosp.stat.gov.lt%2Fpraejusios-paros-covid-19-statistika&src=embed#async_embed,6576794,2160244,460,1432,0.7568710359408034,460,1432,6263404,2473634
Lithuania,2022-07-12,8738954,8738954,1916,https://e.infogram.com/57e5b447-c2ca-40da-aedb-cbf97df68a8e?parent_url=https%3A%2F%2Fosp.stat.gov.lt%2Fpraejusios-paros-covid-19-statistika&src=embed#async_embed,6577144,2161810,350,1566,0.8173277661795407,350,1566,6263754,2475200
Lithuania,2022-07-13,8740662,8740662,1708,https://e.infogram.com/57e5b447-c2ca-40da-aedb-cbf97df68a8e?parent_url=https%3A%2F%2Fosp.stat.gov.lt%2Fpraejusios-paros-covid-19-statistika&src=embed#async_embed,6577428,2163234,284,1424,0.8337236533957846,284,1424,6264038,2476624
Lithuania,2022-07-14,8742371,8742371,1709,https://e.infogram.com/57e5b447-c2ca-40da-aedb-cbf97df68a8e?parent_url=https%3A%2F%2Fosp.stat.gov.lt%2Fpraejusios-paros-covid-19-statistika&src=embed#async_embed,6577699,2164672,271,1438,0.8414277355178467,271,1438,6264309,2478062
Lithuania,2022-07-15,8744258,8744258,1887,https://e.infogram.com/57e5b447-c2ca-40da-aedb-cbf97df68a8e?parent_url=https%3A%2F%2Fosp.stat.gov.lt%2Fpraejusios-paros-covid-19-statistika&src=embed#async_embed,6577998,2166260,299,1588,0.8415474297827239,299,1588,6264608,2479650
Lithuania,2022-07-16,8744258,8744258,0,https://e.infogram.com/57e5b447-c2ca-40da-aedb-cbf97df68a8e?parent_url=https%3A%2F%2Fosp.stat.gov.lt%2Fpraejusios-paros-covid-19-statistika&src=embed#async_embed,6577998,2166260,0,0,0.8415474297827239,0,0,6264608,2479650
Lithuania,2022-07-17,8744258,8744258,0,https://e.infogram.com/57e5b447-c2ca-40da-aedb-cbf97df68a8e?parent_url=https%3A%2F%2Fosp.stat.gov.lt%2Fpraejusios-paros-covid-19-statistika&src=embed#async_embed,6577998,2166260,0,0,0.8415474297827239,0,0,6264608,2479650
Lithuania,2022-07-18,8746583,8746583,2325,https://e.infogram.com/57e5b447-c2ca-40da-aedb-cbf97df68a8e?parent_url=https%3A%2F%2Fosp.stat.gov.lt%2Fpraejusios-paros-covid-19-statistika&src=embed#async_embed,6578520,2168063,522,1803,0.775483870967742,522,1803,6265130,2481453
Lithuania,2022-07-19,8748975,8748975,2392,https://e.infogram.com/57e5b447-c2ca-40da-aedb-cbf97df68a8e?parent_url=https%3A%2F%2Fosp.stat.gov.lt%2Fpraejusios-paros-covid-19-statistika&src=embed#async_embed,6578880,2170095,360,2032,0.8494983277591973,360,2032,6265490,2483485
Lithuania,2022-07-20,8751200,8751200,2225,https://e.infogram.com/57e5b447-c2ca-40da-aedb-cbf97df68a8e?parent_url=https%3A%2F%2Fosp.stat.gov.lt%2Fpraejusios-paros-covid-19-statistika&src=embed#async_embed,6579207,2171993,327,1898,0.8530337078651685,327,1898,6265817,2485383
Lithuania,2022-07-21,8753255,8753255,2055,https://e.infogram.com/57e5b447-c2ca-40da-aedb-cbf97df68a8e?parent_url=https%3A%2F%2Fosp.stat.gov.lt%2Fpraejusios-paros-covid-19-statistika&src=embed#async_embed,6579483,2173772,276,1779,0.8656934306569343,276,1779,6266093,2487162
Lithuania,2022-07-22,8755450,8755450,2195,https://e.infogram.com/57e5b447-c2ca-40da-aedb-cbf97df68a8e?parent_url=https%3A%2F%2Fosp.stat.gov.lt%2Fpraejusios-paros-covid-19-statistika&src=embed#async_embed,6579807,2175643,324,1871,0.8523917995444191,324,1871,6266417,2489033
Lithuania,2022-07-23,8755450,8755450,0,https://e.infogram.com/57e5b447-c2ca-40da-aedb-cbf97df68a8e?parent_url=https%3A%2F%2Fosp.stat.gov.lt%2Fpraejusios-paros-covid-19-statistika&src=embed#async_embed,6579807,2175643,0,0,0.8523917995444191,0,0,6266417,2489033
Lithuania,2022-07-24,8755450,8755450,0,https://e.infogram.com/57e5b447-c2ca-40da-aedb-cbf97df68a8e?parent_url=https%3A%2F%2Fosp.stat.gov.lt%2Fpraejusios-paros-covid-19-statistika&src=embed#async_embed,6579807,2175643,0,0,0.8523917995444191,0,0,6266417,2489033
Lithuania,2022-07-25,8758362,8758362,2912,https://e.infogram.com/57e5b447-c2ca-40da-aedb-cbf97df68a8e?parent_url=https%3A%2F%2Fosp.stat.gov.lt%2Fpraejusios-paros-covid-19-statistika&src=embed#async_embed,6580440,2177922,633,2279,0.7826236263736264,633,2279,6267050,2491312
Lithuania,2022-07-26,8761418,8761418,3056,https://e.infogram.com/57e5b447-c2ca-40da-aedb-cbf97df68a8e?parent_url=https%3A%2F%2Fosp.stat.gov.lt%2Fpraejusios-paros-covid-19-statistika&src=embed#async_embed,6580893,2180525,453,2603,0.8517670157068062,453,2603,6267503,2493915
Lithuania,2022-07-27,8764083,8764083,2665,https://e.infogram.com/57e5b447-c2ca-40da-aedb-cbf97df68a8e?parent_url=https%3A%2F%2Fosp.stat.gov.lt%2Fpraejusios-paros-covid-19-statistika&src=embed#async_embed,6581262,2182821,369,2296,0.8615384615384616,369,2296,6267872,2496211
Lithuania,2022-07-28,8766395,8766395,2312,https://e.infogram.com/57e5b447-c2ca-40da-aedb-cbf97df68a8e?parent_url=https%3A%2F%2Fosp.stat.gov.lt%2Fpraejusios-paros-covid-19-statistika&src=embed#async_embed,6581563,2184832,301,2011,0.8698096885813149,301,2011,6268173,2498222
Lithuania,2022-07-29,8768866,8768866,2471,https://e.infogram.com/57e5b447-c2ca-40da-aedb-cbf97df68a8e?parent_url=https%3A%2F%2Fosp.stat.gov.lt%2Fpraejusios-paros-covid-19-statistika&src=embed#async_embed,6581927,2186939,364,2107,0.8526912181303116,364,2107,6268537,2500329
Lithuania,2022-07-30,8768866,8768866,0,https://e.infogram.com/57e5b447-c2ca-40da-aedb-cbf97df68a8e?parent_url=https%3A%2F%2Fosp.stat.gov.lt%2Fpraejusios-paros-covid-19-statistika&src=embed#async_embed,6581927,2186939,0,0,0.8526912181303116,0,0,6268537,2500329
Lithuania,2022-07-31,8768866,8768866,0,https://e.infogram.com/57e5b447-c2ca-40da-aedb-cbf97df68a8e?parent_url=https%3A%2F%2Fosp.stat.gov.lt%2Fpraejusios-paros-covid-19-statistika&src=embed#async_embed,6581927,2186939,0,0,0.8526912181303116,0,0,6268537,2500329
Lithuania,2022-08-01,8771971,8771971,3105,https://e.infogram.com/57e5b447-c2ca-40da-aedb-cbf97df68a8e?parent_url=https%3A%2F%2Fosp.stat.gov.lt%2Fpraejusios-paros-covid-19-statistika&src=embed#async_embed,6582611,2189360,684,2421,0.7797101449275362,684,2421,6269221,2502750
Lithuania,2022-08-02,8775408,8775408,3437,https://e.infogram.com/57e5b447-c2ca-40da-aedb-cbf97df68a8e?parent_url=https%3A%2F%2Fosp.stat.gov.lt%2Fpraejusios-paros-covid-19-statistika&src=embed#async_embed,6583064,2192344,453,2984,0.8681990107652022,453,2984,6269674,2505734
Lithuania,2022-08-03,8775408,8775408,0,https://e.infogram.com/57e5b447-c2ca-40da-aedb-cbf97df68a8e?parent_url=https%3A%2F%2Fosp.stat.gov.lt%2Fpraejusios-paros-covid-19-statistika&src=embed#async_embed,6583064,2192344,0,0,0.8681990107652022,0,0,6269674,2505734
Lithuania,2022-08-04,8775408,8775408,0,https://e.infogram.com/57e5b447-c2ca-40da-aedb-cbf97df68a8e?parent_url=https%3A%2F%2Fosp.stat.gov.lt%2Fpraejusios-paros-covid-19-statistika&src=embed#async_embed,6583708,2197128,644,4784,0.8813559322033898,0,0,6269674,2505734
Lithuania,2022-08-05,8783374,8783374,7966,https://e.infogram.com/57e5b447-c2ca-40da-aedb-cbf97df68a8e?parent_url=https%3A%2F%2Fosp.stat.gov.lt%2Fpraejusios-paros-covid-19-statistika&src=embed#async_embed,6584003,2199371,295,2243,0.8837667454688731,926,7040,6270600,2512774
Lithuania,2022-08-06,8783374,8783374,0,https://e.infogram.com/57e5b447-c2ca-40da-aedb-cbf97df68a8e?parent_url=https%3A%2F%2Fosp.stat.gov.lt%2Fpraejusios-paros-covid-19-statistika&src=embed#async_embed,6584003,2199371,0,0,0.8837667454688731,0,0,6270600,2512774
Lithuania,2022-08-07,8783374,8783374,0,https://e.infogram.com/57e5b447-c2ca-40da-aedb-cbf97df68a8e?parent_url=https%3A%2F%2Fosp.stat.gov.lt%2Fpraejusios-paros-covid-19-statistika&src=embed#async_embed,6584003,2199371,0,0,0.8837667454688731,0,0,6270600,2512774
Lithuania,2022-08-08,8786720,8786720,3346,https://e.infogram.com/57e5b447-c2ca-40da-aedb-cbf97df68a8e?parent_url=https%3A%2F%2Fosp.stat.gov.lt%2Fpraejusios-paros-covid-19-statistika&src=embed#async_embed,6584654,2202066,651,2695,0.805439330543933,651,2695,6271251,2515469
Lithuania,2022-08-09,8790196,8790196,3476,https://e.infogram.com/57e5b447-c2ca-40da-aedb-cbf97df68a8e?parent_url=https%3A%2F%2Fosp.stat.gov.lt%2Fpraejusios-paros-covid-19-statistika&src=embed#async_embed,6585102,2205094,448,3028,0.8711162255466053,448,3028,6271699,2518497
Lithuania,2022-08-10,8792971,8792971,2775,https://e.infogram.com/57e5b447-c2ca-40da-aedb-cbf97df68a8e?parent_url=https%3A%2F%2Fosp.stat.gov.lt%2Fpraejusios-paros-covid-19-statistika&src=embed#async_embed,6585364,2207607,262,2513,0.9055855855855856,262,2513,6271961,2521010
Lithuania,2022-08-11,8797970,8797970,4999,https://e.infogram.com/57e5b447-c2ca-40da-aedb-cbf97df68a8e?parent_url=https%3A%2F%2Fosp.stat.gov.lt%2Fpraejusios-paros-covid-19-statistika&src=embed#async_embed,6585364,2207607,0,0,0.9055855855855856,472,4527,6272433,2525537
Lithuania,2022-08-12,8797970,8797970,0,https://e.infogram.com/57e5b447-c2ca-40da-aedb-cbf97df68a8e?parent_url=https%3A%2F%2Fosp.stat.gov.lt%2Fpraejusios-paros-covid-19-statistika&src=embed#async_embed,6585906,2212064,542,4457,0.8915783156631326,0,0,6272433,2525537
Lithuania,2022-08-13,8797970,8797970,0,https://e.infogram.com/57e5b447-c2ca-40da-aedb-cbf97df68a8e?parent_url=https%3A%2F%2Fosp.stat.gov.lt%2Fpraejusios-paros-covid-19-statistika&src=embed#async_embed,6585906,2212064,0,0,0.8915783156631326,0,0,6272433,2525537
Lithuania,2022-08-14,8797970,8797970,0,https://e.infogram.com/57e5b447-c2ca-40da-aedb-cbf97df68a8e?parent_url=https%3A%2F%2Fosp.stat.gov.lt%2Fpraejusios-paros-covid-19-statistika&src=embed#async_embed,6585906,2212064,0,0,0.8915783156631326,0,0,6272433,2525537
Lithuania,2022-08-15,8797970,8797970,0,https://e.infogram.com/57e5b447-c2ca-40da-aedb-cbf97df68a8e?parent_url=https%3A%2F%2Fosp.stat.gov.lt%2Fpraejusios-paros-covid-19-statistika&src=embed#async_embed,6585906,2212064,0,0,0.8915783156631326,0,0,6272433,2525537
Lithuania,2022-08-16,8797970,8797970,0,https://e.infogram.com/57e5b447-c2ca-40da-aedb-cbf97df68a8e?parent_url=https%3A%2F%2Fosp.stat.gov.lt%2Fpraejusios-paros-covid-19-statistika&src=embed#async_embed,6585906,2212064,0,0,0.8915783156631326,0,0,6272433,2525537
Lithuania,2022-08-17,8804833,8804833,6863,https://e.infogram.com/57e5b447-c2ca-40da-aedb-cbf97df68a8e?parent_url=https%3A%2F%2Fosp.stat.gov.lt%2Fpraejusios-paros-covid-19-statistika&src=embed#async_embed,6587022,2217811,1116,5747,0.8373888969838263,1116,5747,6273549,2531284
Lithuania,2022-08-18,8807434,8807434,2601,https://e.infogram.com/57e5b447-c2ca-40da-aedb-cbf97df68a8e?parent_url=https%3A%2F%2Fosp.stat.gov.lt%2Fpraejusios-paros-covid-19-statistika&src=embed#async_embed,6587379,2220055,357,2244,0.8627450980392157,357,2244,6273906,2533528
Lithuania,2022-08-19,8809736,8809736,2302,https://e.infogram.com/57e5b447-c2ca-40da-aedb-cbf97df68a8e?parent_url=https%3A%2F%2Fosp.stat.gov.lt%2Fpraejusios-paros-covid-19-statistika&src=embed#async_embed,6587708,2222028,329,1973,0.8570807993049522,329,1973,6274235,2535501
Lithuania,2022-08-20,8809736,8809736,0,https://e.infogram.com/57e5b447-c2ca-40da-aedb-cbf97df68a8e?parent_url=https%3A%2F%2Fosp.stat.gov.lt%2Fpraejusios-paros-covid-19-statistika&src=embed#async_embed,6587708,2222028,0,0,0.8570807993049522,0,0,6274235,2535501
Lithuania,2022-08-21,8809736,8809736,0,https://e.infogram.com/57e5b447-c2ca-40da-aedb-cbf97df68a8e?parent_url=https%3A%2F%2Fosp.stat.gov.lt%2Fpraejusios-paros-covid-19-statistika&src=embed#async_embed,6587708,2222028,0,0,0.8570807993049522,0,0,6274235,2535501
Lithuania,2022-08-22,8812333,8812333,2597,https://e.infogram.com/57e5b447-c2ca-40da-aedb-cbf97df68a8e?parent_url=https%3A%2F%2Fosp.stat.gov.lt%2Fpraejusios-paros-covid-19-statistika&src=embed#async_embed,6588183,2224150,475,2122,0.817096649980747,475,2122,6274710,2537623
Lithuania,2022-08-23,8815196,8815196,2863,https://e.infogram.com/57e5b447-c2ca-40da-aedb-cbf97df68a8e?parent_url=https%3A%2F%2Fosp.stat.gov.lt%2Fpraejusios-paros-covid-19-statistika&src=embed#async_embed,6588550,2226646,367,2496,0.8718127837932239,367,2496,6275077,2540119
Lithuania,2022-08-24,8817178,8817178,1982,https://e.infogram.com/57e5b447-c2ca-40da-aedb-cbf97df68a8e?parent_url=https%3A%2F%2Fosp.stat.gov.lt%2Fpraejusios-paros-covid-19-statistika&src=embed#async_embed,6588781,2228397,231,1751,0.8834510595358224,231,1751,6275308,2541870
Lithuania,2022-08-25,8819110,8819110,1932,https://e.infogram.com/57e5b447-c2ca-40da-aedb-cbf97df68a8e?parent_url=https%3A%2F%2Fosp.stat.gov.lt%2Fpraejusios-paros-covid-19-statistika&src=embed#async_embed,6589005,2230105,224,1708,0.8840579710144928,224,1708,6275532,2543578
Lithuania,2022-08-26,8820675,8820675,1565,https://e.infogram.com/57e5b447-c2ca-40da-aedb-cbf97df68a8e?parent_url=https%3A%2F%2Fosp.stat.gov.lt%2Fpraejusios-paros-covid-19-statistika&src=embed#async_embed,6589235,2231440,230,1335,0.853035143769968,230,1335,6275762,2544913
Lithuania,2022-08-27,8820675,8820675,0,https://e.infogram.com/57e5b447-c2ca-40da-aedb-cbf97df68a8e?parent_url=https%3A%2F%2Fosp.stat.gov.lt%2Fpraejusios-paros-covid-19-statistika&src=embed#async_embed,6589235,2231440,0,0,0.853035143769968,0,0,6275762,2544913
Lithuania,2022-08-28,8820675,8820675,0,https://e.infogram.com/57e5b447-c2ca-40da-aedb-cbf97df68a8e?parent_url=https%3A%2F%2Fosp.stat.gov.lt%2Fpraejusios-paros-covid-19-statistika&src=embed#async_embed,6589235,2231440,0,0,0.853035143769968,0,0,6275762,2544913
Lithuania,2022-08-29,8822866,8822866,2191,https://e.infogram.com/57e5b447-c2ca-40da-aedb-cbf97df68a8e?parent_url=https%3A%2F%2Fosp.stat.gov.lt%2Fpraejusios-paros-covid-19-statistika&src=embed#async_embed,6589648,2233218,413,1778,0.8115015974440895,413,1778,6276175,2546691
Lithuania,2022-08-30,8825304,8825304,2438,https://e.infogram.com/57e5b447-c2ca-40da-aedb-cbf97df68a8e?parent_url=https%3A%2F%2Fosp.stat.gov.lt%2Fpraejusios-paros-covid-19-statistika&src=embed#async_embed,6590011,2235293,363,2075,0.8511074651353568,363,2075,6276538,2548766
Lithuania,2022-08-31,8827185,8827185,1881,https://e.infogram.com/57e5b447-c2ca-40da-aedb-cbf97df68a8e?parent_url=https%3A%2F%2Fosp.stat.gov.lt%2Fpraejusios-paros-covid-19-statistika&src=embed#async_embed,6590257,2236928,246,1635,0.8692185007974481,246,1635,6276784,2550401
Lithuania,2022-09-01,8828798,8828798,1613,https://e.infogram.com/57e5b447-c2ca-40da-aedb-cbf97df68a8e?parent_url=https%3A%2F%2Fosp.stat.gov.lt%2Fpraejusios-paros-covid-19-statistika&src=embed#async_embed,6590499,2238299,242,1371,0.8499690018598884,242,1371,6277026,2551772
Lithuania,2022-09-02,8830134,8830134,1336,https://e.infogram.com/57e5b447-c2ca-40da-aedb-cbf97df68a8e?parent_url=https%3A%2F%2Fosp.stat.gov.lt%2Fpraejusios-paros-covid-19-statistika&src=embed#async_embed,6590655,2239479,156,1180,0.8832335329341318,156,1180,6277182,2552952
Lithuania,2022-09-03,8830134,8830134,0,https://e.infogram.com/57e5b447-c2ca-40da-aedb-cbf97df68a8e?parent_url=https%3A%2F%2Fosp.stat.gov.lt%2Fpraejusios-paros-covid-19-statistika&src=embed#async_embed,6590655,2239479,0,0,0.8832335329341318,0,0,6277182,2552952
Lithuania,2022-09-04,8830134,8830134,0,https://e.infogram.com/57e5b447-c2ca-40da-aedb-cbf97df68a8e?parent_url=https%3A%2F%2Fosp.stat.gov.lt%2Fpraejusios-paros-covid-19-statistika&src=embed#async_embed,6590655,2239479,0,0,0.8832335329341318,0,0,6277182,2552952
Lithuania,2022-09-05,8832037,8832037,1903,https://e.infogram.com/57e5b447-c2ca-40da-aedb-cbf97df68a8e?parent_url=https%3A%2F%2Fosp.stat.gov.lt%2Fpraejusios-paros-covid-19-statistika&src=embed#async_embed,6591050,2240987,395,1508,0.792433000525486,395,1508,6277577,2554460
Lithuania,2022-09-06,8834670,8834670,2633,https://e.infogram.com/57e5b447-c2ca-40da-aedb-cbf97df68a8e?parent_url=https%3A%2F%2Fosp.stat.gov.lt%2Fpraejusios-paros-covid-19-statistika&src=embed#async_embed,6591386,2243284,336,2297,0.8723889099886062,336,2297,6277913,2556757
Lithuania,2022-09-07,8836774,8836774,2104,https://e.infogram.com/57e5b447-c2ca-40da-aedb-cbf97df68a8e?parent_url=https%3A%2F%2Fosp.stat.gov.lt%2Fpraejusios-paros-covid-19-statistika&src=embed#async_embed,6591610,2245164,224,1880,0.8935361216730038,224,1880,6278137,2558637
Lithuania,2022-09-08,8838573,8838573,1799,https://e.infogram.com/57e5b447-c2ca-40da-aedb-cbf97df68a8e?parent_url=https%3A%2F%2Fosp.stat.gov.lt%2Fpraejusios-paros-covid-19-statistika&src=embed#async_embed,6591813,2246760,203,1596,0.8871595330739299,203,1596,6278340,2560233
Lithuania,2022-09-09,8840321,8840321,1748,https://e.infogram.com/57e5b447-c2ca-40da-aedb-cbf97df68a8e?parent_url=https%3A%2F%2Fosp.stat.gov.lt%2Fpraejusios-paros-covid-19-statistika&src=embed#async_embed,6592008,2248313,195,1553,0.8884439359267735,195,1553,6278535,2561786
Lithuania,2022-09-10,8840321,8840321,0,https://e.infogram.com/57e5b447-c2ca-40da-aedb-cbf97df68a8e?parent_url=https%3A%2F%2Fosp.stat.gov.lt%2Fpraejusios-paros-covid-19-statistika&src=embed#async_embed,6592008,2248313,0,0,0.8884439359267735,0,0,6278535,2561786
Lithuania,2022-09-11,8840321,8840321,0,https://e.infogram.com/57e5b447-c2ca-40da-aedb-cbf97df68a8e?parent_url=https%3A%2F%2Fosp.stat.gov.lt%2Fpraejusios-paros-covid-19-statistika&src=embed#async_embed,6592008,2248313,0,0,0.8884439359267735,0,0,6278535,2561786
Lithuania,2022-09-12,8842629,8842629,2308,https://e.infogram.com/57e5b447-c2ca-40da-aedb-cbf97df68a8e?parent_url=https%3A%2F%2Fosp.stat.gov.lt%2Fpraejusios-paros-covid-19-statistika&src=embed#async_embed,6592408,2250221,400,1908,0.8266897746967071,400,1908,6278935,2563694
Lithuania,2022-09-13,8845886,8845886,3257,https://e.infogram.com/57e5b447-c2ca-40da-aedb-cbf97df68a8e?parent_url=https%3A%2F%2Fosp.stat.gov.lt%2Fpraejusios-paros-covid-19-statistika&src=embed#async_embed,6592690,2253196,282,2975,0.9134172551427694,282,2975,6279217,2566669
Lithuania,2022-09-14,8848677,8848677,2791,https://e.infogram.com/57e5b447-c2ca-40da-aedb-cbf97df68a8e?parent_url=https%3A%2F%2Fosp.stat.gov.lt%2Fpraejusios-paros-covid-19-statistika&src=embed#async_embed,6592954,2255723,264,2527,0.9054102472232175,264,2527,6279481,2569196
Lithuania,2022-09-15,8851405,8851405,2728,https://e.infogram.com/57e5b447-c2ca-40da-aedb-cbf97df68a8e?parent_url=https%3A%2F%2Fosp.stat.gov.lt%2Fpraejusios-paros-covid-19-statistika&src=embed#async_embed,6593267,2258138,313,2415,0.8852639296187683,313,2415,6279794,2571611
Lithuania,2022-09-16,8853950,8853950,2545,https://e.infogram.com/57e5b447-c2ca-40da-aedb-cbf97df68a8e?parent_url=https%3A%2F%2Fosp.stat.gov.lt%2Fpraejusios-paros-covid-19-statistika&src=embed#async_embed,6593562,2260388,295,2250,0.8840864440078585,295,2250,6280089,2573861
Lithuania,2022-09-17,8853950,8853950,0,https://e.infogram.com/57e5b447-c2ca-40da-aedb-cbf97df68a8e?parent_url=https%3A%2F%2Fosp.stat.gov.lt%2Fpraejusios-paros-covid-19-statistika&src=embed#async_embed,6593562,2260388,0,0,0.8840864440078585,0,0,6280089,2573861
Lithuania,2022-09-18,8853950,8853950,0,https://e.infogram.com/57e5b447-c2ca-40da-aedb-cbf97df68a8e?parent_url=https%3A%2F%2Fosp.stat.gov.lt%2Fpraejusios-paros-covid-19-statistika&src=embed#async_embed,6593562,2260388,0,0,0.8840864440078585,0,0,6280089,2573861
Lithuania,2022-09-19,8856984,8856984,3034,https://e.infogram.com/57e5b447-c2ca-40da-aedb-cbf97df68a8e?parent_url=https%3A%2F%2Fosp.stat.gov.lt%2Fpraejusios-paros-covid-19-statistika&src=embed#async_embed,6593991,2262993,429,2605,0.8586025049439684,429,2605,6280518,2576466
Lithuania,2022-09-20,8860691,8860691,3707,https://e.infogram.com/57e5b447-c2ca-40da-aedb-cbf97df68a8e?parent_url=https%3A%2F%2Fosp.stat.gov.lt%2Fpraejusios-paros-covid-19-statistika&src=embed#async_embed,6594390,2266301,399,3308,0.8923657944429457,399,3308,6280917,2579774
Lithuania,2022-09-21,8863984,8863984,3293,https://e.infogram.com/57e5b447-c2ca-40da-aedb-cbf97df68a8e?parent_url=https%3A%2F%2Fosp.stat.gov.lt%2Fpraejusios-paros-covid-19-statistika&src=embed#async_embed,6594645,2269339,255,3038,0.9225630124506529,255,3038,6281172,2582812
Lithuania,2022-09-22,8866722,8866722,2738,https://e.infogram.com/57e5b447-c2ca-40da-aedb-cbf97df68a8e?parent_url=https%3A%2F%2Fosp.stat.gov.lt%2Fpraejusios-paros-covid-19-statistika&src=embed#async_embed,6594936,2271786,291,2447,0.8937180423666911,291,2447,6281463,2585259
Lithuania,2022-09-23,8869191,8869191,2469,https://e.infogram.com/57e5b447-c2ca-40da-aedb-cbf97df68a8e?parent_url=https%3A%2F%2Fosp.stat.gov.lt%2Fpraejusios-paros-covid-19-statistika&src=embed#async_embed,6595225,2273966,289,2180,0.8829485621709194,289,2180,6281752,2587439
Lithuania,2022-09-24,8869191,8869191,0,https://e.infogram.com/57e5b447-c2ca-40da-aedb-cbf97df68a8e?parent_url=https%3A%2F%2Fosp.stat.gov.lt%2Fpraejusios-paros-covid-19-statistika&src=embed#async_embed,6595225,2273966,0,0,0.8829485621709194,0,0,6281752,2587439
Lithuania,2022-09-25,8869191,8869191,0,https://e.infogram.com/57e5b447-c2ca-40da-aedb-cbf97df68a8e?parent_url=https%3A%2F%2Fosp.stat.gov.lt%2Fpraejusios-paros-covid-19-statistika&src=embed#async_embed,6595225,2273966,0,0,0.8829485621709194,0,0,6281752,2587439
Lithuania,2022-09-26,8869191,8869191,0,https://e.infogram.com/57e5b447-c2ca-40da-aedb-cbf97df68a8e?parent_url=https%3A%2F%2Fosp.stat.gov.lt%2Fpraejusios-paros-covid-19-statistika&src=embed#async_embed,6595225,2273966,0,0,0.8829485621709194,0,0,6281752,2587439
Lithuania,2022-09-27,8875636,8875636,6445,https://e.infogram.com/57e5b447-c2ca-40da-aedb-cbf97df68a8e?parent_url=https%3A%2F%2Fosp.stat.gov.lt%2Fpraejusios-paros-covid-19-statistika&src=embed#async_embed,6596152,2279484,927,5518,0.8561675717610551,927,5518,6282679,2592957
Lithuania,2022-09-28,8878297,8878297,2661,https://e.infogram.com/57e5b447-c2ca-40da-aedb-cbf97df68a8e?parent_url=https%3A%2F%2Fosp.stat.gov.lt%2Fpraejusios-paros-covid-19-statistika&src=embed#async_embed,6596307,2281990,155,2506,0.9417512213453589,155,2506,6282834,2595463
Lithuania,2022-09-29,8881100,8881100,2803,https://e.infogram.com/57e5b447-c2ca-40da-aedb-cbf97df68a8e?parent_url=https%3A%2F%2Fosp.stat.gov.lt%2Fpraejusios-paros-covid-19-statistika&src=embed#async_embed,6596630,2284470,323,2480,0.8847663217980735,323,2480,6283157,2597943
Lithuania,2022-09-30,8883184,8883184,2084,https://e.infogram.com/57e5b447-c2ca-40da-aedb-cbf97df68a8e?parent_url=https%3A%2F%2Fosp.stat.gov.lt%2Fpraejusios-paros-covid-19-statistika&src=embed#async_embed,6596847,2286337,217,1867,0.8958733205374281,217,1867,6283374,2599810
Lithuania,2022-10-01,8883184,8883184,0,https://e.infogram.com/57e5b447-c2ca-40da-aedb-cbf97df68a8e?parent_url=https%3A%2F%2Fosp.stat.gov.lt%2Fpraejusios-paros-covid-19-statistika&src=embed#async_embed,6596847,2286337,0,0,0.8958733205374281,0,0,6283374,2599810
Lithuania,2022-10-02,8883184,8883184,0,https://e.infogram.com/57e5b447-c2ca-40da-aedb-cbf97df68a8e?parent_url=https%3A%2F%2Fosp.stat.gov.lt%2Fpraejusios-paros-covid-19-statistika&src=embed#async_embed,6596847,2286337,0,0,0.8958733205374281,0,0,6283374,2599810
Lithuania,2022-10-03,8885742,8885742,2558,https://e.infogram.com/57e5b447-c2ca-40da-aedb-cbf97df68a8e?parent_url=https%3A%2F%2Fosp.stat.gov.lt%2Fpraejusios-paros-covid-19-statistika&src=embed#async_embed,6597292,2288450,445,2113,0.8260359655981235,445,2113,6283819,2601923
Lithuania,2022-10-04,8888744,8888744,3002,https://e.infogram.com/57e5b447-c2ca-40da-aedb-cbf97df68a8e?parent_url=https%3A%2F%2Fosp.stat.gov.lt%2Fpraejusios-paros-covid-19-statistika&src=embed#async_embed,6597645,2291099,353,2649,0.8824117255163224,353,2649,6284172,2604572
Lithuania,2022-10-05,8891049,8891049,2305,https://e.infogram.com/57e5b447-c2ca-40da-aedb-cbf97df68a8e?parent_url=https%3A%2F%2Fosp.stat.gov.lt%2Fpraejusios-paros-covid-19-statistika&src=embed#async_embed,6597913,2293136,268,2037,0.8837310195227766,268,2037,6284440,2606609
Lithuania,2022-10-06,8893152,8893152,2103,https://e.infogram.com/57e5b447-c2ca-40da-aedb-cbf97df68a8e?parent_url=https%3A%2F%2Fosp.stat.gov.lt%2Fpraejusios-paros-covid-19-statistika&src=embed#async_embed,6598126,2295026,213,1890,0.8987161198288159,213,1890,6284653,2608499
Lithuania,2022-10-07,8895006,8895006,1854,https://e.infogram.com/57e5b447-c2ca-40da-aedb-cbf97df68a8e?parent_url=https%3A%2F%2Fosp.stat.gov.lt%2Fpraejusios-paros-covid-19-statistika&src=embed#async_embed,6598392,2296614,266,1588,0.8565264293419633,266,1588,6284919,2610087
Lithuania,2022-10-08,8895006,8895006,0,https://e.infogram.com/57e5b447-c2ca-40da-aedb-cbf97df68a8e?parent_url=https%3A%2F%2Fosp.stat.gov.lt%2Fpraejusios-paros-covid-19-statistika&src=embed#async_embed,6598392,2296614,0,0,0.8565264293419633,0,0,6284919,2610087
Lithuania,2022-10-09,8895006,8895006,0,https://e.infogram.com/57e5b447-c2ca-40da-aedb-cbf97df68a8e?parent_url=https%3A%2F%2Fosp.stat.gov.lt%2Fpraejusios-paros-covid-19-statistika&src=embed#async_embed,6598392,2296614,0,0,0.8565264293419633,0,0,6284919,2610087
Lithuania,2022-10-10,8897336,8897336,2330,https://e.infogram.com/57e5b447-c2ca-40da-aedb-cbf97df68a8e?parent_url=https%3A%2F%2Fosp.stat.gov.lt%2Fpraejusios-paros-covid-19-statistika&src=embed#async_embed,6598874,2298462,482,1848,0.7931330472103004,482,1848,6285401,2611935
Lithuania,2022-10-11,8900190,8900190,2854,https://e.infogram.com/57e5b447-c2ca-40da-aedb-cbf97df68a8e?parent_url=https%3A%2F%2Fosp.stat.gov.lt%2Fpraejusios-paros-covid-19-statistika&src=embed#async_embed,6599202,2300988,328,2526,0.885073580939033,328,2526,6285729,2614461
Lithuania,2022-10-12,8902393,8902393,2203,https://e.infogram.com/57e5b447-c2ca-40da-aedb-cbf97df68a8e?parent_url=https%3A%2F%2Fosp.stat.gov.lt%2Fpraejusios-paros-covid-19-statistika&src=embed#async_embed,6599463,2302930,261,1942,0.8815251929187472,261,1942,6285990,2616403
Lithuania,2022-10-13,8904270,8904270,1877,https://e.infogram.com/57e5b447-c2ca-40da-aedb-cbf97df68a8e?parent_url=https%3A%2F%2Fosp.stat.gov.lt%2Fpraejusios-paros-covid-19-statistika&src=embed#async_embed,6599700,2304570,237,1640,0.8737346830047948,237,1640,6286227,2618043
Lithuania,2022-10-14,8906081,8906081,1811,https://e.infogram.com/57e5b447-c2ca-40da-aedb-cbf97df68a8e?parent_url=https%3A%2F%2Fosp.stat.gov.lt%2Fpraejusios-paros-covid-19-statistika&src=embed#async_embed,6599938,2306143,238,1573,0.8685808945334069,238,1573,6286465,2619616
Lithuania,2022-10-15,8906081,8906081,0,https://e.infogram.com/57e5b447-c2ca-40da-aedb-cbf97df68a8e?parent_url=https%3A%2F%2Fosp.stat.gov.lt%2Fpraejusios-paros-covid-19-statistika&src=embed#async_embed,6599938,2306143,0,0,0.8685808945334069,0,0,6286465,2619616
Lithuania,2022-10-16,8906081,8906081,0,https://e.infogram.com/57e5b447-c2ca-40da-aedb-cbf97df68a8e?parent_url=https%3A%2F%2Fosp.stat.gov.lt%2Fpraejusios-paros-covid-19-statistika&src=embed#async_embed,6599938,2306143,0,0,0.8685808945334069,0,0,6286465,2619616
Lithuania,2022-10-17,8910841,8910841,4760,https://e.infogram.com/57e5b447-c2ca-40da-aedb-cbf97df68a8e?parent_url=https%3A%2F%2Fosp.stat.gov.lt%2Fpraejusios-paros-covid-19-statistika&src=embed#async_embed,6600359,2307970,421,1827,0.8127224199288257,891,3869,6287356,2623485
Lithuania,2022-10-18,8910841,8910841,0,https://e.infogram.com/57e5b447-c2ca-40da-aedb-cbf97df68a8e?parent_url=https%3A%2F%2Fosp.stat.gov.lt%2Fpraejusios-paros-covid-19-statistika&src=embed#async_embed,6600628,2310213,269,2243,0.8929140127388535,0,0,6287356,2623485
Lithuania,2022-10-19,8912903,8912903,2062,https://e.infogram.com/57e5b447-c2ca-40da-aedb-cbf97df68a8e?parent_url=https%3A%2F%2Fosp.stat.gov.lt%2Fpraejusios-paros-covid-19-statistika&src=embed#async_embed,6600925,2311978,297,1765,0.8559650824442289,297,1765,6287653,2625250
Lithuania,2022-10-20,8914555,8914555,1652,https://e.infogram.com/57e5b447-c2ca-40da-aedb-cbf97df68a8e?parent_url=https%3A%2F%2Fosp.stat.gov.lt%2Fpraejusios-paros-covid-19-statistika&src=embed#async_embed,6601139,2313416,214,1438,0.8704600484261501,214,1438,6287867,2626688
Lithuania,2022-10-21,8916156,8916156,1601,https://e.infogram.com/57e5b447-c2ca-40da-aedb-cbf97df68a8e?parent_url=https%3A%2F%2Fosp.stat.gov.lt%2Fpraejusios-paros-covid-19-statistika&src=embed#async_embed,6601328,2314828,189,1412,0.8819487820112429,189,1412,6288056,2628100
Lithuania,2022-10-22,8916156,8916156,0,https://e.infogram.com/57e5b447-c2ca-40da-aedb-cbf97df68a8e?parent_url=https%3A%2F%2Fosp.stat.gov.lt%2Fpraejusios-paros-covid-19-statistika&src=embed#async_embed,6601328,2314828,0,0,0.8819487820112429,0,0,6288056,2628100
Lithuania,2022-10-23,8916156,8916156,0,https://e.infogram.com/57e5b447-c2ca-40da-aedb-cbf97df68a8e?parent_url=https%3A%2F%2Fosp.stat.gov.lt%2Fpraejusios-paros-covid-19-statistika&src=embed#async_embed,6601328,2314828,0,0,0.8819487820112429,0,0,6288056,2628100
Lithuania,2022-10-24,8917729,8917729,1573,https://e.infogram.com/57e5b447-c2ca-40da-aedb-cbf97df68a8e?parent_url=https%3A%2F%2Fosp.stat.gov.lt%2Fpraejusios-paros-covid-19-statistika&src=embed#async_embed,6601599,2316130,271,1302,0.8277177368086459,271,1302,6288327,2629402
Lithuania,2022-10-25,8920300,8920300,2571,https://e.infogram.com/57e5b447-c2ca-40da-aedb-cbf97df68a8e?parent_url=https%3A%2F%2Fosp.stat.gov.lt%2Fpraejusios-paros-covid-19-statistika&src=embed#async_embed,6601976,2318324,377,2194,0.853364449630494,377,2194,6288704,2631596
Lithuania,2022-10-26,8921963,8921963,1663,https://e.infogram.com/57e5b447-c2ca-40da-aedb-cbf97df68a8e?parent_url=https%3A%2F%2Fosp.stat.gov.lt%2Fpraejusios-paros-covid-19-statistika&src=embed#async_embed,6602234,2319729,258,1405,0.8448586891160553,258,1405,6288962,2633001
Lithuania,2022-10-27,8923868,8923868,1905,https://e.infogram.com/57e5b447-c2ca-40da-aedb-cbf97df68a8e?parent_url=https%3A%2F%2Fosp.stat.gov.lt%2Fpraejusios-paros-covid-19-statistika&src=embed#async_embed,6602386,2321482,152,1753,0.9202099737532808,152,1753,6289114,2634754
Lithuania,2022-10-28,8925291,8925291,1423,https://e.infogram.com/57e5b447-c2ca-40da-aedb-cbf97df68a8e?parent_url=https%3A%2F%2Fosp.stat.gov.lt%2Fpraejusios-paros-covid-19-statistika&src=embed#async_embed,6602646,2322645,260,1163,0.8172874209416725,260,1163,6289374,2635917
Lithuania,2022-10-29,8925291,8925291,0,https://e.infogram.com/57e5b447-c2ca-40da-aedb-cbf97df68a8e?parent_url=https%3A%2F%2Fosp.stat.gov.lt%2Fpraejusios-paros-covid-19-statistika&src=embed#async_embed,6602646,2322645,0,0,0.8172874209416725,0,0,6289374,2635917
Lithuania,2022-10-30,8925291,8925291,0,https://e.infogram.com/57e5b447-c2ca-40da-aedb-cbf97df68a8e?parent_url=https%3A%2F%2Fosp.stat.gov.lt%2Fpraejusios-paros-covid-19-statistika&src=embed#async_embed,6602646,2322645,0,0,0.8172874209416725,0,0,6289374,2635917
Lithuania,2022-10-31,8927053,8927053,1762,https://e.infogram.com/57e5b447-c2ca-40da-aedb-cbf97df68a8e?parent_url=https%3A%2F%2Fosp.stat.gov.lt%2Fpraejusios-paros-covid-19-statistika&src=embed#async_embed,6603056,2323997,410,1352,0.7673098751418842,410,1352,6289784,2637269
Lithuania,2022-11-01,8927053,8927053,0,https://e.infogram.com/57e5b447-c2ca-40da-aedb-cbf97df68a8e?parent_url=https%3A%2F%2Fosp.stat.gov.lt%2Fpraejusios-paros-covid-19-statistika&src=embed#async_embed,6603056,2323997,0,0,0.7673098751418842,0,0,6289784,2637269
Lithuania,2022-11-02,8927053,8927053,0,https://e.infogram.com/57e5b447-c2ca-40da-aedb-cbf97df68a8e?parent_url=https%3A%2F%2Fosp.stat.gov.lt%2Fpraejusios-paros-covid-19-statistika&src=embed#async_embed,6603056,2323997,0,0,0.7673098751418842,0,0,6289784,2637269
Lithuania,2022-11-03,8929204,8929204,2151,https://e.infogram.com/57e5b447-c2ca-40da-aedb-cbf97df68a8e?parent_url=https%3A%2F%2Fosp.stat.gov.lt%2Fpraejusios-paros-covid-19-statistika&src=embed#async_embed,6603512,2325692,456,1695,0.7880055788005579,456,1695,6290240,2638964
Lithuania,2022-11-04,8931083,8931083,1879,https://e.infogram.com/57e5b447-c2ca-40da-aedb-cbf97df68a8e?parent_url=https%3A%2F%2Fosp.stat.gov.lt%2Fpraejusios-paros-covid-19-statistika&src=embed#async_embed,6603815,2327268,303,1576,0.8387440127727515,303,1576,6290543,2640540
Lithuania,2022-11-05,8931083,8931083,0,https://e.infogram.com/57e5b447-c2ca-40da-aedb-cbf97df68a8e?parent_url=https%3A%2F%2Fosp.stat.gov.lt%2Fpraejusios-paros-covid-19-statistika&src=embed#async_embed,6603815,2327268,0,0,0.8387440127727515,0,0,6290543,2640540
Lithuania,2022-11-06,8931083,8931083,0,https://e.infogram.com/57e5b447-c2ca-40da-aedb-cbf97df68a8e?parent_url=https%3A%2F%2Fosp.stat.gov.lt%2Fpraejusios-paros-covid-19-statistika&src=embed#async_embed,6603815,2327268,0,0,0.8387440127727515,0,0,6290543,2640540
Lithuania,2022-11-07,8932776,8932776,1693,https://e.infogram.com/57e5b447-c2ca-40da-aedb-cbf97df68a8e?parent_url=https%3A%2F%2Fosp.stat.gov.lt%2Fpraejusios-paros-covid-19-statistika&src=embed#async_embed,6604174,2328602,359,1334,0.7879503839338452,359,1334,6290902,2641874
Lithuania,2022-11-08,8934754,8934754,1978,https://e.infogram.com/57e5b447-c2ca-40da-aedb-cbf97df68a8e?parent_url=https%3A%2F%2Fosp.stat.gov.lt%2Fpraejusios-paros-covid-19-statistika&src=embed#async_embed,6604455,2330299,281,1697,0.8579373104145601,281,1697,6291183,2643571
Lithuania,2022-11-09,8936158,8936158,1404,https://e.infogram.com/57e5b447-c2ca-40da-aedb-cbf97df68a8e?parent_url=https%3A%2F%2Fosp.stat.gov.lt%2Fpraejusios-paros-covid-19-statistika&src=embed#async_embed,6604656,2331502,201,1203,0.8568376068376068,201,1203,6291384,2644774
Lithuania,2022-11-10,8937426,8937426,1268,https://e.infogram.com/57e5b447-c2ca-40da-aedb-cbf97df68a8e?parent_url=https%3A%2F%2Fosp.stat.gov.lt%2Fpraejusios-paros-covid-19-statistika&src=embed#async_embed,6604918,2332508,262,1006,0.7933753943217665,262,1006,6291646,2645780
Lithuania,2022-11-11,8938581,8938581,1155,https://e.infogram.com/57e5b447-c2ca-40da-aedb-cbf97df68a8e?parent_url=https%3A%2F%2Fosp.stat.gov.lt%2Fpraejusios-paros-covid-19-statistika&src=embed#async_embed,6605071,2333510,153,1002,0.8675324675324675,153,1002,6291799,2646782
Lithuania,2022-11-12,8938581,8938581,0,https://e.infogram.com/57e5b447-c2ca-40da-aedb-cbf97df68a8e?parent_url=https%3A%2F%2Fosp.stat.gov.lt%2Fpraejusios-paros-covid-19-statistika&src=embed#async_embed,6605071,2333510,0,0,0.8675324675324675,0,0,6291799,2646782
Lithuania,2022-11-13,8938581,8938581,0,https://e.infogram.com/57e5b447-c2ca-40da-aedb-cbf97df68a8e?parent_url=https%3A%2F%2Fosp.stat.gov.lt%2Fpraejusios-paros-covid-19-statistika&src=embed#async_embed,6605071,2333510,0,0,0.8675324675324675,0,0,6291799,2646782
Lithuania,2022-11-14,8940091,8940091,1510,https://e.infogram.com/57e5b447-c2ca-40da-aedb-cbf97df68a8e?parent_url=https%3A%2F%2Fosp.stat.gov.lt%2Fpraejusios-paros-covid-19-statistika&src=embed#async_embed,6605446,2334645,375,1135,0.7516556291390728,375,1135,6292174,2647917
Lithuania,2022-11-15,8941868,8941868,1777,https://e.infogram.com/57e5b447-c2ca-40da-aedb-cbf97df68a8e?parent_url=https%3A%2F%2Fosp.stat.gov.lt%2Fpraejusios-paros-covid-19-statistika&src=embed#async_embed,6605803,2336065,357,1420,0.799099606077659,357,1420,6292531,2649337
Lithuania,2022-11-16,8943275,8943275,1407,https://e.infogram.com/57e5b447-c2ca-40da-aedb-cbf97df68a8e?parent_url=https%3A%2F%2Fosp.stat.gov.lt%2Fpraejusios-paros-covid-19-statistika&src=embed#async_embed,6606044,2337231,241,1166,0.8287135749822317,241,1166,6292772,2650503
Lithuania,2022-11-17,8944501,8944501,1226,https://e.infogram.com/57e5b447-c2ca-40da-aedb-cbf97df68a8e?parent_url=https%3A%2F%2Fosp.stat.gov.lt%2Fpraejusios-paros-covid-19-statistika&src=embed#async_embed,6606223,2338278,179,1047,0.8539967373572593,179,1047,6292951,2651550
Lithuania,2022-11-18,8945609,8945609,1108,https://e.infogram.com/57e5b447-c2ca-40da-aedb-cbf97df68a8e?parent_url=https%3A%2F%2Fosp.stat.gov.lt%2Fpraejusios-paros-covid-19-statistika&src=embed#async_embed,6606369,2339240,146,962,0.868231046931408,146,962,6293097,2652512
Lithuania,2022-11-19,8945609,8945609,0,https://e.infogram.com/57e5b447-c2ca-40da-aedb-cbf97df68a8e?parent_url=https%3A%2F%2Fosp.stat.gov.lt%2Fpraejusios-paros-covid-19-statistika&src=embed#async_embed,6606369,2339240,0,0,0.868231046931408,0,0,6293097,2652512
Lithuania,2022-11-20,8945609,8945609,0,https://e.infogram.com/57e5b447-c2ca-40da-aedb-cbf97df68a8e?parent_url=https%3A%2F%2Fosp.stat.gov.lt%2Fpraejusios-paros-covid-19-statistika&src=embed#async_embed,6606369,2339240,0,0,0.868231046931408,0,0,6293097,2652512
Lithuania,2022-11-21,8945609,8945609,0,https://e.infogram.com/57e5b447-c2ca-40da-aedb-cbf97df68a8e?parent_url=https%3A%2F%2Fosp.stat.gov.lt%2Fpraejusios-paros-covid-19-statistika&src=embed#async_embed,6606369,2339240,0,0,0.868231046931408,0,0,6293097,2652512
Lithuania,2022-11-22,8945609,8945609,0,https://e.infogram.com/57e5b447-c2ca-40da-aedb-cbf97df68a8e?parent_url=https%3A%2F%2Fosp.stat.gov.lt%2Fpraejusios-paros-covid-19-statistika&src=embed#async_embed,6606984,2342000,615,2760,0.8177777777777778,0,0,6293097,2652512
Lithuania,2022-11-23,8945609,8945609,0,https://e.infogram.com/57e5b447-c2ca-40da-aedb-cbf97df68a8e?parent_url=https%3A%2F%2Fosp.stat.gov.lt%2Fpraejusios-paros-covid-19-statistika&src=embed#async_embed,6607244,2343206,260,1206,0.8226466575716235,0,0,6293097,2652512
Lithuania,2022-11-24,8945609,8945609,0,https://e.infogram.com/57e5b447-c2ca-40da-aedb-cbf97df68a8e?parent_url=https%3A%2F%2Fosp.stat.gov.lt%2Fpraejusios-paros-covid-19-statistika&src=embed#async_embed,6607397,2344412,153,1206,0.8874172185430463,0,0,6293097,2652512
Lithuania,2022-11-25,8945609,8945609,0,https://e.infogram.com/57e5b447-c2ca-40da-aedb-cbf97df68a8e?parent_url=https%3A%2F%2Fosp.stat.gov.lt%2Fpraejusios-paros-covid-19-statistika&src=embed#async_embed,6607597,2345545,200,1133,0.8499624906226556,0,0,6293097,2652512
Lithuania,2022-11-26,8945609,8945609,0,https://e.infogram.com/57e5b447-c2ca-40da-aedb-cbf97df68a8e?parent_url=https%3A%2F%2Fosp.stat.gov.lt%2Fpraejusios-paros-covid-19-statistika&src=embed#async_embed,6607597,2345545,0,0,0.8499624906226556,0,0,6293097,2652512
Lithuania,2022-11-27,8945609,8945609,0,https://e.infogram.com/57e5b447-c2ca-40da-aedb-cbf97df68a8e?parent_url=https%3A%2F%2Fosp.stat.gov.lt%2Fpraejusios-paros-covid-19-statistika&src=embed#async_embed,6607597,2345545,0,0,0.8499624906226556,0,0,6293097,2652512
Lithuania,2022-11-28,8945609,8945609,0,https://e.infogram.com/57e5b447-c2ca-40da-aedb-cbf97df68a8e?parent_url=https%3A%2F%2Fosp.stat.gov.lt%2Fpraejusios-paros-covid-19-statistika&src=embed#async_embed,6608047,2346871,450,1326,0.7466216216216216,0,0,6293097,2652512
Lithuania,2022-11-29,8945609,8945609,0,https://e.infogram.com/57e5b447-c2ca-40da-aedb-cbf97df68a8e?parent_url=https%3A%2F%2Fosp.stat.gov.lt%2Fpraejusios-paros-covid-19-statistika&src=embed#async_embed,6608200,2347939,153,1068,0.8746928746928747,0,0,6293097,2652512
Lithuania,2022-11-30,8945609,8945609,0,https://e.infogram.com/57e5b447-c2ca-40da-aedb-cbf97df68a8e?parent_url=https%3A%2F%2Fosp.stat.gov.lt%2Fpraejusios-paros-covid-19-statistika&src=embed#async_embed,6608456,2350273,256,2334,0.9011583011583012,0,0,6293097,2652512
Lithuania,2022-12-01,8960637,8960637,15028,https://e.infogram.com/57e5b447-c2ca-40da-aedb-cbf97df68a8e?parent_url=https%3A%2F%2Fosp.stat.gov.lt%2Fpraejusios-paros-covid-19-statistika&src=embed#async_embed,6608752,2351885,296,1612,0.8448637316561844,2331,12697,6295428,2665209
Lithuania,2022-12-02,8962291,8962291,1654,https://e.infogram.com/57e5b447-c2ca-40da-aedb-cbf97df68a8e?parent_url=https%3A%2F%2Fosp.stat.gov.lt%2Fpraejusios-paros-covid-19-statistika&src=embed#async_embed,6608995,2353296,243,1411,0.8530834340991535,243,1411,6295671,2666620
Lithuania,2022-12-03,8962291,8962291,0,https://e.infogram.com/57e5b447-c2ca-40da-aedb-cbf97df68a8e?parent_url=https%3A%2F%2Fosp.stat.gov.lt%2Fpraejusios-paros-covid-19-statistika&src=embed#async_embed,6608995,2353296,0,0,0.8530834340991535,0,0,6295671,2666620
Lithuania,2022-12-04,8962291,8962291,0,https://e.infogram.com/57e5b447-c2ca-40da-aedb-cbf97df68a8e?parent_url=https%3A%2F%2Fosp.stat.gov.lt%2Fpraejusios-paros-covid-19-statistika&src=embed#async_embed,6608995,2353296,0,0,0.8530834340991535,0,0,6295671,2666620
Lithuania,2022-12-05,8964461,8964461,2170,https://e.infogram.com/57e5b447-c2ca-40da-aedb-cbf97df68a8e?parent_url=https%3A%2F%2Fosp.stat.gov.lt%2Fpraejusios-paros-covid-19-statistika&src=embed#async_embed,6609449,2355012,454,1716,0.7907834101382488,454,1716,6296125,2668336
Lithuania,2022-12-06,8967461,8967461,3000,https://e.infogram.com/57e5b447-c2ca-40da-aedb-cbf97df68a8e?parent_url=https%3A%2F%2Fosp.stat.gov.lt%2Fpraejusios-paros-covid-19-statistika&src=embed#async_embed,6609798,2357663,349,2651,0.8836666666666667,349,2651,6296474,2670987
Lithuania,2022-12-07,8969756,8969756,2295,https://e.infogram.com/57e5b447-c2ca-40da-aedb-cbf97df68a8e?parent_url=https%3A%2F%2Fosp.stat.gov.lt%2Fpraejusios-paros-covid-19-statistika&src=embed#async_embed,6610204,2359552,406,1889,0.8230936819172113,406,1889,6296880,2672876
Lithuania,2022-12-08,8971840,8971840,2084,https://e.infogram.com/57e5b447-c2ca-40da-aedb-cbf97df68a8e?parent_url=https%3A%2F%2Fosp.stat.gov.lt%2Fpraejusios-paros-covid-19-statistika&src=embed#async_embed,6610506,2361334,302,1782,0.8550863723608445,302,1782,6297182,2674658
Lithuania,2022-12-09,8973851,8973851,2011,https://e.infogram.com/57e5b447-c2ca-40da-aedb-cbf97df68a8e?parent_url=https%3A%2F%2Fosp.stat.gov.lt%2Fpraejusios-paros-covid-19-statistika&src=embed#async_embed,6610742,2363109,236,1775,0.8826454500248633,236,1775,6297418,2676433
Lithuania,2022-12-10,8973851,8973851,0,https://e.infogram.com/57e5b447-c2ca-40da-aedb-cbf97df68a8e?parent_url=https%3A%2F%2Fosp.stat.gov.lt%2Fpraejusios-paros-covid-19-statistika&src=embed#async_embed,6610742,2363109,0,0,0.8826454500248633,0,0,6297418,2676433
Lithuania,2022-12-11,8973851,8973851,0,https://e.infogram.com/57e5b447-c2ca-40da-aedb-cbf97df68a8e?parent_url=https%3A%2F%2Fosp.stat.gov.lt%2Fpraejusios-paros-covid-19-statistika&src=embed#async_embed,6610742,2363109,0,0,0.8826454500248633,0,0,6297418,2676433
Lithuania,2022-12-12,8976627,8976627,2776,https://e.infogram.com/57e5b447-c2ca-40da-aedb-cbf97df68a8e?parent_url=https%3A%2F%2Fosp.stat.gov.lt%2Fpraejusios-paros-covid-19-statistika&src=embed#async_embed,6611404,2365223,662,2114,0.7615273775216138,662,2114,6298080,2678547
Lithuania,2022-12-13,8979493,8979493,2866,https://e.infogram.com/57e5b447-c2ca-40da-aedb-cbf97df68a8e?parent_url=https%3A%2F%2Fosp.stat.gov.lt%2Fpraejusios-paros-covid-19-statistika&src=embed#async_embed,6611764,2367729,360,2506,0.8743893928820656,360,2506,6298440,2681053
Lithuania,2022-12-14,8982084,8982084,2591,https://e.infogram.com/57e5b447-c2ca-40da-aedb-cbf97df68a8e?parent_url=https%3A%2F%2Fosp.stat.gov.lt%2Fpraejusios-paros-covid-19-statistika&src=embed#async_embed,6612090,2369994,326,2265,0.8741798533384794,326,2265,6298766,2683318
Lithuania,2022-12-15,8984318,8984318,2234,https://e.infogram.com/57e5b447-c2ca-40da-aedb-cbf97df68a8e?parent_url=https%3A%2F%2Fosp.stat.gov.lt%2Fpraejusios-paros-covid-19-statistika&src=embed#async_embed,6612392,2371926,302,1932,0.864816472694718,302,1932,6299068,2685250
Lithuania,2022-12-16,8984318,8984318,0,https://e.infogram.com/57e5b447-c2ca-40da-aedb-cbf97df68a8e?parent_url=https%3A%2F%2Fosp.stat.gov.lt%2Fpraejusios-paros-covid-19-statistika&src=embed#async_embed,6612392,2371926,0,0,0.864816472694718,0,0,6299068,2685250
Lithuania,2022-12-17,8984318,8984318,0,https://e.infogram.com/57e5b447-c2ca-40da-aedb-cbf97df68a8e?parent_url=https%3A%2F%2Fosp.stat.gov.lt%2Fpraejusios-paros-covid-19-statistika&src=embed#async_embed,6612392,2371926,0,0,0.864816472694718,0,0,6299068,2685250
Lithuania,2022-12-18,8984318,8984318,0,https://e.infogram.com/57e5b447-c2ca-40da-aedb-cbf97df68a8e?parent_url=https%3A%2F%2Fosp.stat.gov.lt%2Fpraejusios-paros-covid-19-statistika&src=embed#async_embed,6612392,2371926,0,0,0.864816472694718,0,0,6299068,2685250
Lithuania,2022-12-19,8989011,8989011,4693,https://e.infogram.com/57e5b447-c2ca-40da-aedb-cbf97df68a8e?parent_url=https%3A%2F%2Fosp.stat.gov.lt%2Fpraejusios-paros-covid-19-statistika&src=embed#async_embed,6613193,2375818,801,3892,0.8293202642233113,801,3892,6299869,2689142
Lithuania,2022-12-20,8989011,8989011,0,https://e.infogram.com/57e5b447-c2ca-40da-aedb-cbf97df68a8e?parent_url=https%3A%2F%2Fosp.stat.gov.lt%2Fpraejusios-paros-covid-19-statistika&src=embed#async_embed,6613193,2375818,0,0,0.8293202642233113,0,0,6299869,2689142
Lithuania,2022-12-21,8989011,8989011,0,https://e.infogram.com/57e5b447-c2ca-40da-aedb-cbf97df68a8e?parent_url=https%3A%2F%2Fosp.stat.gov.lt%2Fpraejusios-paros-covid-19-statistika&src=embed#async_embed,6613193,2375818,0,0,0.8293202642233113,0,0,6299869,2689142
Lithuania,2022-12-22,8992468,8992468,3457,https://e.infogram.com/57e5b447-c2ca-40da-aedb-cbf97df68a8e?parent_url=https%3A%2F%2Fosp.stat.gov.lt%2Fpraejusios-paros-covid-19-statistika&src=embed#async_embed,6613636,2378832,443,3014,0.8718542088516055,443,3014,6300312,2692156
Lithuania,2022-12-23,8992468,8992468,0,https://e.infogram.com/57e5b447-c2ca-40da-aedb-cbf97df68a8e?parent_url=https%3A%2F%2Fosp.stat.gov.lt%2Fpraejusios-paros-covid-19-statistika&src=embed#async_embed,6613636,2378832,0,0,0.8718542088516055,0,0,6300312,2692156
Lithuania,2022-12-24,8992468,8992468,0,https://e.infogram.com/57e5b447-c2ca-40da-aedb-cbf97df68a8e?parent_url=https%3A%2F%2Fosp.stat.gov.lt%2Fpraejusios-paros-covid-19-statistika&src=embed#async_embed,6613636,2378832,0,0,0.8718542088516055,0,0,6300312,2692156
Lithuania,2022-12-25,8992468,8992468,0,https://e.infogram.com/57e5b447-c2ca-40da-aedb-cbf97df68a8e?parent_url=https%3A%2F%2Fosp.stat.gov.lt%2Fpraejusios-paros-covid-19-statistika&src=embed#async_embed,6613636,2378832,0,0,0.8718542088516055,0,0,6300312,2692156
Lithuania,2022-12-26,8992468,8992468,0,https://e.infogram.com/57e5b447-c2ca-40da-aedb-cbf97df68a8e?parent_url=https%3A%2F%2Fosp.stat.gov.lt%2Fpraejusios-paros-covid-19-statistika&src=embed#async_embed,6613636,2378832,0,0,0.8718542088516055,0,0,6300312,2692156
Lithuania,2022-12-27,9002348,9002348,9880,https://e.infogram.com/57e5b447-c2ca-40da-aedb-cbf97df68a8e?parent_url=https%3A%2F%2Fosp.stat.gov.lt%2Fpraejusios-paros-covid-19-statistika&src=embed#async_embed,6615037,2387311,1401,8479,0.8581983805668016,1401,8479,6301713,2700635
Lithuania,2022-12-28,9005147,9005147,2799,https://e.infogram.com/57e5b447-c2ca-40da-aedb-cbf97df68a8e?parent_url=https%3A%2F%2Fosp.stat.gov.lt%2Fpraejusios-paros-covid-19-statistika&src=embed#async_embed,6615301,2389846,264,2535,0.9056806002143623,264,2535,6301977,2703170
Lithuania,2022-12-29,9007395,9007395,2248,https://e.infogram.com/57e5b447-c2ca-40da-aedb-cbf97df68a8e?parent_url=https%3A%2F%2Fosp.stat.gov.lt%2Fpraejusios-paros-covid-19-statistika&src=embed#async_embed,6615585,2391810,284,1964,0.8736654804270463,284,1964,6302261,2705134
Lithuania,2022-12-30,9009652,9009652,2257,https://e.infogram.com/57e5b447-c2ca-40da-aedb-cbf97df68a8e?parent_url=https%3A%2F%2Fosp.stat.gov.lt%2Fpraejusios-paros-covid-19-statistika&src=embed#async_embed,6615803,2393849,218,2039,0.9034116083296411,218,2039,6302479,2707173
Lithuania,2022-12-31,9009652,9009652,0,https://e.infogram.com/57e5b447-c2ca-40da-aedb-cbf97df68a8e?parent_url=https%3A%2F%2Fosp.stat.gov.lt%2Fpraejusios-paros-covid-19-statistika&src=embed#async_embed,6615803,2393849,0,0,0.9034116083296411,0,0,6302479,2707173
Lithuania,2023-01-01,9009652,9009652,0,https://e.infogram.com/57e5b447-c2ca-40da-aedb-cbf97df68a8e?parent_url=https%3A%2F%2Fosp.stat.gov.lt%2Fpraejusios-paros-covid-19-statistika&src=embed#async_embed,6615803,2393849,0,0,0.9034116083296411,0,0,6302479,2707173
Lithuania,2023-01-02,9012512,9012512,2860,https://e.infogram.com/57e5b447-c2ca-40da-aedb-cbf97df68a8e?parent_url=https%3A%2F%2Fosp.stat.gov.lt%2Fpraejusios-paros-covid-19-statistika&src=embed#async_embed,6616249,2396263,446,2414,0.8440559440559441,446,2414,6302925,2709587
Lithuania,2023-01-03,9015283,9015283,2771,https://e.infogram.com/57e5b447-c2ca-40da-aedb-cbf97df68a8e?parent_url=https%3A%2F%2Fosp.stat.gov.lt%2Fpraejusios-paros-covid-19-statistika&src=embed#async_embed,6616579,2398704,330,2441,0.8809094189823169,330,2441,6303255,2712028
Lithuania,2023-01-04,9017535,9017535,2252,https://e.infogram.com/57e5b447-c2ca-40da-aedb-cbf97df68a8e?parent_url=https%3A%2F%2Fosp.stat.gov.lt%2Fpraejusios-paros-covid-19-statistika&src=embed#async_embed,6616847,2400688,268,1984,0.8809946714031972,268,1984,6303523,2714012
Lithuania,2023-01-05,9019316,9019316,1781,https://e.infogram.com/57e5b447-c2ca-40da-aedb-cbf97df68a8e?parent_url=https%3A%2F%2Fosp.stat.gov.lt%2Fpraejusios-paros-covid-19-statistika&src=embed#async_embed,6617070,2402246,223,1558,0.8747894441325098,223,1558,6303746,2715570
Lithuania,2023-01-06,9020881,9020881,1565,https://e.infogram.com/57e5b447-c2ca-40da-aedb-cbf97df68a8e?parent_url=https%3A%2F%2Fosp.stat.gov.lt%2Fpraejusios-paros-covid-19-statistika&src=embed#async_embed,6617252,2403629,182,1383,0.8837060702875399,182,1383,6303928,2716953
Lithuania,2023-01-07,9020881,9020881,0,https://e.infogram.com/57e5b447-c2ca-40da-aedb-cbf97df68a8e?parent_url=https%3A%2F%2Fosp.stat.gov.lt%2Fpraejusios-paros-covid-19-statistika&src=embed#async_embed,6617252,2403629,0,0,0.8837060702875399,0,0,6303928,2716953
Lithuania,2023-01-08,9020881,9020881,0,https://e.infogram.com/57e5b447-c2ca-40da-aedb-cbf97df68a8e?parent_url=https%3A%2F%2Fosp.stat.gov.lt%2Fpraejusios-paros-covid-19-statistika&src=embed#async_embed,6617252,2403629,0,0,0.8837060702875399,0,0,6303928,2716953
Lithuania,2023-01-09,9022700,9022700,1819,https://e.infogram.com/57e5b447-c2ca-40da-aedb-cbf97df68a8e?parent_url=https%3A%2F%2Fosp.stat.gov.lt%2Fpraejusios-paros-covid-19-statistika&src=embed#async_embed,6617630,2405070,378,1441,0.7921935129191864,378,1441,6304306,2718394
Lithuania,2023-01-10,9024602,9024602,1902,https://e.infogram.com/57e5b447-c2ca-40da-aedb-cbf97df68a8e?parent_url=https%3A%2F%2Fosp.stat.gov.lt%2Fpraejusios-paros-covid-19-statistika&src=embed#async_embed,6617877,2406725,247,1655,0.870136698212408,247,1655,6304553,2720049
Lithuania,2023-01-11,9025798,9025798,1196,https://e.infogram.com/57e5b447-c2ca-40da-aedb-cbf97df68a8e?parent_url=https%3A%2F%2Fosp.stat.gov.lt%2Fpraejusios-paros-covid-19-statistika&src=embed#async_embed,6618039,2407759,162,1034,0.8645484949832776,162,1034,6304715,2721083
Lithuania,2023-01-12,9027232,9027232,1434,https://e.infogram.com/57e5b447-c2ca-40da-aedb-cbf97df68a8e?parent_url=https%3A%2F%2Fosp.stat.gov.lt%2Fpraejusios-paros-covid-19-statistika&src=embed#async_embed,6618216,2409016,177,1257,0.8765690376569037,177,1257,6304892,2722340
Lithuania,2023-01-13,9028266,9028266,1034,https://e.infogram.com/57e5b447-c2ca-40da-aedb-cbf97df68a8e?parent_url=https%3A%2F%2Fosp.stat.gov.lt%2Fpraejusios-paros-covid-19-statistika&src=embed#async_embed,6618324,2409942,108,926,0.8955512572533849,108,926,6305000,2723266
Lithuania,2023-01-14,9028266,9028266,0,https://e.infogram.com/57e5b447-c2ca-40da-aedb-cbf97df68a8e?parent_url=https%3A%2F%2Fosp.stat.gov.lt%2Fpraejusios-paros-covid-19-statistika&src=embed#async_embed,6618324,2409942,0,0,0.8955512572533849,0,0,6305000,2723266
Lithuania,2023-01-15,9028266,9028266,0,https://e.infogram.com/57e5b447-c2ca-40da-aedb-cbf97df68a8e?parent_url=https%3A%2F%2Fosp.stat.gov.lt%2Fpraejusios-paros-covid-19-statistika&src=embed#async_embed,6618324,2409942,0,0,0.8955512572533849,0,0,6305000,2723266
Lithuania,2023-01-16,9029793,9029793,1527,https://e.infogram.com/57e5b447-c2ca-40da-aedb-cbf97df68a8e?parent_url=https%3A%2F%2Fosp.stat.gov.lt%2Fpraejusios-paros-covid-19-statistika&src=embed#async_embed,6618676,2411117,352,1175,0.7694826457105436,352,1175,6305352,2724441
Lithuania,2023-01-17,9031430,9031430,1637,https://e.infogram.com/57e5b447-c2ca-40da-aedb-cbf97df68a8e?parent_url=https%3A%2F%2Fosp.stat.gov.lt%2Fpraejusios-paros-covid-19-statistika&src=embed#async_embed,6618894,2412536,218,1419,0.8668295662797801,218,1419,6305570,2725860
Lithuania,2023-01-18,9032665,9032665,1235,https://e.infogram.com/57e5b447-c2ca-40da-aedb-cbf97df68a8e?parent_url=https%3A%2F%2Fosp.stat.gov.lt%2Fpraejusios-paros-covid-19-statistika&src=embed#async_embed,6619077,2413588,183,1052,0.8518218623481781,183,1052,6305753,2726912
Lithuania,2023-01-19,9032665,9032665,0,https://e.infogram.com/57e5b447-c2ca-40da-aedb-cbf97df68a8e?parent_url=https%3A%2F%2Fosp.stat.gov.lt%2Fpraejusios-paros-covid-19-statistika&src=embed#async_embed,6619077,2413588,0,0,0.8518218623481781,0,0,6305753,2726912
Lithuania,2023-01-20,9034655,9034655,1990,https://e.infogram.com/57e5b447-c2ca-40da-aedb-cbf97df68a8e?parent_url=https%3A%2F%2Fosp.stat.gov.lt%2Fpraejusios-paros-covid-19-statistika&src=embed#async_embed,6619334,2415321,257,1733,0.870854271356784,257,1733,6306010,2728645
Lithuania,2023-01-21,9034655,9034655,0,https://e.infogram.com/57e5b447-c2ca-40da-aedb-cbf97df68a8e?parent_url=https%3A%2F%2Fosp.stat.gov.lt%2Fpraejusios-paros-covid-19-statistika&src=embed#async_embed,6619334,2415321,0,0,0.870854271356784,0,0,6306010,2728645
Lithuania,2023-01-22,9034655,9034655,0,https://e.infogram.com/57e5b447-c2ca-40da-aedb-cbf97df68a8e?parent_url=https%3A%2F%2Fosp.stat.gov.lt%2Fpraejusios-paros-covid-19-statistika&src=embed#async_embed,6619334,2415321,0,0,0.870854271356784,0,0,6306010,2728645
Lithuania,2023-01-23,9035989,9035989,1334,https://e.infogram.com/57e5b447-c2ca-40da-aedb-cbf97df68a8e?parent_url=https%3A%2F%2Fosp.stat.gov.lt%2Fpraejusios-paros-covid-19-statistika&src=embed#async_embed,6619578,2416411,244,1090,0.8170914542728636,244,1090,6306254,2729735
Lithuania,2023-01-24,9037536,9037536,1547,https://e.infogram.com/57e5b447-c2ca-40da-aedb-cbf97df68a8e?parent_url=https%3A%2F%2Fosp.stat.gov.lt%2Fpraejusios-paros-covid-19-statistika&src=embed#async_embed,6619765,2417771,187,1360,0.8791208791208791,187,1360,6306441,2731095
Lithuania,2023-01-25,9038731,9038731,1195,https://e.infogram.com/57e5b447-c2ca-40da-aedb-cbf97df68a8e?parent_url=https%3A%2F%2Fosp.stat.gov.lt%2Fpraejusios-paros-covid-19-statistika&src=embed#async_embed,6619922,2418809,157,1038,0.8686192468619247,157,1038,6306598,2732133
Lithuania,2023-01-26,9039789,9039789,1058,https://e.infogram.com/57e5b447-c2ca-40da-aedb-cbf97df68a8e?parent_url=https%3A%2F%2Fosp.stat.gov.lt%2Fpraejusios-paros-covid-19-statistika&src=embed#async_embed,6620017,2419772,95,963,0.9102079395085066,95,963,6306693,2733096
Lithuania,2023-01-27,9040862,9040862,1073,https://e.infogram.com/57e5b447-c2ca-40da-aedb-cbf97df68a8e?parent_url=https%3A%2F%2Fosp.stat.gov.lt%2Fpraejusios-paros-covid-19-statistika&src=embed#async_embed,6620212,2420650,195,878,0.8182665424044734,195,878,6306888,2733974
Lithuania,2023-01-28,9040862,9040862,0,https://e.infogram.com/57e5b447-c2ca-40da-aedb-cbf97df68a8e?parent_url=https%3A%2F%2Fosp.stat.gov.lt%2Fpraejusios-paros-covid-19-statistika&src=embed#async_embed,6620212,2420650,0,0,0.8182665424044734,0,0,6306888,2733974
Lithuania,2023-01-29,9040862,9040862,0,https://e.infogram.com/57e5b447-c2ca-40da-aedb-cbf97df68a8e?parent_url=https%3A%2F%2Fosp.stat.gov.lt%2Fpraejusios-paros-covid-19-statistika&src=embed#async_embed,6620212,2420650,0,0,0.8182665424044734,0,0,6306888,2733974
Lithuania,2023-01-30,9042221,9042221,1359,https://e.infogram.com/57e5b447-c2ca-40da-aedb-cbf97df68a8e?parent_url=https%3A%2F%2Fosp.stat.gov.lt%2Fpraejusios-paros-covid-19-statistika&src=embed#async_embed,6620470,2421751,258,1101,0.8101545253863135,258,1101,6307146,2735075
Lithuania,2023-01-31,9043814,9043814,1593,https://e.infogram.com/57e5b447-c2ca-40da-aedb-cbf97df68a8e?parent_url=https%3A%2F%2Fosp.stat.gov.lt%2Fpraejusios-paros-covid-19-statistika&src=embed#async_embed,6620653,2423161,183,1410,0.8851224105461394,183,1410,6307329,2736485
Lithuania,2023-02-01,9045494,9045494,1680,https://e.infogram.com/57e5b447-c2ca-40da-aedb-cbf97df68a8e?parent_url=https%3A%2F%2Fosp.stat.gov.lt%2Fpraejusios-paros-covid-19-statistika&src=embed#async_embed,6620803,2424691,150,1530,0.9107142857142857,150,1530,6307479,2738015
Lithuania,2023-02-02,9046584,9046584,1090,https://e.infogram.com/57e5b447-c2ca-40da-aedb-cbf97df68a8e?parent_url=https%3A%2F%2Fosp.stat.gov.lt%2Fpraejusios-paros-covid-19-statistika&src=embed#async_embed,6620952,2425632,149,941,0.863302752293578,149,941,6307628,2738956
Lithuania,2023-02-03,9047778,9047778,1194,https://e.infogram.com/57e5b447-c2ca-40da-aedb-cbf97df68a8e?parent_url=https%3A%2F%2Fosp.stat.gov.lt%2Fpraejusios-paros-covid-19-statistika&src=embed#async_embed,6621106,2426672,154,1040,0.8710217755443886,154,1040,6307782,2739996
Lithuania,2023-02-04,9047778,9047778,0,https://e.infogram.com/57e5b447-c2ca-40da-aedb-cbf97df68a8e?parent_url=https%3A%2F%2Fosp.stat.gov.lt%2Fpraejusios-paros-covid-19-statistika&src=embed#async_embed,6621106,2426672,0,0,0.8710217755443886,0,0,6307782,2739996
Lithuania,2023-02-05,9047778,9047778,0,https://e.infogram.com/57e5b447-c2ca-40da-aedb-cbf97df68a8e?parent_url=https%3A%2F%2Fosp.stat.gov.lt%2Fpraejusios-paros-covid-19-statistika&src=embed#async_embed,6621106,2426672,0,0,0.8710217755443886,0,0,6307782,2739996
Lithuania,2023-02-06,9049156,9049156,1378,https://e.infogram.com/57e5b447-c2ca-40da-aedb-cbf97df68a8e?parent_url=https%3A%2F%2Fosp.stat.gov.lt%2Fpraejusios-paros-covid-19-statistika&src=embed#async_embed,6621332,2427824,226,1152,0.8359941944847605,226,1152,6308008,2741148
Lithuania,2023-02-07,9050807,9050807,1651,https://e.infogram.com/57e5b447-c2ca-40da-aedb-cbf97df68a8e?parent_url=https%3A%2F%2Fosp.stat.gov.lt%2Fpraejusios-paros-covid-19-statistika&src=embed#async_embed,6621544,2429263,212,1439,0.8715929739551787,212,1439,6308220,2742587
Lithuania,2023-02-08,9050807,9050807,0,https://e.infogram.com/57e5b447-c2ca-40da-aedb-cbf97df68a8e?parent_url=https%3A%2F%2Fosp.stat.gov.lt%2Fpraejusios-paros-covid-19-statistika&src=embed#async_embed,6621544,2429263,0,0,0.8715929739551787,0,0,6308220,2742587
Lithuania,2023-02-09,9050807,9050807,0,https://e.infogram.com/57e5b447-c2ca-40da-aedb-cbf97df68a8e?parent_url=https%3A%2F%2Fosp.stat.gov.lt%2Fpraejusios-paros-covid-19-statistika&src=embed#async_embed,6621823,2431459,279,2196,0.8872727272727273,0,0,6308220,2742587
Lithuania,2023-02-10,9054457,9054457,3650,https://e.infogram.com/57e5b447-c2ca-40da-aedb-cbf97df68a8e?parent_url=https%3A%2F%2Fosp.stat.gov.lt%2Fpraejusios-paros-covid-19-statistika&src=embed#async_embed,6622000,2432457,177,998,0.8493617021276596,550,3100,6308770,2745687
Lithuania,2023-02-11,9054457,9054457,0,https://e.infogram.com/57e5b447-c2ca-40da-aedb-cbf97df68a8e?parent_url=https%3A%2F%2Fosp.stat.gov.lt%2Fpraejusios-paros-covid-19-statistika&src=embed#async_embed,6622000,2432457,0,0,0.8493617021276596,0,0,6308770,2745687
Lithuania,2023-02-12,9055979,9055979,1522,https://e.infogram.com/57e5b447-c2ca-40da-aedb-cbf97df68a8e?parent_url=https%3A%2F%2Fosp.stat.gov.lt%2Fpraejusios-paros-covid-19-statistika&src=embed#async_embed,6622000,2432457,0,0,0.8493617021276596,229,1293,6308999,2746980
Lithuania,2023-02-13,9055979,9055979,0,https://e.infogram.com/57e5b447-c2ca-40da-aedb-cbf97df68a8e?parent_url=https%3A%2F%2Fosp.stat.gov.lt%2Fpraejusios-paros-covid-19-statistika&src=embed#async_embed,6622257,2433722,257,1265,0.831143232588699,0,0,6308999,2746980
Lithuania,2023-02-14,9057625,9057625,1646,https://e.infogram.com/57e5b447-c2ca-40da-aedb-cbf97df68a8e?parent_url=https%3A%2F%2Fosp.stat.gov.lt%2Fpraejusios-paros-covid-19-statistika&src=embed#async_embed,6622471,2435154,214,1432,0.8699878493317132,214,1432,6309213,2748412
Slovakia,2021-03-23,22909120,22909120,328620,https://korona.gov.sk/,2279486,20629634,10875,317745,0.9669070659119956,10875,317745,2279486,20629634
Slovakia,2021-03-24,23128218,23128218,219098,https://korona.gov.sk/,2290864,20837354,11378,207720,0.9480689006745839,11378,207720,2290864,20837354
Slovakia,2021-03-25,23328365,23328365,200147,https://korona.gov.sk/,2300975,21027390,10111,190036,0.949482130633984,10111,190036,2300975,21027390
Slovakia,2021-03-26,23512736,23512736,184371,https://korona.gov.sk/,2310054,21202682,9079,175292,0.9507568977767653,9079,175292,2310054,21202682
Slovakia,2021-03-27,23836249,23836249,323513,https://korona.gov.sk/,2322443,21513806,12389,311124,0.9617047846608946,12389,311124,2322443,21513806
Slovakia,2021-03-28,24435035,24435035,598786,https://korona.gov.sk/,2329530,22105505,7087,591699,0.9881643859408871,7087,591699,2329530,22105505
Slovakia,2021-03-29,24770315,24770315,335280,https://korona.gov.sk/,2331828,22438487,2298,332982,0.9931460272011453,2298,332982,2331828,22438487
Slovakia,2021-03-30,25132752,25132752,362437,https://korona.gov.sk/,2340533,22792219,8705,353732,0.975982032739483,8705,353732,2340533,22792219
Slovakia,2021-03-31,25378086,25378086,245334,https://korona.gov.sk/,2351940,23026146,11407,233927,0.9535042024342325,11407,233927,2351940,23026146
Slovakia,2021-04-01,25634349,25634349,256263,https://korona.gov.sk/,2360594,23273755,8654,247609,0.966230005892384,8654,247609,2360594,23273755
Slovakia,2021-04-02,25915186,25915186,280837,https://korona.gov.sk/,2373463,23541723,12869,267968,0.954176265947863,12869,267968,2373463,23541723
Slovakia,2021-04-03,26096234,26096234,181048,https://korona.gov.sk/,2379759,23716475,6296,174752,0.9652246917944413,6296,174752,2379759,23716475
Slovakia,2021-04-04,26711901,26711901,615667,https://korona.gov.sk/,2384180,24327721,4421,611246,0.9928191701033189,4421,611246,2384180,24327721
Slovakia,2021-04-05,26926375,26926375,214474,https://korona.gov.sk/,2386011,24540364,1831,212643,0.991462834655949,1831,212643,2386011,24540364
Slovakia,2021-04-06,27043526,27043526,117151,https://korona.gov.sk/,2389156,24654370,3145,114006,0.9731543051275704,3145,114006,2389156,24654370
Slovakia,2021-04-07,27418747,27418747,375221,https://korona.gov.sk/,2399863,25018884,10707,364514,0.971464816734671,10707,364514,2399863,25018884
Slovakia,2021-04-08,27641040,27641040,222293,https://korona.gov.sk/,2411744,25229296,11881,210412,0.9465525230214177,11881,210412,2411744,25229296
Slovakia,2021-04-09,27826872,27826872,185832,https://korona.gov.sk/,2420747,25406125,9003,176829,0.951553015627018,9003,176829,2420747,25406125
Slovakia,2021-04-10,28114203,28114203,287331,https://korona.gov.sk/,2432500,25681703,11753,275578,0.9590959555356018,11753,275578,2432500,25681703
Slovakia,2021-04-11,28702887,28702887,588684,https://korona.gov.sk/,2439970,26262917,7470,581214,0.9873106794137432,7470,581214,2439970,26262917
Slovakia,2021-04-12,29058959,29058959,356072,https://korona.gov.sk/,2441472,26617487,1502,354570,0.9957817520052125,1502,354570,2441472,26617487
Slovakia,2021-04-13,29383409,29383409,324450,https://korona.gov.sk/,2449747,26933662,8275,316175,0.9744952997380182,8275,316175,2449747,26933662
Slovakia,2021-04-14,29580364,29580364,196955,https://korona.gov.sk/,2458340,27122024,8593,188362,0.9563707445863269,8593,188362,2458340,27122024
Slovakia,2021-04-15,29797625,29797625,217261,https://korona.gov.sk/,2465652,27331973,7312,209949,0.9663446269694055,7312,209949,2465652,27331973
Slovakia,2021-04-16,29992550,29992550,194925,https://korona.gov.sk/,2473314,27519236,7662,187263,0.9606925740669489,7662,187263,2473314,27519236
Slovakia,2021-04-17,30310903,30310903,318353,https://korona.gov.sk/,2486691,27824212,13377,304976,0.9579806064337386,13377,304976,2486691,27824212
Slovakia,2021-04-18,30885802,30885802,574899,https://korona.gov.sk/,2503748,28382054,17057,557842,0.9703304406513144,17057,557842,2503748,28382054
Slovakia,2021-04-19,31277633,31277633,391831,https://korona.gov.sk/,2505182,28772451,1434,390397,0.9963402589381647,1434,390397,2505182,28772451
Slovakia,2021-04-20,31596512,31596512,318879,https://korona.gov.sk/,2513141,29083371,7959,310920,0.9750406894151072,7959,310920,2513141,29083371
Slovakia,2021-04-21,31823684,31823684,227172,https://korona.gov.sk/,2520570,29303114,7429,219743,0.9672979064321308,7429,219743,2520570,29303114
Slovakia,2021-04-22,31977104,31977104,153420,https://korona.gov.sk/,2527366,29449738,6796,146624,0.9557032981358363,6796,146624,2527366,29449738
Slovakia,2021-04-23,32115483,32115483,138379,https://korona.gov.sk/,2533929,29581554,6563,131816,0.9525722833666959,6563,131816,2533929,29581554
Slovakia,2021-04-24,32432957,32432957,317474,https://korona.gov.sk/,2548241,29884716,14312,303162,0.9549191429849373,14312,303162,2548241,29884716
Slovakia,2021-04-25,32970534,32970534,537577,https://korona.gov.sk/,2578835,30391699,30594,506983,0.9430890830522883,30594,506983,2578835,30391699
Slovakia,2021-04-26,33356097,33356097,385563,https://korona.gov.sk/,2589457,30766640,10622,374941,0.972450676024411,10622,374941,2589457,30766640
Slovakia,2021-04-27,33687664,33687664,331567,https://korona.gov.sk/,2597742,31089922,8285,323282,0.975012591723543,8285,323282,2597742,31089922
Slovakia,2021-04-28,33838694,33838694,151030,https://korona.gov.sk/,2605250,31233444,7508,143522,0.9502880222472356,7508,143522,2605250,31233444
Slovakia,2021-04-29,33997566,33997566,158872,https://korona.gov.sk/,2611807,31385759,6557,152315,0.958727780855028,6557,152315,2611807,31385759
Slovakia,2021-04-30,34163391,34163391,165825,https://korona.gov.sk/,2620819,31542572,9012,156813,0.9456535504296698,9012,156813,2620819,31542572
Slovakia,2021-05-01,34435551,34435551,272160,https://korona.gov.sk/,2629250,31806301,8431,263729,0.96902189888301,8431,263729,2629250,31806301
Slovakia,2021-05-02,34829241,34829241,393690,https://korona.gov.sk/,2664217,32165024,34967,358723,0.9111813863699866,34967,358723,2664217,32165024
Slovakia,2021-05-03,35107484,35107484,278243,https://korona.gov.sk/,2676393,32431091,12176,266067,0.9562396897675772,12176,266067,2676393,32431091
Slovakia,2021-05-04,35345283,35345283,237799,https://korona.gov.sk/,2683618,32661665,7225,230574,0.9696171977174,7225,230574,2683618,32661665
Slovakia,2021-05-05,35484585,35484585,139302,https://korona.gov.sk/,2691638,32792947,8020,131282,0.942427244404244,8020,131282,2691638,32792947
Slovakia,2021-05-06,35586326,35586326,101741,https://korona.gov.sk/,2697906,32888420,6268,95473,0.9383925850935217,6268,95473,2697906,32888420
Slovakia,2021-05-07,35687155,35687155,100829,https://korona.gov.sk/,2704901,32982254,6995,93834,0.9306251177736564,6995,93834,2704901,32982254
Slovakia,2021-05-08,35854003,35854003,166848,https://korona.gov.sk/,2717033,33136970,12132,154716,0.9272871116225546,12132,154716,2717033,33136970
Slovakia,2021-05-09,36011159,36011159,157156,https://korona.gov.sk/,2720699,33290460,3666,153490,0.9766728600880653,3666,153490,2720699,33290460
Slovakia,2021-05-10,36172666,36172666,161507,https://korona.gov.sk/,2726117,33446549,5418,156089,0.9664534664132205,5418,156089,2726117,33446549
Slovakia,2021-05-11,36355448,36355448,182782,https://korona.gov.sk/,2734112,33621336,7995,174787,0.9562593690844832,7995,174787,2734112,33621336
Slovakia,2021-05-12,36463030,36463030,107582,https://korona.gov.sk/,2740888,33722142,6776,100806,0.9370154858619472,6776,100806,2740888,33722142
Slovakia,2021-05-13,36571318,36571318,108288,https://korona.gov.sk/,2745856,33825462,4968,103320,0.9541223404255319,4968,103320,2745856,33825462
Slovakia,2021-05-14,36661382,36661382,90064,https://korona.gov.sk/,2752948,33908434,7092,82972,0.9212559957363653,7092,82972,2752948,33908434
Slovakia,2021-05-15,36800878,36800878,139496,https://korona.gov.sk/,2759676,34041202,6728,132768,0.9517692263577451,6728,132768,2759676,34041202
Slovakia,2021-05-16,36952728,36952728,151850,https://korona.gov.sk/,2762414,34190314,2738,149112,0.9819690484030293,2738,149112,2762414,34190314
Slovakia,2021-05-17,37083843,37083843,131115,https://korona.gov.sk/,2765568,34318275,3154,127961,0.9759447812988598,3154,127961,2765568,34318275
Slovakia,2021-05-18,37250140,37250140,166297,https://korona.gov.sk/,2772844,34477296,7276,159021,0.9562469557478487,7276,159021,2772844,34477296
Slovakia,2021-05-19,37342875,37342875,92735,https://korona.gov.sk/,2778680,34564195,5836,86899,0.9370679894322532,5836,86899,2778680,34564195
Slovakia,2021-05-20,37430864,37430864,87989,https://korona.gov.sk/,2784277,34646587,5597,82392,0.9363897759947266,5597,82392,2784277,34646587
Slovakia,2021-05-21,37503734,37503734,72870,https://korona.gov.sk/,2788281,34715453,4004,68866,0.9450528338136407,4004,68866,2788281,34715453
Slovakia,2021-05-22,37609448,37609448,105714,https://korona.gov.sk/,2793952,34815496,5671,100043,0.9463552604196227,5671,100043,2793952,34815496
Slovakia,2021-05-23,37707686,37707686,98238,https://korona.gov.sk/,2798074,34909612,4122,94116,0.9580406767238747,4122,94116,2798074,34909612
Slovakia,2021-05-24,37810468,37810468,102782,https://korona.gov.sk/,2799241,35011227,1167,101615,0.9886458718452648,1167,101615,2799241,35011227
Slovakia,2021-05-25,37922632,37922632,112164,https://korona.gov.sk/,2805853,35116779,6612,105552,0.9410506044720232,6612,105552,2805853,35116779
Slovakia,2021-05-26,38002260,38002260,79628,https://korona.gov.sk/,2812008,35190252,6155,73473,0.9227030692721153,6155,73473,2812008,35190252
Slovakia,2021-05-27,38075805,38075805,73545,https://korona.gov.sk/,2816985,35258820,4977,68568,0.9323271466449112,4977,68568,2816985,35258820
Slovakia,2021-05-28,38137735,38137735,61930,https://korona.gov.sk/,2821167,35316568,4182,57748,0.9324721459712578,4182,57748,2821167,35316568
Slovakia,2021-05-29,38137735,38137735,0,https://korona.gov.sk/,2821167,35316568,0,0,0.9324721459712578,0,0,2821167,35316568
Slovakia,2021-05-30,38313469,38313469,175734,https://korona.gov.sk/,2829751,35483718,8584,167150,0.951153447824553,8584,167150,2829751,35483718
Slovakia,2021-05-31,38389363,38389363,75894,https://korona.gov.sk/,2831060,35558303,1309,74585,0.982752259730677,1309,74585,2831060,35558303
Slovakia,2021-06-01,38478578,38478578,89215,https://korona.gov.sk/,2838146,35640432,7086,82129,0.9205738945244634,7086,82129,2838146,35640432
Slovakia,2021-06-02,38540820,38540820,62242,https://korona.gov.sk/,2843402,35697418,5256,56986,0.9155554127438065,5256,56986,2843402,35697418
Slovakia,2021-06-03,38595394,38595394,54574,https://korona.gov.sk/,2848668,35746726,5266,49308,0.9035071645838678,5266,49308,2848668,35746726
Slovakia,2021-06-04,38652398,38652398,57004,https://korona.gov.sk/,2854008,35798390,5340,51664,0.9063223633429233,5340,51664,2854008,35798390
Slovakia,2021-06-05,38728884,38728884,76486,https://korona.gov.sk/,2859556,35869328,5548,70938,0.9274638495933897,5548,70938,2859556,35869328
Slovakia,2021-06-06,38792441,38792441,63557,https://korona.gov.sk/,2862336,35930105,2780,60777,0.956259735355665,2780,60777,2862336,35930105
Slovakia,2021-06-07,38857279,38857279,64838,https://korona.gov.sk/,2863317,35993962,981,63857,0.9848699836515623,981,63857,2863317,35993962
Slovakia,2021-06-08,38925577,38925577,68298,https://korona.gov.sk/,2869093,36056484,5776,62522,0.9154294415649067,5776,62522,2869093,36056484
Slovakia,2021-06-09,38982445,38982445,56868,https://korona.gov.sk/,2875030,36107415,5937,50931,0.8956003376239713,5937,50931,2875030,36107415
Slovakia,2021-06-10,39044130,39044130,61685,https://korona.gov.sk/,2879548,36164582,4518,57167,0.9267569101078058,4518,57167,2879548,36164582
Slovakia,2021-06-11,39080975,39080975,36845,https://korona.gov.sk/,2883850,36197125,4302,32543,0.8832406025240874,4302,32543,2883850,36197125
Slovakia,2021-06-12,39154068,39154068,73093,https://korona.gov.sk/,2889713,36264355,5863,67230,0.9197871205176966,5863,67230,2889713,36264355
Slovakia,2021-06-13,39212294,39212294,58226,https://korona.gov.sk/,2892229,36320065,2516,55710,0.9567890633050528,2516,55710,2892229,36320065
Slovakia,2021-06-14,39264330,39264330,52036,https://korona.gov.sk/,2893322,36371008,1093,50943,0.9789953109385809,1093,50943,2893322,36371008
Slovakia,2021-06-15,39331415,39331415,67085,https://korona.gov.sk/,2899336,36432079,6014,61071,0.9103525378251472,6014,61071,2899336,36432079
Slovakia,2021-06-16,39381244,39381244,49829,https://korona.gov.sk/,2903570,36477674,4234,45595,0.9150294005498806,4234,45595,2903570,36477674
Slovakia,2021-06-17,39431800,39431800,50556,https://korona.gov.sk/,2907942,36523858,4372,46184,0.9135216393702034,4372,46184,2907942,36523858
Slovakia,2021-06-18,39476574,39476574,44774,https://korona.gov.sk/,2911736,36564838,3794,40980,0.9152633224639299,3794,40980,2911736,36564838
Slovakia,2021-06-19,39476574,39476574,0,https://korona.gov.sk/,2911736,36564838,0,0,0.9152633224639299,0,0,2911736,36564838
Slovakia,2021-06-20,39476574,39476574,0,https://korona.gov.sk/,2911736,36564838,0,0,0.9152633224639299,0,0,2911736,36564838
Slovakia,2021-06-21,39628152,39628152,151578,https://korona.gov.sk/,2920840,36707312,9104,142474,0.9399385135045983,9104,142474,2920840,36707312
Slovakia,2021-06-22,39692928,39692928,64776,https://korona.gov.sk/,2926911,36766017,6071,58705,0.9062770161788317,6071,58705,2926911,36766017
Slovakia,2021-06-23,39728631,39728631,35703,https://korona.gov.sk/,2931288,36797343,4377,31326,0.8774052600621797,4377,31326,2931288,36797343
Slovakia,2021-06-24,39773159,39773159,44528,https://korona.gov.sk/,2935496,36837663,4208,40320,0.905497664390945,4208,40320,2935496,36837663
Slovakia,2021-06-25,39815370,39815370,42211,https://korona.gov.sk/,2938855,36876515,3359,38852,0.920423586268982,3359,38852,2938855,36876515
Slovakia,2021-06-26,39865966,39865966,50596,https://korona.gov.sk/,2944540,36921426,5685,44911,0.887639339078188,5685,44911,2944540,36921426
Slovakia,2021-06-27,39901442,39901442,35476,https://korona.gov.sk/,2947093,36954349,2553,32923,0.9280358552260684,2553,32923,2947093,36954349
Slovakia,2021-06-28,39937111,39937111,35669,https://korona.gov.sk/,2947897,36989214,804,34865,0.9774594185427121,804,34865,2947897,36989214
Slovakia,2021-06-29,39993348,39993348,56237,https://korona.gov.sk/,2953485,37039863,5588,50649,0.900634813379092,5588,50649,2953485,37039863
Slovakia,2021-06-30,40001259,40001259,7911,https://korona.gov.sk/,2959472,36950978,5987,-88885,0.900634813379092,786,7125,2954271,37046988
Slovakia,2021-07-01,40104232,40104232,102973,https://korona.gov.sk/,2964856,37139376,5384,188398,0.9722162017112013,2861,100112,2957132,37147100
Slovakia,2021-07-02,40127098,40127098,22866,https://korona.gov.sk/,2970298,37156800,5442,17424,0.7620047231697717,5442,17424,2962574,37164524
Slovakia,2021-07-03,40152642,40152642,25544,https://korona.gov.sk/,2978570,37174072,8272,17272,0.6761666144691513,8272,17272,2970846,37181796
Slovakia,2021-07-04,40152642,40152642,0,https://korona.gov.sk/,2978570,37174072,0,0,0.6761666144691513,0,0,2970846,37181796
Slovakia,2021-07-05,40175589,40175589,22947,https://korona.gov.sk/,2984432,37191157,5862,17085,0.7445417701660347,5862,17085,2976708,37198881
Slovakia,2021-07-06,40186557,40186557,10968,https://korona.gov.sk/,2987321,37199236,2889,8079,0.736597374179431,2889,8079,2979597,37206960
Slovakia,2021-07-07,40204368,40204368,17811,https://korona.gov.sk/,2992958,37211410,5637,12174,0.6835101903318174,5637,12174,2985234,37219134
Slovakia,2021-07-08,40226869,40226869,22501,https://korona.gov.sk/,2998203,37228666,5245,17256,0.7668992489222701,5245,17256,2990479,37236390
Slovakia,2021-07-09,40240845,40240845,13976,https://korona.gov.sk/,3003874,37236971,5671,8305,0.5942329708070979,5671,8305,2996150,37244695
Slovakia,2021-07-10,40264898,40264898,24053,https://korona.gov.sk/,3012777,37252121,8903,15150,0.6298590612397622,8903,15150,3005053,37259845
Slovakia,2021-07-11,40277200,40277200,12302,https://korona.gov.sk/,3017476,37259724,4699,7603,0.6180295886847667,4699,7603,3009752,37267448
Slovakia,2021-07-12,40283769,40283769,6569,https://korona.gov.sk/,3018508,37265261,1032,5537,0.8428984624752626,1032,5537,3010784,37272985
Slovakia,2021-07-13,40304576,40304576,20807,https://korona.gov.sk/,3025036,37279540,6528,14279,0.6862594319219494,6528,14279,3017312,37287264
Slovakia,2021-07-14,40335429,40335429,30853,https://korona.gov.sk/,3029733,37305696,4697,26156,0.8477619680420057,4697,26156,3022009,37313420
Slovakia,2021-07-15,40353798,40353798,18369,https://korona.gov.sk/,3035642,37318156,5909,12460,0.6783167292721433,5909,12460,3027918,37325880
Slovakia,2021-07-16,40381111,40381111,27313,https://korona.gov.sk/,3041797,37339314,6155,21158,0.7746494343352982,6155,21158,3034073,37347038
Slovakia,2021-07-17,40381111,40381111,0,https://korona.gov.sk/,3041797,37339314,0,0,0.7746494343352982,0,0,3034073,37347038
Slovakia,2021-07-18,40420801,40420801,39690,https://korona.gov.sk/,3057456,37363345,15659,24031,0.6054673721340388,15659,24031,3049732,37371069
Slovakia,2021-07-19,40428275,40428275,7474,https://korona.gov.sk/,3058624,37369651,1168,6306,0.8437249130318437,1168,6306,3050900,37377375
Slovakia,2021-07-20,40444845,40444845,16570,https://korona.gov.sk/,3066516,37378329,7892,8678,0.5237175618587809,7892,8678,3058792,37386053
Slovakia,2021-07-21,40464169,40464169,19324,https://korona.gov.sk/,3073119,37391050,6603,12721,0.6583005588904989,6603,12721,3065395,37398774
Slovakia,2021-07-22,40482194,40482194,18025,https://korona.gov.sk/,3079898,37402296,6779,11246,0.6239112343966713,6779,11246,3072174,37410020
Slovakia,2021-07-23,40497380,40497380,15186,https://korona.gov.sk/,3087364,37410016,7466,7720,0.5083629658896351,7466,7720,3079640,37417740
Slovakia,2021-07-24,40497380,40497380,0,https://korona.gov.sk/,3087364,37410016,0,0,0.5083629658896351,0,0,3079640,37417740
Slovakia,2021-07-25,40530199,40530199,32819,https://korona.gov.sk/,3103738,37426461,16374,16445,0.5010816904841707,16374,16445,3096014,37434185
Slovakia,2021-07-26,40537640,40537640,7441,https://korona.gov.sk/,3105170,37432470,1432,6009,0.8075527482865207,1432,6009,3097446,37440194
Slovakia,2021-07-27,40557527,40557527,19887,https://korona.gov.sk/,3113864,37443663,8694,11193,0.5628299894403379,8694,11193,3106140,37451387
Slovakia,2021-07-28,40574694,40574694,17167,https://korona.gov.sk/,3121263,37453431,7399,9768,0.5689986602201899,7399,9768,3113539,37461155
Slovakia,2021-07-29,40602085,40602085,27391,https://korona.gov.sk/,3128228,37473857,6965,20426,0.7457193968821876,6965,20426,3120504,37481581
Slovakia,2021-07-30,40617495,40617495,15410,https://korona.gov.sk/,3135516,37481979,7288,8122,0.527060350421804,7288,8122,3127792,37489703
Slovakia,2021-07-31,40645638,40645638,28143,https://korona.gov.sk/,3145755,37499883,10239,17904,0.636179511779128,10239,17904,3138031,37507607
Slovakia,2021-08-01,40657698,40657698,12060,https://korona.gov.sk/,3151619,37506079,5864,6196,0.5137645107794362,5864,6196,3143895,37513803
Slovakia,2021-08-02,40666899,40660666,2968,https://korona.gov.sk/,3152824,37514075,1205,7996,0.8690359743506141,389,2579,3144284,37516382
Slovakia,2021-08-03,40684229,40660666,0,https://korona.gov.sk/,3160527,37523702,7703,9627,0.5555106751298327,0,0,3144284,37516382
Slovakia,2021-08-04,40701037,40660666,0,https://korona.gov.sk/,3167445,37533592,6918,9890,0.5884102808186578,0,0,3144284,37516382
Slovakia,2021-08-05,40660666,40660666,0,https://korona.gov.sk/,3173282,37487384,5837,-46208,0.5884102808186578,0,0,3144284,37516382
Slovakia,2021-08-06,40660666,40660666,0,https://korona.gov.sk/,3173282,37487384,0,0,0.5884102808186578,0,0,3144284,37516382
Slovakia,2021-08-07,40694176,40694176,33510,https://korona.gov.sk/,3190859,37503317,17577,15933,0.4754700089525515,17577,15933,3161861,37532315
Slovakia,2021-08-08,40705258,40705258,11082,https://korona.gov.sk/,3195149,37510109,4290,6792,0.6128857606930157,4290,6792,3166151,37539107
Slovakia,2021-08-09,40714156,40714156,8898,https://korona.gov.sk/,3197030,37517126,1881,7017,0.7886041807147673,1881,7017,3168032,37546124
Slovakia,2021-08-10,40714156,40714156,0,https://korona.gov.sk/,3197030,37517126,0,0,0.7886041807147673,0,0,3168032,37546124
Slovakia,2021-08-11,40745303,40745303,31147,https://korona.gov.sk/,3210962,37534341,13932,17215,0.5527017048190837,13932,17215,3181964,37563339
Slovakia,2021-08-12,40760198,40760198,14895,https://korona.gov.sk/,3217620,37542578,6658,8237,0.5530043638804968,6658,8237,3188622,37571576
Slovakia,2021-08-13,40774223,40774223,14025,https://korona.gov.sk/,3223718,37550505,6098,7927,0.565204991087344,6098,7927,3194720,37579503
Slovakia,2021-08-14,40795137,40795137,20914,https://korona.gov.sk/,3232920,37562217,9202,11712,0.5600076503777374,9202,11712,3203922,37591215
Slovakia,2021-08-15,40807298,40807298,12161,https://korona.gov.sk/,3237612,37569686,4692,7469,0.6141764657511718,4692,7469,3208614,37598684
Slovakia,2021-08-16,40814685,40814685,7387,https://korona.gov.sk/,3238921,37575764,1309,6078,0.8227968051983213,1309,6078,3209923,37604762
Slovakia,2021-08-17,40836381,40836381,21696,https://korona.gov.sk/,3246178,37590203,7257,14439,0.6655143805309734,7257,14439,3217180,37619201
Slovakia,2021-08-18,40850847,40850847,14466,https://korona.gov.sk/,3252650,37598197,6472,7994,0.5526061108806858,6472,7994,3223652,37627195
Slovakia,2021-08-19,40867668,40867668,16821,https://korona.gov.sk/,3258782,37608886,6132,10689,0.6354556803995006,6132,10689,3229784,37637884
Slovakia,2021-08-20,40885691,40885691,18023,https://korona.gov.sk/,3264598,37621093,5816,12207,0.6773012262109527,5816,12207,3235600,37650091
Slovakia,2021-08-21,40907668,40907668,21977,https://korona.gov.sk/,3272082,37635586,7484,14493,0.6594621649906721,7484,14493,3243084,37664584
Slovakia,2021-08-22,40920284,40920284,12616,https://korona.gov.sk/,3276924,37643360,4842,7774,0.6162016487000634,4842,7774,3247926,37672358
Slovakia,2021-08-23,40932178,40932178,11894,https://korona.gov.sk/,3277867,37654311,943,10951,0.9207163275601143,943,10951,3248869,37683309
Slovakia,2021-08-24,40954512,40954512,22334,https://korona.gov.sk/,3285445,37669067,7578,14756,0.6606966956210263,7578,14756,3256447,37698065
Slovakia,2021-08-25,40971897,40971897,17385,https://korona.gov.sk/,3290825,37681072,5380,12005,0.6905378199597354,5380,12005,3261827,37710070
Slovakia,2021-08-26,40990718,40990718,18821,https://korona.gov.sk/,3296756,37693962,5931,12890,0.6848732798469794,5931,12890,3267758,37722960
Slovakia,2021-08-27,41008296,41008296,17578,https://korona.gov.sk/,3301773,37706523,5017,12561,0.7145864148367277,5017,12561,3272775,37735521
Slovakia,2021-08-28,41028838,41028838,20542,https://korona.gov.sk/,3308315,37720523,6542,14000,0.6815305228312725,6542,14000,3279317,37749521
Slovakia,2021-08-29,41040634,41040634,11796,https://korona.gov.sk/,3311147,37729487,2832,8964,0.7599186164801628,2832,8964,3282149,37758485
Slovakia,2021-08-30,41049134,41049134,8500,https://korona.gov.sk/,3312632,37736502,1485,7015,0.8252941176470588,1485,7015,3283634,37765500
Slovakia,2021-08-31,41071153,41071153,22019,https://korona.gov.sk/,3319411,37751742,6779,15240,0.6921295245015668,6779,15240,3290413,37780740
Slovakia,2021-09-01,41094226,41094226,23073,https://korona.gov.sk/,3325957,37768269,6546,16527,0.7162917696008322,6546,16527,3296959,37797267
Slovakia,2021-09-02,41103881,41103881,9655,https://korona.gov.sk/,3329425,37774456,3468,6187,0.6408078715691352,3468,6187,3300427,37803454
Slovakia,2021-09-03,41123343,41123343,19462,https://korona.gov.sk/,3336980,37786363,7555,11907,0.6118076251156099,7555,11907,3307982,37815361
Slovakia,2021-09-04,41150701,41150701,27358,https://korona.gov.sk/,3348585,37802116,11605,15753,0.575809635207252,11605,15753,3319587,37831114
Slovakia,2021-09-05,41180959,41180959,30258,https://korona.gov.sk/,3369619,37811340,21034,9224,0.3048449996695089,21034,9224,3340621,37840338
Slovakia,2021-09-06,41202098,41202098,21139,https://korona.gov.sk/,3383345,37818753,13726,7413,0.35067884005865935,13726,7413,3354347,37847751
Slovakia,2021-09-07,41229992,41229992,27894,https://korona.gov.sk/,3391458,37838534,8113,19781,0.7091489209148921,8113,19781,3362460,37867532
Slovakia,2021-09-08,41257139,41257139,27147,https://korona.gov.sk/,3400908,37856231,9450,17697,0.6518952370427672,9450,17697,3371910,37885229
Slovakia,2021-09-09,41305567,41305567,48428,https://korona.gov.sk/,3435134,37870433,34226,14202,0.2932600974642769,34226,14202,3406136,37899431
Slovakia,2021-09-10,41332507,41332507,26940,https://korona.gov.sk/,3441686,37890821,6552,20388,0.7567928730512249,6552,20388,3412688,37919819
Slovakia,2021-09-11,41360924,41360924,28417,https://korona.gov.sk/,3449759,37911165,8073,20344,0.7159094907977619,8073,20344,3420761,37940163
Slovakia,2021-09-12,41377317,41377317,16393,https://korona.gov.sk/,3454265,37923052,4506,11887,0.7251265784176173,4506,11887,3425267,37952050
Slovakia,2021-09-13,41388453,41388453,11136,https://korona.gov.sk/,3455704,37932749,1439,9697,0.8707794540229885,1439,9697,3426706,37961747
Slovakia,2021-09-14,41419897,41419897,31444,https://korona.gov.sk/,3463355,37956542,7651,23793,0.7566785396260017,7651,23793,3434357,37985540
Slovakia,2021-09-15,41453401,41453401,33504,https://korona.gov.sk/,3472283,37981118,8928,24576,0.7335243553008596,8928,24576,3443285,38010116
Slovakia,2021-09-16,41463871,41463871,10470,https://korona.gov.sk/,3476350,37987521,4067,6403,0.611556829035339,4067,6403,3447352,38016519
Slovakia,2021-09-17,41492980,41492980,29109,https://korona.gov.sk/,3485349,38007631,8999,20110,0.6908516266446804,8999,20110,3456351,38036629
Slovakia,2021-09-18,41529094,41529094,36114,https://korona.gov.sk/,3495433,38033661,10084,26030,0.7207731073821787,10084,26030,3466435,38062659
Slovakia,2021-09-19,41548409,41548409,19315,https://korona.gov.sk/,3502218,38046191,6785,12530,0.6487186124773492,6785,12530,3473220,38075189
Slovakia,2021-09-20,41565161,41565161,16752,https://korona.gov.sk/,3504199,38060962,1981,14771,0.8817454632282713,1981,14771,3475201,38089960
Slovakia,2021-09-21,41565161,41565161,0,https://korona.gov.sk/,3504199,38060962,0,0,0.8817454632282713,0,0,3475201,38089960
Slovakia,2021-09-22,41565161,41565161,0,https://korona.gov.sk/,3504199,38060962,0,0,0.8817454632282713,0,0,3475201,38089960
Slovakia,2021-09-23,41565161,41565161,0,https://korona.gov.sk/,3504199,38060962,0,0,0.8817454632282713,0,0,3475201,38089960
Slovakia,2021-09-24,41565161,41565161,0,https://korona.gov.sk/,3504199,38060962,0,0,0.8817454632282713,0,0,3475201,38089960
Slovakia,2021-09-25,41565161,41565161,0,https://korona.gov.sk/,3504199,38060962,0,0,0.8817454632282713,0,0,3475201,38089960
Slovakia,2021-09-26,41565161,41565161,0,https://korona.gov.sk/,3504199,38060962,0,0,0.8817454632282713,0,0,3475201,38089960
Slovakia,2021-09-27,41565161,41565161,0,https://korona.gov.sk/,3504199,38060962,0,0,0.8817454632282713,0,0,3475201,38089960
Slovakia,2021-09-28,41565161,41565161,0,https://korona.gov.sk/,3504199,38060962,0,0,0.8817454632282713,0,0,3475201,38089960
Slovakia,2021-09-29,41565161,41565161,0,https://korona.gov.sk/,3504199,38060962,0,0,0.8817454632282713,0,0,3475201,38089960
Slovakia,2021-09-30,41565161,41565161,0,https://korona.gov.sk/,3504199,38060962,0,0,0.8817454632282713,0,0,3475201,38089960
Slovakia,2021-10-01,41565161,41565161,0,https://korona.gov.sk/,3504199,38060962,0,0,0.8817454632282713,0,0,3475201,38089960
Slovakia,2021-10-02,41565161,41565161,0,https://korona.gov.sk/,3504199,38060962,0,0,0.8817454632282713,0,0,3475201,38089960
Slovakia,2021-10-03,41565161,41565161,0,https://korona.gov.sk/,3504199,38060962,0,0,0.8817454632282713,0,0,3475201,38089960
Slovakia,2021-10-04,41565161,41565161,0,https://korona.gov.sk/,3504199,38060962,0,0,0.8817454632282713,0,0,3475201,38089960
Slovakia,2021-10-05,41565161,41565161,0,https://korona.gov.sk/,3504199,38060962,0,0,0.8817454632282713,0,0,3475201,38089960
Slovakia,2021-10-06,41565161,41565161,0,https://korona.gov.sk/,3504199,38060962,0,0,0.8817454632282713,0,0,3475201,38089960
Slovakia,2021-10-07,41565161,41565161,0,https://korona.gov.sk/,3504199,38060962,0,0,0.8817454632282713,0,0,3475201,38089960
Slovakia,2021-10-08,41565161,41565161,0,https://korona.gov.sk/,3504199,38060962,0,0,0.8817454632282713,0,0,3475201,38089960
Slovakia,2021-10-09,41565161,41565161,0,https://korona.gov.sk/,3504199,38060962,0,0,0.8817454632282713,0,0,3475201,38089960
Slovakia,2021-10-10,41565161,41565161,0,https://korona.gov.sk/,3504199,38060962,0,0,0.8817454632282713,0,0,3475201,38089960
Slovakia,2021-10-11,41565161,41565161,0,https://korona.gov.sk/,3504199,38060962,0,0,0.8817454632282713,0,0,3475201,38089960
Slovakia,2021-10-12,41565161,41565161,0,https://korona.gov.sk/,3504199,38060962,0,0,0.8817454632282713,0,0,3475201,38089960
Slovakia,2021-10-13,41565161,41565161,0,https://korona.gov.sk/,3504199,38060962,0,0,0.8817454632282713,0,0,3475201,38089960
Slovakia,2021-10-14,41565161,41565161,0,https://korona.gov.sk/,3504199,38060962,0,0,0.8817454632282713,0,0,3475201,38089960
Slovakia,2021-10-15,41565161,41565161,0,https://korona.gov.sk/,3504199,38060962,0,0,0.8817454632282713,0,0,3475201,38089960
Slovakia,2021-10-16,41565161,41565161,0,https://korona.gov.sk/,3504199,38060962,0,0,0.8817454632282713,0,0,3475201,38089960
Slovakia,2021-10-17,41565161,41565161,0,https://korona.gov.sk/,3504199,38060962,0,0,0.8817454632282713,0,0,3475201,38089960
Slovakia,2021-10-18,41565161,41565161,0,https://korona.gov.sk/,3504199,38060962,0,0,0.8817454632282713,0,0,3475201,38089960
Slovakia,2021-10-19,41565161,41565161,0,https://korona.gov.sk/,3504199,38060962,0,0,0.8817454632282713,0,0,3475201,38089960
Slovakia,2021-10-20,41565161,41565161,0,https://korona.gov.sk/,3504199,38060962,0,0,0.8817454632282713,0,0,3475201,38089960
Slovakia,2021-10-21,41565161,41565161,0,https://korona.gov.sk/,3504199,38060962,0,0,0.8817454632282713,0,0,3475201,38089960
Slovakia,2021-10-22,41565161,41565161,0,https://korona.gov.sk/,3504199,38060962,0,0,0.8817454632282713,0,0,3475201,38089960
Slovakia,2021-10-23,41565161,41565161,0,https://korona.gov.sk/,3504199,38060962,0,0,0.8817454632282713,0,0,3475201,38089960
Slovakia,2021-10-24,41565161,41565161,0,https://korona.gov.sk/,3504199,38060962,0,0,0.8817454632282713,0,0,3475201,38089960
Slovakia,2021-10-25,41565161,41565161,0,https://korona.gov.sk/,3504199,38060962,0,0,0.8817454632282713,0,0,3475201,38089960
Slovakia,2021-10-26,41565161,41565161,0,https://korona.gov.sk/,3504199,38060962,0,0,0.8817454632282713,0,0,3475201,38089960
Slovakia,2021-10-27,41565161,41565161,0,https://korona.gov.sk/,3504199,38060962,0,0,0.8817454632282713,0,0,3475201,38089960
Slovakia,2021-10-28,41565161,41565161,0,https://korona.gov.sk/,3504199,38060962,0,0,0.8817454632282713,0,0,3475201,38089960
Slovakia,2021-10-29,41565161,41565161,0,https://korona.gov.sk/,3504199,38060962,0,0,0.8817454632282713,0,0,3475201,38089960
Slovakia,2021-10-30,41565161,41565161,0,https://korona.gov.sk/,3504199,38060962,0,0,0.8817454632282713,0,0,3475201,38089960
Slovakia,2021-10-31,41565161,41565161,0,https://korona.gov.sk/,3504199,38060962,0,0,0.8817454632282713,0,0,3475201,38089960
Slovakia,2021-11-01,41565161,41565161,0,https://korona.gov.sk/,3504199,38060962,0,0,0.8817454632282713,0,0,3475201,38089960
Slovakia,2021-11-02,41565161,41565161,0,https://korona.gov.sk/,3504199,38060962,0,0,0.8817454632282713,0,0,3475201,38089960
Slovakia,2021-11-03,41565161,41565161,0,https://korona.gov.sk/,3504199,38060962,0,0,0.8817454632282713,0,0,3475201,38089960
Slovakia,2021-11-04,41565161,41565161,0,https://korona.gov.sk/,3504199,38060962,0,0,0.8817454632282713,0,0,3475201,38089960
Slovakia,2021-11-05,41565161,41565161,0,https://korona.gov.sk/,3504199,38060962,0,0,0.8817454632282713,0,0,3475201,38089960
Slovakia,2021-11-06,41565161,41565161,0,https://korona.gov.sk/,3504199,38060962,0,0,0.8817454632282713,0,0,3475201,38089960
Slovakia,2021-11-07,41565161,41565161,0,https://korona.gov.sk/,3504199,38060962,0,0,0.8817454632282713,0,0,3475201,38089960
Slovakia,2021-11-08,41565161,41565161,0,https://korona.gov.sk/,3504199,38060962,0,0,0.8817454632282713,0,0,3475201,38089960
Slovakia,2021-11-09,41565161,41565161,0,https://korona.gov.sk/,3504199,38060962,0,0,0.8817454632282713,0,0,3475201,38089960
Slovakia,2021-11-10,41565161,41565161,0,https://korona.gov.sk/,3504199,38060962,0,0,0.8817454632282713,0,0,3475201,38089960
Slovakia,2021-11-11,41565161,41565161,0,https://korona.gov.sk/,3504199,38060962,0,0,0.8817454632282713,0,0,3475201,38089960
Slovakia,2021-11-12,41565161,41565161,0,https://korona.gov.sk/,3504199,38060962,0,0,0.8817454632282713,0,0,3475201,38089960
Slovakia,2021-11-13,41565161,41565161,0,https://korona.gov.sk/,3504199,38060962,0,0,0.8817454632282713,0,0,3475201,38089960
Slovakia,2021-11-14,41565161,41565161,0,https://korona.gov.sk/,3504199,38060962,0,0,0.8817454632282713,0,0,3475201,38089960
Slovakia,2021-11-15,41565161,41565161,0,https://korona.gov.sk/,3504199,38060962,0,0,0.8817454632282713,0,0,3475201,38089960
Slovakia,2021-11-16,41565161,41565161,0,https://korona.gov.sk/,3504199,38060962,0,0,0.8817454632282713,0,0,3475201,38089960
Slovakia,2021-11-17,41565161,41565161,0,https://korona.gov.sk/,3504199,38060962,0,0,0.8817454632282713,0,0,3475201,38089960
Slovakia,2021-11-18,41565161,41565161,0,https://korona.gov.sk/,3504199,38060962,0,0,0.8817454632282713,0,0,3475201,38089960
Slovakia,2021-11-19,41565161,41565161,0,https://korona.gov.sk/,3504199,38060962,0,0,0.8817454632282713,0,0,3475201,38089960
Slovakia,2021-11-20,41565161,41565161,0,https://korona.gov.sk/,3504199,38060962,0,0,0.8817454632282713,0,0,3475201,38089960
Slovakia,2021-11-21,41565161,41565161,0,https://korona.gov.sk/,3504199,38060962,0,0,0.8817454632282713,0,0,3475201,38089960
Slovakia,2021-11-22,41565161,41565161,0,https://korona.gov.sk/,3504199,38060962,0,0,0.8817454632282713,0,0,3475201,38089960
Slovakia,2021-11-23,41565161,41565161,0,https://korona.gov.sk/,3504199,38060962,0,0,0.8817454632282713,0,0,3475201,38089960
Slovakia,2021-11-24,41565161,41565161,0,https://korona.gov.sk/,3504199,38060962,0,0,0.8817454632282713,0,0,3475201,38089960
Slovakia,2021-11-25,41565161,41565161,0,https://korona.gov.sk/,3504199,38060962,0,0,0.8817454632282713,0,0,3475201,38089960
Slovakia,2021-11-26,41565161,41565161,0,https://korona.gov.sk/,3504199,38060962,0,0,0.8817454632282713,0,0,3475201,38089960
Slovakia,2021-11-27,41565161,41565161,0,https://korona.gov.sk/,3504199,38060962,0,0,0.8817454632282713,0,0,3475201,38089960
Slovakia,2021-11-28,41565161,41565161,0,https://korona.gov.sk/,3504199,38060962,0,0,0.8817454632282713,0,0,3475201,38089960
Slovakia,2021-11-29,41565161,41565161,0,https://korona.gov.sk/,3504199,38060962,0,0,0.8817454632282713,0,0,3475201,38089960
Slovakia,2021-11-30,41565161,41565161,0,https://korona.gov.sk/,3504199,38060962,0,0,0.8817454632282713,0,0,3475201,38089960
Slovakia,2021-12-01,41565161,41565161,0,https://korona.gov.sk/,3504199,38060962,0,0,0.8817454632282713,0,0,3475201,38089960
Slovakia,2021-12-02,41565161,41565161,0,https://korona.gov.sk/,3504199,38060962,0,0,0.8817454632282713,0,0,3475201,38089960
Slovakia,2021-12-03,41565161,41565161,0,https://korona.gov.sk/,3504199,38060962,0,0,0.8817454632282713,0,0,3475201,38089960
Slovakia,2021-12-04,41565161,41565161,0,https://korona.gov.sk/,3504199,38060962,0,0,0.8817454632282713,0,0,3475201,38089960
Slovakia,2021-12-05,41565161,41565161,0,https://korona.gov.sk/,3504199,38060962,0,0,0.8817454632282713,0,0,3475201,38089960
Slovakia,2021-12-06,41565161,41565161,0,https://korona.gov.sk/,3504199,38060962,0,0,0.8817454632282713,0,0,3475201,38089960
Slovakia,2021-12-07,41565161,41565161,0,https://korona.gov.sk/,3504199,38060962,0,0,0.8817454632282713,0,0,3475201,38089960
Slovakia,2021-12-08,41565161,41565161,0,https://korona.gov.sk/,3504199,38060962,0,0,0.8817454632282713,0,0,3475201,38089960
Slovakia,2021-12-09,41565161,41565161,0,https://korona.gov.sk/,3504199,38060962,0,0,0.8817454632282713,0,0,3475201,38089960
Slovakia,2021-12-10,41565161,41565161,0,https://korona.gov.sk/,3504199,38060962,0,0,0.8817454632282713,0,0,3475201,38089960
Slovakia,2021-12-11,41565161,41565161,0,https://korona.gov.sk/,3504199,38060962,0,0,0.8817454632282713,0,0,3475201,38089960
Slovakia,2021-12-12,41565161,41565161,0,https://korona.gov.sk/,3504199,38060962,0,0,0.8817454632282713,0,0,3475201,38089960
Slovakia,2021-12-13,41565161,41565161,0,https://korona.gov.sk/,3504199,38060962,0,0,0.8817454632282713,0,0,3475201,38089960
Slovakia,2021-12-14,41565161,41565161,0,https://korona.gov.sk/,3504199,38060962,0,0,0.8817454632282713,0,0,3475201,38089960
Slovakia,2021-12-15,41565161,41565161,0,https://korona.gov.sk/,3504199,38060962,0,0,0.8817454632282713,0,0,3475201,38089960
Slovakia,2021-12-16,41565161,41565161,0,https://korona.gov.sk/,3504199,38060962,0,0,0.8817454632282713,0,0,3475201,38089960
Slovakia,2021-12-17,41565161,41565161,0,https://korona.gov.sk/,3504199,38060962,0,0,0.8817454632282713,0,0,3475201,38089960
Slovakia,2021-12-18,41565161,41565161,0,https://korona.gov.sk/,3504199,38060962,0,0,0.8817454632282713,0,0,3475201,38089960
Slovakia,2021-12-19,41565161,41565161,0,https://korona.gov.sk/,3504199,38060962,0,0,0.8817454632282713,0,0,3475201,38089960
Slovakia,2021-12-20,41565161,41565161,0,https://korona.gov.sk/,3504199,38060962,0,0,0.8817454632282713,0,0,3475201,38089960
Slovakia,2021-12-21,41565161,41565161,0,https://korona.gov.sk/,3504199,38060962,0,0,0.8817454632282713,0,0,3475201,38089960
Slovakia,2021-12-22,41565161,41565161,0,https://korona.gov.sk/,3504199,38060962,0,0,0.8817454632282713,0,0,3475201,38089960
Slovakia,2021-12-23,41565161,41565161,0,https://korona.gov.sk/,3504199,38060962,0,0,0.8817454632282713,0,0,3475201,38089960
Slovakia,2021-12-24,41565161,41565161,0,https://korona.gov.sk/,3504199,38060962,0,0,0.8817454632282713,0,0,3475201,38089960
Slovakia,2021-12-25,41565161,41565161,0,https://korona.gov.sk/,3504199,38060962,0,0,0.8817454632282713,0,0,3475201,38089960
Slovakia,2021-12-26,41565161,41565161,0,https://korona.gov.sk/,3504199,38060962,0,0,0.8817454632282713,0,0,3475201,38089960
Slovakia,2021-12-27,41565161,41565161,0,https://korona.gov.sk/,3504199,38060962,0,0,0.8817454632282713,0,0,3475201,38089960
Slovakia,2021-12-28,41565161,41565161,0,https://korona.gov.sk/,3504199,38060962,0,0,0.8817454632282713,0,0,3475201,38089960
Slovakia,2021-12-29,41565161,41565161,0,https://korona.gov.sk/,3504199,38060962,0,0,0.8817454632282713,0,0,3475201,38089960
Slovakia,2021-12-30,41565161,41565161,0,https://korona.gov.sk/,3504199,38060962,0,0,0.8817454632282713,0,0,3475201,38089960
Slovakia,2021-12-31,41565161,41565161,0,https://korona.gov.sk/,3504199,38060962,0,0,0.8817454632282713,0,0,3475201,38089960
Slovakia,2022-01-01,41565161,41565161,0,https://korona.gov.sk/,3504199,38060962,0,0,0.8817454632282713,0,0,3475201,38089960
Slovakia,2022-01-02,41565161,41565161,0,https://korona.gov.sk/,3504199,38060962,0,0,0.8817454632282713,0,0,3475201,38089960
Slovakia,2022-01-03,41565161,41565161,0,https://korona.gov.sk/,3504199,38060962,0,0,0.8817454632282713,0,0,3475201,38089960
Slovakia,2022-01-04,41565161,41565161,0,https://korona.gov.sk/,3504199,38060962,0,0,0.8817454632282713,0,0,3475201,38089960
Slovakia,2022-01-05,41565161,41565161,0,https://korona.gov.sk/,3504199,38060962,0,0,0.8817454632282713,0,0,3475201,38089960
Slovakia,2022-01-06,41565161,41565161,0,https://korona.gov.sk/,3504199,38060962,0,0,0.8817454632282713,0,0,3475201,38089960
Slovakia,2022-01-07,41565161,41565161,0,https://korona.gov.sk/,3504199,38060962,0,0,0.8817454632282713,0,0,3475201,38089960
Slovakia,2022-01-08,41565161,41565161,0,https://korona.gov.sk/,3504199,38060962,0,0,0.8817454632282713,0,0,3475201,38089960
Slovakia,2022-01-09,41565161,41565161,0,https://korona.gov.sk/,3504199,38060962,0,0,0.8817454632282713,0,0,3475201,38089960
Slovakia,2022-01-10,41565161,41565161,0,https://korona.gov.sk/,3504199,38060962,0,0,0.8817454632282713,0,0,3475201,38089960
Slovakia,2022-01-11,41565161,41565161,0,https://korona.gov.sk/,3504199,38060962,0,0,0.8817454632282713,0,0,3475201,38089960
Slovakia,2022-01-12,41565161,41565161,0,https://korona.gov.sk/,3504199,38060962,0,0,0.8817454632282713,0,0,3475201,38089960
Slovakia,2022-01-13,41565161,41565161,0,https://korona.gov.sk/,3504199,38060962,0,0,0.8817454632282713,0,0,3475201,38089960
Slovakia,2022-01-14,41565161,41565161,0,https://korona.gov.sk/,3504199,38060962,0,0,0.8817454632282713,0,0,3475201,38089960
Slovakia,2022-01-15,41565161,41565161,0,https://korona.gov.sk/,3504199,38060962,0,0,0.8817454632282713,0,0,3475201,38089960
Slovakia,2022-01-16,41565161,41565161,0,https://korona.gov.sk/,3504199,38060962,0,0,0.8817454632282713,0,0,3475201,38089960
Slovakia,2022-01-17,41565161,41565161,0,https://korona.gov.sk/,3504199,38060962,0,0,0.8817454632282713,0,0,3475201,38089960
Slovakia,2022-01-18,41565161,41565161,0,https://korona.gov.sk/,3504199,38060962,0,0,0.8817454632282713,0,0,3475201,38089960
Slovakia,2022-01-19,41565161,41565161,0,https://korona.gov.sk/,3504199,38060962,0,0,0.8817454632282713,0,0,3475201,38089960
Slovakia,2022-01-20,41565161,41565161,0,https://korona.gov.sk/,3504199,38060962,0,0,0.8817454632282713,0,0,3475201,38089960
Slovakia,2022-01-21,41565161,41565161,0,https://korona.gov.sk/,3504199,38060962,0,0,0.8817454632282713,0,0,3475201,38089960
Slovakia,2022-01-22,41565161,41565161,0,https://korona.gov.sk/,3504199,38060962,0,0,0.8817454632282713,0,0,3475201,38089960
Slovakia,2022-01-23,41565161,41565161,0,https://korona.gov.sk/,3504199,38060962,0,0,0.8817454632282713,0,0,3475201,38089960
Slovakia,2022-01-24,41565161,41565161,0,https://korona.gov.sk/,3504199,38060962,0,0,0.8817454632282713,0,0,3475201,38089960
Slovakia,2022-01-25,41565161,41565161,0,https://korona.gov.sk/,3504199,38060962,0,0,0.8817454632282713,0,0,3475201,38089960
Slovakia,2022-01-26,41565161,41565161,0,https://korona.gov.sk/,3504199,38060962,0,0,0.8817454632282713,0,0,3475201,38089960
Slovakia,2022-01-27,41565161,41565161,0,https://korona.gov.sk/,3504199,38060962,0,0,0.8817454632282713,0,0,3475201,38089960
Slovakia,2022-01-28,41565161,41565161,0,https://korona.gov.sk/,3504199,38060962,0,0,0.8817454632282713,0,0,3475201,38089960
Slovakia,2022-01-29,41565161,41565161,0,https://korona.gov.sk/,3504199,38060962,0,0,0.8817454632282713,0,0,3475201,38089960
Slovakia,2022-01-30,41565161,41565161,0,https://korona.gov.sk/,3504199,38060962,0,0,0.8817454632282713,0,0,3475201,38089960
Slovakia,2022-01-31,41565161,41565161,0,https://korona.gov.sk/,3504199,38060962,0,0,0.8817454632282713,0,0,3475201,38089960
Slovakia,2022-02-01,41565161,41565161,0,https://korona.gov.sk/,3504199,38060962,0,0,0.8817454632282713,0,0,3475201,38089960
Slovakia,2022-02-02,41565161,41565161,0,https://korona.gov.sk/,3504199,38060962,0,0,0.8817454632282713,0,0,3475201,38089960
Slovakia,2022-02-03,41565161,41565161,0,https://korona.gov.sk/,3504199,38060962,0,0,0.8817454632282713,0,0,3475201,38089960
Slovakia,2022-02-04,41565161,41565161,0,https://korona.gov.sk/,3504199,38060962,0,0,0.8817454632282713,0,0,3475201,38089960
Slovakia,2022-02-05,41565161,41565161,0,https://korona.gov.sk/,3504199,38060962,0,0,0.8817454632282713,0,0,3475201,38089960
Slovakia,2022-02-06,41565161,41565161,0,https://korona.gov.sk/,3504199,38060962,0,0,0.8817454632282713,0,0,3475201,38089960
Slovakia,2022-02-07,41565161,41565161,0,https://korona.gov.sk/,3504199,38060962,0,0,0.8817454632282713,0,0,3475201,38089960
Slovakia,2022-02-08,41565161,41565161,0,https://korona.gov.sk/,3504199,38060962,0,0,0.8817454632282713,0,0,3475201,38089960
Slovakia,2022-02-09,41565161,41565161,0,https://korona.gov.sk/,3504199,38060962,0,0,0.8817454632282713,0,0,3475201,38089960
Slovakia,2022-02-10,41565161,41565161,0,https://korona.gov.sk/,3504199,38060962,0,0,0.8817454632282713,0,0,3475201,38089960
Slovakia,2022-02-11,41565161,41565161,0,https://korona.gov.sk/,3504199,38060962,0,0,0.8817454632282713,0,0,3475201,38089960
Slovakia,2022-02-12,41565161,41565161,0,https://korona.gov.sk/,3504199,38060962,0,0,0.8817454632282713,0,0,3475201,38089960
Slovakia,2022-02-13,41565161,41565161,0,https://korona.gov.sk/,3504199,38060962,0,0,0.8817454632282713,0,0,3475201,38089960
Slovakia,2022-02-14,41565161,41565161,0,https://korona.gov.sk/,3504199,38060962,0,0,0.8817454632282713,0,0,3475201,38089960
Slovakia,2022-02-15,41565161,41565161,0,https://korona.gov.sk/,3504199,38060962,0,0,0.8817454632282713,0,0,3475201,38089960
Slovakia,2022-02-16,41565161,41565161,0,https://korona.gov.sk/,3504199,38060962,0,0,0.8817454632282713,0,0,3475201,38089960
Slovakia,2022-02-17,41565161,41565161,0,https://korona.gov.sk/,3504199,38060962,0,0,0.8817454632282713,0,0,3475201,38089960
Slovakia,2022-02-18,41565161,41565161,0,https://korona.gov.sk/,3504199,38060962,0,0,0.8817454632282713,0,0,3475201,38089960
Slovakia,2022-02-19,41565161,41565161,0,https://korona.gov.sk/,3504199,38060962,0,0,0.8817454632282713,0,0,3475201,38089960
Slovakia,2022-02-20,41565161,41565161,0,https://korona.gov.sk/,3504199,38060962,0,0,0.8817454632282713,0,0,3475201,38089960
Slovakia,2022-02-21,41565161,41565161,0,https://korona.gov.sk/,3504199,38060962,0,0,0.8817454632282713,0,0,3475201,38089960
Slovakia,2022-02-22,41565161,41565161,0,https://korona.gov.sk/,3504199,38060962,0,0,0.8817454632282713,0,0,3475201,38089960
Slovakia,2022-02-23,41565161,41565161,0,https://korona.gov.sk/,3504199,38060962,0,0,0.8817454632282713,0,0,3475201,38089960
Slovakia,2022-02-24,41565161,41565161,0,https://korona.gov.sk/,3504199,38060962,0,0,0.8817454632282713,0,0,3475201,38089960
Slovakia,2022-02-25,41565161,41565161,0,https://korona.gov.sk/,3504199,38060962,0,0,0.8817454632282713,0,0,3475201,38089960
Slovakia,2022-02-26,41565161,41565161,0,https://korona.gov.sk/,3504199,38060962,0,0,0.8817454632282713,0,0,3475201,38089960
Slovakia,2022-02-27,41565161,41565161,0,https://korona.gov.sk/,3504199,38060962,0,0,0.8817454632282713,0,0,3475201,38089960
Slovakia,2022-02-28,41565161,41565161,0,https://korona.gov.sk/,3504199,38060962,0,0,0.8817454632282713,0,0,3475201,38089960
Slovakia,2022-03-01,41565161,41565161,0,https://korona.gov.sk/,3504199,38060962,0,0,0.8817454632282713,0,0,3475201,38089960
Slovakia,2022-03-02,41565161,41565161,0,https://korona.gov.sk/,3504199,38060962,0,0,0.8817454632282713,0,0,3475201,38089960
Slovakia,2022-03-03,41565161,41565161,0,https://korona.gov.sk/,3504199,38060962,0,0,0.8817454632282713,0,0,3475201,38089960
Slovakia,2022-03-04,41565161,41565161,0,https://korona.gov.sk/,3504199,38060962,0,0,0.8817454632282713,0,0,3475201,38089960
Slovakia,2022-03-05,41565161,41565161,0,https://korona.gov.sk/,3504199,38060962,0,0,0.8817454632282713,0,0,3475201,38089960
Slovakia,2022-03-06,41565161,41565161,0,https://korona.gov.sk/,3504199,38060962,0,0,0.8817454632282713,0,0,3475201,38089960
Slovakia,2022-03-07,41565161,41565161,0,https://korona.gov.sk/,3504199,38060962,0,0,0.8817454632282713,0,0,3475201,38089960
Slovakia,2022-03-08,41565161,41565161,0,https://korona.gov.sk/,3504199,38060962,0,0,0.8817454632282713,0,0,3475201,38089960
Slovakia,2022-03-09,41565161,41565161,0,https://korona.gov.sk/,3504199,38060962,0,0,0.8817454632282713,0,0,3475201,38089960
Slovakia,2022-03-10,41565161,41565161,0,https://korona.gov.sk/,3504199,38060962,0,0,0.8817454632282713,0,0,3475201,38089960
Slovakia,2022-03-11,41565161,41565161,0,https://korona.gov.sk/,3504199,38060962,0,0,0.8817454632282713,0,0,3475201,38089960
Slovakia,2022-03-12,41565161,41565161,0,https://korona.gov.sk/,3504199,38060962,0,0,0.8817454632282713,0,0,3475201,38089960
Slovakia,2022-03-13,41565161,41565161,0,https://korona.gov.sk/,3504199,38060962,0,0,0.8817454632282713,0,0,3475201,38089960
Slovakia,2022-03-14,41565161,41565161,0,https://korona.gov.sk/,3504199,38060962,0,0,0.8817454632282713,0,0,3475201,38089960
Slovakia,2022-03-15,41565161,41565161,0,https://korona.gov.sk/,3504199,38060962,0,0,0.8817454632282713,0,0,3475201,38089960
Slovakia,2022-03-16,41565161,41565161,0,https://korona.gov.sk/,3504199,38060962,0,0,0.8817454632282713,0,0,3475201,38089960
Slovakia,2022-03-17,41565161,41565161,0,https://korona.gov.sk/,3504199,38060962,0,0,0.8817454632282713,0,0,3475201,38089960
Slovakia,2022-03-18,41565161,41565161,0,https://korona.gov.sk/,3504199,38060962,0,0,0.8817454632282713,0,0,3475201,38089960
Slovakia,2022-03-19,41565161,41565161,0,https://korona.gov.sk/,3504199,38060962,0,0,0.8817454632282713,0,0,3475201,38089960
Slovakia,2022-03-20,41565161,41565161,0,https://korona.gov.sk/,3504199,38060962,0,0,0.8817454632282713,0,0,3475201,38089960
Slovakia,2022-03-21,41565161,41565161,0,https://korona.gov.sk/,3504199,38060962,0,0,0.8817454632282713,0,0,3475201,38089960
Slovakia,2022-03-22,50297390,50297390,8732229,https://korona.gov.sk/,6744708,43552682,3240509,5491720,0.6289024257151296,3240509,5491720,6715710,43581680
Slovakia,2022-03-23,50333931,50333931,36541,https://korona.gov.sk/,6764220,43569711,19512,17029,0.4660244656687009,19512,17029,6735222,43598709
Slovakia,2022-03-24,50333931,50333931,0,https://korona.gov.sk/,6764220,43569711,0,0,0.4660244656687009,0,0,6735222,43598709
Slovakia,2022-03-25,50333931,50333931,0,https://korona.gov.sk/,6798172,43601324,33952,31613,0.48216273926637687,0,0,6735222,43598709
Slovakia,2022-03-26,50427633,50427633,93702,https://korona.gov.sk/,6812898,43614735,14726,13411,0.4766321924867612,49041,44661,6784263,43643370
Slovakia,2022-03-27,50443652,50443652,16019,https://korona.gov.sk/,6824373,43619279,11475,4544,0.2836631500093639,11475,4544,6795738,43647914
Slovakia,2022-03-28,50453879,50453879,10227,https://korona.gov.sk/,6830063,43623816,5690,4537,0.44362960790065514,5690,4537,6801428,43652451
Slovakia,2022-03-29,50489550,50489550,35671,https://korona.gov.sk/,6845351,43644199,15288,20383,0.5714165568669227,15288,20383,6816716,43672834
Slovakia,2022-03-30,50518571,50518571,29021,https://korona.gov.sk/,6860089,43658482,14738,14283,0.49216084904035007,14738,14283,6831454,43687117
Slovakia,2022-03-31,50549562,50549562,30991,https://korona.gov.sk/,6875917,43673645,15828,15163,0.4892710787002678,15828,15163,6847282,43702280
Slovakia,2022-04-01,50575384,50575384,25822,https://korona.gov.sk/,6887739,43687645,11822,14000,0.5421733405623113,11822,14000,6859104,43716280
Slovakia,2022-04-02,50600340,50600340,24956,https://korona.gov.sk/,6900741,43699599,13002,11954,0.4790030453598333,13002,11954,6872106,43728234
Slovakia,2022-04-03,50611151,50611151,10811,https://korona.gov.sk/,6908765,43702386,8024,2787,0.2577929886226991,8024,2787,6880130,43731021
Slovakia,2022-04-04,50620300,50620300,9149,https://korona.gov.sk/,6912806,43707494,4041,5108,0.5583123838670893,4041,5108,6884171,43736129
Slovakia,2022-04-05,50651667,50651667,31367,https://korona.gov.sk/,6926378,43725289,13572,17795,0.567315969012019,13572,17795,6897743,43753924
Slovakia,2022-04-06,50676512,50676512,24845,https://korona.gov.sk/,6939102,43737410,12724,12121,0.4878647615214329,12724,12121,6910467,43766045
Slovakia,2022-04-07,50698975,50698975,22463,https://korona.gov.sk/,6950054,43748921,10952,11511,0.5124426835240172,10952,11511,6921419,43777556
Slovakia,2022-04-08,50718503,50718503,19528,https://korona.gov.sk/,6958964,43759539,8910,10618,0.5437320770176157,8910,10618,6930329,43788174
Slovakia,2022-04-09,50740100,50740100,21597,https://korona.gov.sk/,6967893,43772207,8929,12668,0.58656294855767,8929,12668,6939258,43800842
Slovakia,2022-04-10,50749161,50749161,9061,https://korona.gov.sk/,6974263,43774898,6370,2691,0.296987087517934,6370,2691,6945628,43803533
Slovakia,2022-04-11,50755194,50755194,6033,https://korona.gov.sk/,6977217,43777977,2954,3079,0.5103596883805736,2954,3079,6948582,43806612
Slovakia,2022-04-12,50782094,50782094,26900,https://korona.gov.sk/,6987643,43794451,10426,16474,0.6124163568773234,10426,16474,6959008,43823086
Slovakia,2022-04-13,50800428,50800428,18334,https://korona.gov.sk/,6995626,43804802,7983,10351,0.5645794698374604,7983,10351,6966991,43833437
Slovakia,2022-04-14,50800428,50800428,0,https://korona.gov.sk/,6995626,43804802,0,0,0.5645794698374604,0,0,6966991,43833437
Slovakia,2022-04-15,50833516,50833516,33088,https://korona.gov.sk/,7010890,43822626,15264,17824,0.5386847195357833,15264,17824,6982255,43851261
Slovakia,2022-04-16,50838297,50838297,4781,https://korona.gov.sk/,7013438,43824859,2548,2233,0.4670571010248902,2548,2233,6984803,43853494
Slovakia,2022-04-17,50842904,50842904,4607,https://korona.gov.sk/,7016700,43826204,3262,1345,0.29194703711743,3262,1345,6988065,43854839
Slovakia,2022-04-18,50842904,50842904,0,https://korona.gov.sk/,7016700,43826204,0,0,0.29194703711743,0,0,6988065,43854839
Slovakia,2022-04-19,50854095,50854095,11191,https://korona.gov.sk/,7023635,43830460,6935,4256,0.38030560271646857,6935,4256,6995000,43859095
Slovakia,2022-04-20,50879904,50879904,25809,https://korona.gov.sk/,7032606,43847298,8971,16838,0.6524080747026231,8971,16838,7003971,43875933
Slovakia,2022-04-21,50899851,50899851,19947,https://korona.gov.sk/,7041022,43858829,8416,11531,0.5780819170802627,8416,11531,7012387,43887464
Slovakia,2022-04-22,50918375,50918375,18524,https://korona.gov.sk/,7046883,43871492,5861,12663,0.6835996545022673,5861,12663,7018248,43900127
Slovakia,2022-04-23,50932666,50932666,14291,https://korona.gov.sk/,7052991,43879675,6108,8183,0.5725981386886851,6108,8183,7024356,43908310
Slovakia,2022-04-24,50939621,50939621,6955,https://korona.gov.sk/,7057901,43881720,4910,2045,0.29403306973400434,4910,2045,7029266,43910355
Slovakia,2022-04-25,50944507,50944507,4886,https://korona.gov.sk/,7059789,43884718,1888,2998,0.6135898485468686,1888,2998,7031154,43913353
Slovakia,2022-04-26,50963068,50963068,18561,https://korona.gov.sk/,7067460,43895608,7671,10890,0.5867140779052853,7671,10890,7038825,43924243
Slovakia,2022-04-27,50994753,50994753,31685,https://korona.gov.sk/,7074245,43920508,6785,24900,0.7858608174214928,6785,24900,7045610,43949143
Slovakia,2022-04-28,51008409,51008409,13656,https://korona.gov.sk/,7079734,43928675,5489,8167,0.5980521382542472,5489,8167,7051099,43957310
Slovakia,2022-04-29,51008409,51008409,0,https://korona.gov.sk/,7079734,43928675,0,0,0.5980521382542472,0,0,7051099,43957310
Slovakia,2022-04-30,51008409,51008409,0,https://korona.gov.sk/,7079734,43928675,0,0,0.5980521382542472,0,0,7051099,43957310
Slovakia,2022-05-01,51008409,51008409,0,https://korona.gov.sk/,7079734,43928675,0,0,0.5980521382542472,0,0,7051099,43957310
Slovakia,2022-05-02,51008409,51008409,0,https://korona.gov.sk/,7079734,43928675,0,0,0.5980521382542472,0,0,7051099,43957310
Slovakia,2022-05-03,51008409,51008409,0,https://korona.gov.sk/,7079734,43928675,0,0,0.5980521382542472,0,0,7051099,43957310
Slovakia,2022-05-04,51064410,51064410,56001,https://korona.gov.sk/,7104005,43960405,24271,31730,0.566597025053124,24271,31730,7075370,43989040
Slovakia,2022-05-05,51071788,51071788,7378,https://korona.gov.sk/,7107056,43964732,3051,4327,0.5864732989970182,3051,4327,7078421,43993367
Slovakia,2022-05-06,51078344,51078344,6556,https://korona.gov.sk/,7109492,43968852,2436,4120,0.6284319707138499,2436,4120,7080857,43997487
Slovakia,2022-05-07,51084536,51084536,6192,https://korona.gov.sk/,7112210,43972326,2718,3474,0.561046511627907,2718,3474,7083575,44000961
Slovakia,2022-05-08,51087319,51087319,2783,https://korona.gov.sk/,7113811,43973508,1601,1182,0.42472152353575277,1601,1182,7085176,44002143
Slovakia,2022-05-09,51088728,51088728,1409,https://korona.gov.sk/,7114375,43974353,564,845,0.5997161107168204,564,845,7085740,44002988
Slovakia,2022-05-10,51097014,51097014,8286,https://korona.gov.sk/,7117625,43979389,3250,5036,0.6077721457880763,3250,5036,7088990,44008024
Slovakia,2022-05-11,51103291,51103291,6277,https://korona.gov.sk/,7120136,43983155,2511,3766,0.599968137645372,2511,3766,7091501,44011790
Slovakia,2022-05-12,51109043,51109043,5752,https://korona.gov.sk/,7122263,43986780,2127,3625,0.6302155771905424,2127,3625,7093628,44015415
Slovakia,2022-05-13,51113595,51113595,4552,https://korona.gov.sk/,7123790,43989805,1527,3025,0.664543057996485,1527,3025,7095155,44018440
Slovakia,2022-05-14,51113595,51113595,0,https://korona.gov.sk/,7123790,43989805,0,0,0.664543057996485,0,0,7095155,44018440
Slovakia,2022-05-15,51121236,51121236,7641,https://korona.gov.sk/,7127129,43994107,3339,4302,0.5630153121319199,3339,4302,7098494,44022742
Slovakia,2022-05-16,51122421,51122421,1185,https://korona.gov.sk/,7127568,43994853,439,746,0.6295358649789029,439,746,7098933,44023488
Slovakia,2022-05-17,51129144,51129144,6723,https://korona.gov.sk/,7129843,43999301,2275,4448,0.6616094005652239,2275,4448,7101208,44027936
Slovakia,2022-05-18,51133958,51133958,4814,https://korona.gov.sk/,7131776,44002182,1933,2881,0.5984628167843788,1933,2881,7103141,44030817
Slovakia,2022-05-19,51133958,51133958,0,https://korona.gov.sk/,7131776,44002182,0,0,0.5984628167843788,0,0,7103141,44030817
Slovakia,2022-05-20,51142409,51142409,8451,https://korona.gov.sk/,7135046,44007363,3270,5181,0.6130635427760028,3270,5181,7106411,44035998
Slovakia,2022-05-21,51142409,51142409,0,https://korona.gov.sk/,7135046,44007363,0,0,0.6130635427760028,0,0,7106411,44035998
Slovakia,2022-05-22,51142409,51142409,0,https://korona.gov.sk/,7135046,44007363,0,0,0.6130635427760028,0,0,7106411,44035998
Slovakia,2022-05-23,51142409,51142409,0,https://korona.gov.sk/,7135046,44007363,0,0,0.6130635427760028,0,0,7106411,44035998
Slovakia,2022-05-24,51154591,51154591,12182,https://korona.gov.sk/,7139957,44014634,4911,7271,0.596864225907076,4911,7271,7111322,44043269
Slovakia,2022-05-25,51158686,51158686,4095,https://korona.gov.sk/,7141380,44017306,1423,2672,0.6525030525030525,1423,2672,7112745,44045941
Slovakia,2022-05-26,51158686,51158686,0,https://korona.gov.sk/,7141380,44017306,0,0,0.6525030525030525,0,0,7112745,44045941
Slovakia,2022-05-27,51166127,51166127,7441,https://korona.gov.sk/,7143863,44022264,2483,4958,0.6663082918962505,2483,4958,7115228,44050899
Slovakia,2022-05-28,51169349,51169349,3222,https://korona.gov.sk/,7145153,44024196,1290,1932,0.5996275605214153,1290,1932,7116518,44052831
Slovakia,2022-05-29,51170536,51170536,1187,https://korona.gov.sk/,7145844,44024692,691,496,0.41786015164279694,691,496,7117209,44053327
Slovakia,2022-05-30,51171364,51171364,828,https://korona.gov.sk/,7146140,44025224,296,532,0.642512077294686,296,532,7117505,44053859
Slovakia,2022-05-31,51176914,51176914,5550,https://korona.gov.sk/,7147828,44029086,1688,3862,0.6958558558558559,1688,3862,7119193,44057721
Slovakia,2022-06-01,51180805,51180805,3891,https://korona.gov.sk/,7149094,44031711,1266,2625,0.674633770239013,1266,2625,7120459,44060346
Slovakia,2022-06-02,51184876,51184876,4071,https://korona.gov.sk/,7150182,44034694,1088,2983,0.732743797592729,1088,2983,7121547,44063329
Slovakia,2022-06-03,51188639,51188639,3763,https://korona.gov.sk/,7151121,44037518,939,2824,0.7504650544778103,939,2824,7122486,44066153
Slovakia,2022-06-04,51191195,51191195,2556,https://korona.gov.sk/,7152141,44039054,1020,1536,0.6009389671361502,1020,1536,7123506,44067689
Slovakia,2022-06-05,51192213,51192213,1018,https://korona.gov.sk/,7152732,44039481,591,427,0.4194499017681729,591,427,7124097,44068116
Slovakia,2022-06-06,51193150,51193150,937,https://korona.gov.sk/,7152978,44040172,246,691,0.7374599786552828,246,691,7124343,44068807
Slovakia,2022-06-07,51198292,51198292,5142,https://korona.gov.sk/,7154358,44043934,1380,3762,0.7316219369894983,1380,3762,7125723,44072569
Slovakia,2022-06-08,51203821,51203821,5529,https://korona.gov.sk/,7155371,44048450,1013,4516,0.816784228612769,1013,4516,7126736,44077085
Slovakia,2022-06-09,51206731,51206731,2910,https://korona.gov.sk/,7156420,44050311,1049,1861,0.6395189003436426,1049,1861,7127785,44078946
Slovakia,2022-06-10,51209589,51209589,2858,https://korona.gov.sk/,7157278,44052311,858,2000,0.6997900629811057,858,2000,7128643,44080946
Slovakia,2022-06-11,51212006,51212006,2417,https://korona.gov.sk/,7158362,44053644,1084,1333,0.551510136532892,1084,1333,7129727,44082279
Slovakia,2022-06-12,51212006,51212006,0,https://korona.gov.sk/,7158362,44053644,0,0,0.551510136532892,0,0,7129727,44082279
Slovakia,2022-06-13,51213510,51213510,1504,https://korona.gov.sk/,7159130,44054380,768,736,0.48936170212765956,768,736,7130495,44083015
Slovakia,2022-06-14,51217469,51217469,3959,https://korona.gov.sk/,7160395,44057074,1265,2694,0.6804748673907552,1265,2694,7131760,44085709
Slovakia,2022-06-15,51220264,51220264,2795,https://korona.gov.sk/,7161427,44058837,1032,1763,0.6307692307692307,1032,1763,7132792,44087472
Slovakia,2022-06-16,51222748,51222748,2484,https://korona.gov.sk/,7162345,44060403,918,1566,0.6304347826086957,918,1566,7133710,44089038
Slovakia,2022-06-17,51225283,51225283,2535,https://korona.gov.sk/,7163124,44062159,779,1756,0.6927021696252466,779,1756,7134489,44090794
Slovakia,2022-06-18,51227487,51227487,2204,https://korona.gov.sk/,7164202,44063285,1078,1126,0.5108892921960072,1078,1126,7135567,44091920
Slovakia,2022-06-19,51227487,51227487,0,https://korona.gov.sk/,7164202,44063285,0,0,0.5108892921960072,0,0,7135567,44091920
Slovakia,2022-06-20,51228854,51228854,1367,https://korona.gov.sk/,7164967,44063887,765,602,0.4403803950256035,765,602,7136332,44092522
Slovakia,2022-06-21,51232873,51232873,4019,https://korona.gov.sk/,7166397,44066476,1430,2589,0.6441900970390645,1430,2589,7137762,44095111
Slovakia,2022-06-22,51235672,51235672,2799,https://korona.gov.sk/,7167562,44068110,1165,1634,0.5837799214005002,1165,1634,7138927,44096745
Slovakia,2022-06-23,51238515,51238515,2843,https://korona.gov.sk/,7168820,44069695,1258,1585,0.5575096728807598,1258,1585,7140185,44098330
Slovakia,2022-06-24,51242179,51242179,3664,https://korona.gov.sk/,7169829,44072350,1009,2655,0.724617903930131,1009,2655,7141194,44100985
Slovakia,2022-06-25,51245001,51245001,2822,https://korona.gov.sk/,7171183,44073818,1354,1468,0.520198440822112,1354,1468,7142548,44102453
Slovakia,2022-06-26,51246076,51246076,1075,https://korona.gov.sk/,7171795,44074281,612,463,0.4306976744186046,612,463,7143160,44102916
Slovakia,2022-06-27,51246852,51246852,776,https://korona.gov.sk/,7172125,44074727,330,446,0.5747422680412371,330,446,7143490,44103362
Slovakia,2022-06-28,51252033,51252033,5181,https://korona.gov.sk/,7173799,44078234,1674,3507,0.6768963520555877,1674,3507,7145164,44106869
Slovakia,2022-06-29,51257695,51257695,5662,https://korona.gov.sk/,7175104,44082591,1305,4357,0.769516072059343,1305,4357,7146469,44111226
Slovakia,2022-06-30,51261079,51261079,3384,https://korona.gov.sk/,7176779,44084300,1675,1709,0.5050236406619385,1675,1709,7148144,44112935
Slovakia,2022-07-01,51264695,51264695,3616,https://korona.gov.sk/,7178099,44086596,1320,2296,0.6349557522123894,1320,2296,7149464,44115231
Slovakia,2022-07-02,51268161,51268161,3466,https://korona.gov.sk/,7179567,44088594,1468,1998,0.5764570109636469,1468,1998,7150932,44117229
Slovakia,2022-07-03,51269425,51269425,1264,https://korona.gov.sk/,7180264,44089161,697,567,0.4485759493670886,697,567,7151629,44117796
Slovakia,2022-07-04,51270104,51270104,679,https://korona.gov.sk/,7180477,44089627,213,466,0.6863033873343152,213,466,7151842,44118262
Slovakia,2022-07-05,51274824,51274824,4720,https://korona.gov.sk/,7182254,44092570,1777,2943,0.6235169491525424,1777,2943,7153619,44121205
Slovakia,2022-07-06,51275972,51275972,1148,https://korona.gov.sk/,7182872,44093100,618,530,0.4616724738675958,618,530,7154237,44121735
Slovakia,2022-07-07,51280407,51280407,4435,https://korona.gov.sk/,7184509,44095898,1637,2798,0.630890642615558,1637,2798,7155874,44124533
Slovakia,2022-07-08,51284461,51284461,4054,https://korona.gov.sk/,7186103,44098358,1594,2460,0.6068080907745437,1594,2460,7157468,44126993
Slovakia,2022-07-09,51288712,51288712,4251,https://korona.gov.sk/,7188104,44100608,2001,2250,0.529287226534933,2001,2250,7159469,44129243
Slovakia,2022-07-10,51290212,51290212,1500,https://korona.gov.sk/,7189012,44101200,908,592,0.39466666666666667,908,592,7160377,44129835
Slovakia,2022-07-11,51291057,51291057,845,https://korona.gov.sk/,7189321,44101736,309,536,0.6343195266272189,309,536,7160686,44130371
Slovakia,2022-07-12,51296577,51296577,5520,https://korona.gov.sk/,7191338,44105239,2017,3503,0.6346014492753623,2017,3503,7162703,44133874
Slovakia,2022-07-13,51301112,51301112,4535,https://korona.gov.sk/,7193460,44107652,2122,2413,0.5320837927232636,2122,2413,7164825,44136287
Slovakia,2022-07-14,51305277,51305277,4165,https://korona.gov.sk/,7195329,44109948,1869,2296,0.5512605042016807,1869,2296,7166694,44138583
Slovakia,2022-07-15,51309312,51309312,4035,https://korona.gov.sk/,7197069,44112243,1740,2295,0.5687732342007435,1740,2295,7168434,44140878
Slovakia,2022-07-16,51314482,51314482,5170,https://korona.gov.sk/,7199580,44114902,2511,2659,0.5143133462282399,2511,2659,7170945,44143537
Slovakia,2022-07-17,51316430,51316430,1948,https://korona.gov.sk/,7200663,44115767,1083,865,0.4440451745379877,1083,865,7172028,44144402
Slovakia,2022-07-18,51317252,51317252,822,https://korona.gov.sk/,7201031,44116221,368,454,0.5523114355231143,368,454,7172396,44144856
Slovakia,2022-07-19,51323661,51323661,6409,https://korona.gov.sk/,7203294,44120367,2263,4146,0.6469027929474177,2263,4146,7174659,44149002
Slovakia,2022-07-20,51329132,51329132,5471,https://korona.gov.sk/,7205716,44123416,2422,3049,0.5573021385487114,2422,3049,7177081,44152051
Slovakia,2022-07-21,51334477,51334477,5345,https://korona.gov.sk/,7208018,44126459,2302,3043,0.5693171188026193,2302,3043,7179383,44155094
Slovakia,2022-07-22,51340358,51340358,5881,https://korona.gov.sk/,7210437,44129921,2419,3462,0.5886753953409284,2419,3462,7181802,44158556
Slovakia,2022-07-23,51346117,51346117,5759,https://korona.gov.sk/,7212784,44133333,2347,3412,0.5924639694391387,2347,3412,7184149,44161968
Slovakia,2022-07-24,51348358,51348358,2241,https://korona.gov.sk/,7214159,44134199,1375,866,0.38643462739848283,1375,866,7185524,44162834
Slovakia,2022-07-25,51349573,51349573,1215,https://korona.gov.sk/,7214547,44135026,388,827,0.6806584362139918,388,827,7185912,44163661
Slovakia,2022-07-26,51357332,51357332,7759,https://korona.gov.sk/,7217162,44140170,2615,5144,0.6629720324784122,2615,5144,7188527,44168805
Slovakia,2022-07-27,51364017,51364017,6685,https://korona.gov.sk/,7219358,44144659,2196,4489,0.6715033657442034,2196,4489,7190723,44173294
Slovakia,2022-07-28,51368071,51368071,4054,https://korona.gov.sk/,7220753,44147318,1395,2659,0.6558954119388258,1395,2659,7192118,44175953
Slovakia,2022-07-29,51374066,51374066,5995,https://korona.gov.sk/,7222708,44151358,1955,4040,0.6738949124270225,1955,4040,7194073,44179993
Slovakia,2022-07-30,51380081,51380081,6015,https://korona.gov.sk/,7225203,44154878,2495,3520,0.5852036575228595,2495,3520,7196568,44183513
Slovakia,2022-07-31,51382028,51382028,1947,https://korona.gov.sk/,7226240,44155788,1037,910,0.46738572162300973,1037,910,7197605,44184423
Slovakia,2022-08-01,51383548,51383548,1520,https://korona.gov.sk/,7226614,44156934,374,1146,0.7539473684210526,374,1146,7197979,44185569
Slovakia,2022-08-02,51391698,51391698,8150,https://korona.gov.sk/,7229040,44162658,2426,5724,0.7023312883435583,2426,5724,7200405,44191293
Slovakia,2022-08-03,51397703,51397703,6005,https://korona.gov.sk/,7231219,44166484,2179,3826,0.637135720233139,2179,3826,7202584,44195119
Slovakia,2022-08-04,51397703,51397703,0,https://korona.gov.sk/,7231219,44006895,0,-159589,1,0,0,7202584,44195119
Slovakia,2022-08-05,51397703,51397703,0,https://korona.gov.sk/,7231219,44006895,0,0,1,0,0,7202584,44195119
Slovakia,2022-08-06,51397703,51397703,0,https://korona.gov.sk/,7231219,44006895,0,0,1,0,0,7202584,44195119
Slovakia,2022-08-07,51397703,51397703,0,https://korona.gov.sk/,7231219,44006895,0,0,1,0,0,7202584,44195119
Slovakia,2022-08-08,51397703,51397703,0,https://korona.gov.sk/,7231219,44006895,0,0,1,0,0,7202584,44195119
Slovakia,2022-08-09,51397703,51397703,0,https://korona.gov.sk/,7231219,44006895,0,0,1,0,0,7202584,44195119
Slovakia,2022-08-10,51397703,51397703,0,https://korona.gov.sk/,7231219,44006895,0,0,1,0,0,7202584,44195119
Slovakia,2022-08-11,51397703,51397703,0,https://korona.gov.sk/,7231219,44006895,0,0,1,0,0,7202584,44195119
Slovakia,2022-08-12,51397703,51397703,0,https://korona.gov.sk/,7231219,44006895,0,0,1,0,0,7202584,44195119
Slovakia,2022-08-13,51397703,51397703,0,https://korona.gov.sk/,7231219,44006895,0,0,1,0,0,7202584,44195119
Slovakia,2022-08-14,51397703,51397703,0,https://korona.gov.sk/,7231219,44006895,0,0,1,0,0,7202584,44195119
Slovakia,2022-08-15,51397703,51397703,0,https://korona.gov.sk/,7231219,44006895,0,0,1,0,0,7202584,44195119
Slovakia,2022-08-16,51397703,51397703,0,https://korona.gov.sk/,7231219,44006895,0,0,1,0,0,7202584,44195119
Slovakia,2022-08-17,51397703,51397703,0,https://korona.gov.sk/,7231219,44006895,0,0,1,0,0,7202584,44195119
Slovakia,2022-08-18,51397703,51397703,0,https://korona.gov.sk/,7231219,44006895,0,0,1,0,0,7202584,44195119
Slovakia,2022-08-19,51397703,51397703,0,https://korona.gov.sk/,7231219,44006895,0,0,1,0,0,7202584,44195119
Slovakia,2022-08-20,51397703,51397703,0,https://korona.gov.sk/,7231219,44006895,0,0,1,0,0,7202584,44195119
Slovakia,2022-08-21,51397703,51397703,0,https://korona.gov.sk/,7231219,44006895,0,0,1,0,0,7202584,44195119
Slovakia,2022-08-22,51397703,51397703,0,https://korona.gov.sk/,7231219,44006895,0,0,1,0,0,7202584,44195119
Slovakia,2022-08-23,51397703,51397703,0,https://korona.gov.sk/,7231219,44006895,0,0,1,0,0,7202584,44195119
Slovakia,2022-08-24,51397703,51397703,0,https://korona.gov.sk/,7231219,44006895,0,0,1,0,0,7202584,44195119
Slovakia,2022-08-25,51397703,51397703,0,https://korona.gov.sk/,7231219,44006895,0,0,1,0,0,7202584,44195119
Slovakia,2022-08-26,51397703,51397703,0,https://korona.gov.sk/,7231219,44006895,0,0,1,0,0,7202584,44195119
Slovakia,2022-08-27,51397703,51397703,0,https://korona.gov.sk/,7231219,44006895,0,0,1,0,0,7202584,44195119
Slovakia,2022-08-28,51397703,51397703,0,https://korona.gov.sk/,7231219,44006895,0,0,1,0,0,7202584,44195119
Slovakia,2022-08-29,51397703,51397703,0,https://korona.gov.sk/,7231219,44006895,0,0,1,0,0,7202584,44195119
Slovakia,2022-08-30,51397703,51397703,0,https://korona.gov.sk/,7231219,44006895,0,0,1,0,0,7202584,44195119
Slovakia,2022-08-31,51397703,51397703,0,https://korona.gov.sk/,7231219,44006895,0,0,1,0,0,7202584,44195119
Slovakia,2022-09-01,51397703,51397703,0,https://korona.gov.sk/,7231219,44006895,0,0,1,0,0,7202584,44195119
Slovakia,2022-09-02,51397703,51397703,0,https://korona.gov.sk/,7231219,44006895,0,0,1,0,0,7202584,44195119
Slovakia,2022-09-03,51397703,51397703,0,https://korona.gov.sk/,7231219,44006895,0,0,1,0,0,7202584,44195119
Slovakia,2022-09-04,51397703,51397703,0,https://korona.gov.sk/,7231219,44006895,0,0,1,0,0,7202584,44195119
Slovakia,2022-09-05,51397703,51397703,0,https://korona.gov.sk/,7231219,44006895,0,0,1,0,0,7202584,44195119
Slovakia,2022-09-06,51397703,51397703,0,https://korona.gov.sk/,7231219,44006895,0,0,1,0,0,7202584,44195119
Slovakia,2022-09-07,51397703,51397703,0,https://korona.gov.sk/,7231219,44006895,0,0,1,0,0,7202584,44195119
Slovakia,2022-09-08,51397703,51397703,0,https://korona.gov.sk/,7231219,44006895,0,0,1,0,0,7202584,44195119
Slovakia,2022-09-09,51397703,51397703,0,https://korona.gov.sk/,7231219,44006895,0,0,1,0,0,7202584,44195119
Slovakia,2022-09-10,51397703,51397703,0,https://korona.gov.sk/,7231219,44006895,0,0,1,0,0,7202584,44195119
Slovakia,2022-09-11,51397703,51397703,0,https://korona.gov.sk/,7231219,44006895,0,0,1,0,0,7202584,44195119
Slovakia,2022-09-12,51397703,51397703,0,https://korona.gov.sk/,7231219,44006895,0,0,1,0,0,7202584,44195119
Slovakia,2022-09-13,51397703,51397703,0,https://korona.gov.sk/,7231219,44006895,0,0,1,0,0,7202584,44195119
Slovakia,2022-09-14,51397703,51397703,0,https://korona.gov.sk/,7231219,44006895,0,0,1,0,0,7202584,44195119
Slovakia,2022-09-15,51397703,51397703,0,https://korona.gov.sk/,7231219,44006895,0,0,1,0,0,7202584,44195119
Slovakia,2022-09-16,51397703,51397703,0,https://korona.gov.sk/,7231219,44006895,0,0,1,0,0,7202584,44195119
Slovakia,2022-09-17,51397703,51397703,0,https://korona.gov.sk/,7231219,44006895,0,0,1,0,0,7202584,44195119
Slovakia,2022-09-18,51397703,51397703,0,https://korona.gov.sk/,7231219,44006895,0,0,1,0,0,7202584,44195119
Slovakia,2022-09-19,51397703,51397703,0,https://korona.gov.sk/,7231219,44006895,0,0,1,0,0,7202584,44195119
Slovakia,2022-09-20,51397703,51397703,0,https://korona.gov.sk/,7231219,44006895,0,0,1,0,0,7202584,44195119
Slovakia,2022-09-21,51397703,51397703,0,https://korona.gov.sk/,7231219,44006895,0,0,1,0,0,7202584,44195119
Slovakia,2022-09-22,51397703,51397703,0,https://korona.gov.sk/,7231219,44006895,0,0,1,0,0,7202584,44195119
Slovakia,2022-09-23,51397703,51397703,0,https://korona.gov.sk/,7231219,44006895,0,0,1,0,0,7202584,44195119
Slovakia,2022-09-24,51397703,51397703,0,https://korona.gov.sk/,7231219,44006895,0,0,1,0,0,7202584,44195119
Slovakia,2022-09-25,51397703,51397703,0,https://korona.gov.sk/,7231219,44006895,0,0,1,0,0,7202584,44195119
Slovakia,2022-09-26,51397703,51397703,0,https://korona.gov.sk/,7231219,44006895,0,0,1,0,0,7202584,44195119
Slovakia,2022-09-27,51397703,51397703,0,https://korona.gov.sk/,7231219,44006895,0,0,1,0,0,7202584,44195119
Slovakia,2022-09-28,51397703,51397703,0,https://korona.gov.sk/,7231219,44006895,0,0,1,0,0,7202584,44195119
Slovakia,2022-09-29,51397703,51397703,0,https://korona.gov.sk/,7231219,44006895,0,0,1,0,0,7202584,44195119
Slovakia,2022-09-30,51397703,51397703,0,https://korona.gov.sk/,7231219,44006895,0,0,1,0,0,7202584,44195119
Slovakia,2022-10-01,51397703,51397703,0,https://korona.gov.sk/,7231219,44006895,0,0,1,0,0,7202584,44195119
Slovakia,2022-10-02,51397703,51397703,0,https://korona.gov.sk/,7231219,44006895,0,0,1,0,0,7202584,44195119
Slovakia,2022-10-03,51397703,51397703,0,https://korona.gov.sk/,7231219,44006895,0,0,1,0,0,7202584,44195119
Slovakia,2022-10-04,51397703,51397703,0,https://korona.gov.sk/,7231219,44006895,0,0,1,0,0,7202584,44195119
Slovakia,2022-10-05,51397703,51397703,0,https://korona.gov.sk/,7231219,44006895,0,0,1,0,0,7202584,44195119
Slovakia,2022-10-06,51397703,51397703,0,https://korona.gov.sk/,7231219,44006895,0,0,1,0,0,7202584,44195119
Slovakia,2022-10-07,51397703,51397703,0,https://korona.gov.sk/,7231219,44006895,0,0,1,0,0,7202584,44195119
Slovakia,2022-10-08,51397703,51397703,0,https://korona.gov.sk/,7231219,44006895,0,0,1,0,0,7202584,44195119
Slovakia,2022-10-09,51397703,51397703,0,https://korona.gov.sk/,7231219,44006895,0,0,1,0,0,7202584,44195119
Slovakia,2022-10-10,51397703,51397703,0,https://korona.gov.sk/,7231219,44006895,0,0,1,0,0,7202584,44195119
Slovakia,2022-10-11,51397703,51397703,0,https://korona.gov.sk/,7231219,44006895,0,0,1,0,0,7202584,44195119
Slovakia,2022-10-12,51397703,51397703,0,https://korona.gov.sk/,7231219,44006895,0,0,1,0,0,7202584,44195119
Slovakia,2022-10-13,51397703,51397703,0,https://korona.gov.sk/,7231219,44006895,0,0,1,0,0,7202584,44195119
Slovakia,2022-10-14,51397703,51397703,0,https://korona.gov.sk/,7231219,44006895,0,0,1,0,0,7202584,44195119
Slovakia,2022-10-15,51397703,51397703,0,https://korona.gov.sk/,7231219,44006895,0,0,1,0,0,7202584,44195119
Slovakia,2022-10-16,51397703,51397703,0,https://korona.gov.sk/,7231219,44006895,0,0,1,0,0,7202584,44195119
Slovakia,2022-10-17,51397703,51397703,0,https://korona.gov.sk/,7231219,44006895,0,0,1,0,0,7202584,44195119
Slovakia,2022-10-18,51397703,51397703,0,https://korona.gov.sk/,7231219,44006895,0,0,1,0,0,7202584,44195119
Slovakia,2022-10-19,51397703,51397703,0,https://korona.gov.sk/,7231219,44006895,0,0,1,0,0,7202584,44195119
Slovakia,2022-10-20,51397703,51397703,0,https://korona.gov.sk/,7231219,44006895,0,0,1,0,0,7202584,44195119
Slovakia,2022-10-21,51397703,51397703,0,https://korona.gov.sk/,7231219,44006895,0,0,1,0,0,7202584,44195119
Slovakia,2022-10-22,51397703,51397703,0,https://korona.gov.sk/,7231219,44006895,0,0,1,0,0,7202584,44195119
Slovakia,2022-10-23,51397703,51397703,0,https://korona.gov.sk/,7231219,44006895,0,0,1,0,0,7202584,44195119
Slovakia,2022-10-24,51397703,51397703,0,https://korona.gov.sk/,7231219,44006895,0,0,1,0,0,7202584,44195119
Slovakia,2022-10-25,51772654,51772654,374951,https://korona.gov.sk/,7231219,44006895,0,0,1,0,374951,7202584,44570070
Slovakia,2022-10-26,51776484,51776484,3830,https://korona.gov.sk/,7231219,44006895,0,0,1,0,3830,7202584,44573900
Slovakia,2022-10-27,51781542,51781542,5058,https://korona.gov.sk/,7231219,44006895,0,0,1,0,5058,7202584,44578958
Slovakia,2022-10-28,51785763,51785763,4221,https://korona.gov.sk/,7231219,44006895,0,0,1,0,4221,7202584,44583179
Slovakia,2022-10-29,51786867,51786867,1104,https://korona.gov.sk/,7231219,44006895,0,0,1,0,1104,7202584,44584283
Slovakia,2022-10-30,51787204,51787204,337,https://korona.gov.sk/,7231219,44006895,0,0,1,0,337,7202584,44584620
Slovakia,2022-10-31,51792908,51792908,5704,https://korona.gov.sk/,7231219,44006895,0,0,1,0,5704,7202584,44590324
Slovakia,2022-11-01,51794277,51794277,1369,https://korona.gov.sk/,7231219,44006895,0,0,1,0,1369,7202584,44591693
Slovakia,2022-11-02,51798512,51798512,4235,https://korona.gov.sk/,7231219,44006895,0,0,1,0,4235,7202584,44595928
Slovakia,2022-11-03,51803725,51803725,5213,https://korona.gov.sk/,7231219,44006895,0,0,1,0,5213,7202584,44601141
Slovakia,2022-11-04,51808375,51808375,4650,https://korona.gov.sk/,7231219,44006895,0,0,1,0,4650,7202584,44605791
Slovakia,2022-11-05,51809630,51809630,1255,https://korona.gov.sk/,7231219,44006895,0,0,1,0,1255,7202584,44607046
Slovakia,2022-11-06,51810279,51810279,649,https://korona.gov.sk/,7231219,44006895,0,0,1,0,649,7202584,44607695
Slovakia,2022-11-07,51817507,51817507,7228,https://korona.gov.sk/,7231219,44006895,0,0,1,0,7228,7202584,44614923
Slovakia,2022-11-08,51821282,51821282,3775,https://korona.gov.sk/,7231219,44006895,0,0,1,0,3775,7202584,44618698
Slovakia,2022-11-09,51824873,51824873,3591,https://korona.gov.sk/,7231219,44006895,0,0,1,0,3591,7202584,44622289
Slovakia,2022-11-10,51830066,51830066,5193,https://korona.gov.sk/,7231219,44006895,0,0,1,0,5193,7202584,44627482
Slovakia,2022-11-11,51834089,51834089,4023,https://korona.gov.sk/,7231219,44006895,0,0,1,0,4023,7202584,44631505
Slovakia,2022-11-12,51834870,51834870,781,https://korona.gov.sk/,7231219,44006895,0,0,1,0,781,7202584,44632286
Slovakia,2022-11-13,51835204,51835204,334,https://korona.gov.sk/,7231219,44006895,0,0,1,0,334,7202584,44632620
Slovakia,2022-11-14,51841762,51841762,6558,https://korona.gov.sk/,7231219,44006895,0,0,1,0,6558,7202584,44639178
Slovakia,2022-11-15,51845299,51845299,3537,https://korona.gov.sk/,7231219,44006895,0,0,1,0,3537,7202584,44642715
Slovakia,2022-11-16,51849164,51849164,3865,https://korona.gov.sk/,7231219,44006895,0,0,1,0,3865,7202584,44646580
Slovakia,2022-11-17,51849743,51849743,579,https://korona.gov.sk/,7231219,44006895,0,0,1,0,579,7202584,44647159
Slovakia,2022-11-18,51849743,51849743,0,https://korona.gov.sk/,7231219,44006895,0,0,1,0,0,7202584,44647159
Slovakia,2022-11-19,51855051,51855051,5308,https://korona.gov.sk/,7231219,44006895,0,0,1,0,5308,7202584,44652467
Slovakia,2022-11-20,51855410,51855410,359,https://korona.gov.sk/,7231219,44006895,0,0,1,0,359,7202584,44652826
Slovakia,2022-11-21,51855410,51855410,0,https://korona.gov.sk/,7231219,44006895,0,0,1,0,0,7202584,44652826
Slovakia,2022-11-22,51865352,51865352,9942,https://korona.gov.sk/,7231219,44006895,0,0,1,0,9942,7202584,44662768
Slovakia,2022-11-23,51868974,51868974,3622,https://korona.gov.sk/,7231219,44006895,0,0,1,0,3622,7202584,44666390
Slovakia,2022-11-24,51873055,51873055,4081,https://korona.gov.sk/,7231219,44006895,0,0,1,0,4081,7202584,44670471
Slovakia,2022-11-25,51875890,51875890,2835,https://korona.gov.sk/,7231219,44006895,0,0,1,0,2835,7202584,44673306
Slovakia,2022-11-26,51875890,51875890,0,https://korona.gov.sk/,7231219,44006895,0,0,1,0,0,7202584,44673306
Slovakia,2022-11-27,51875890,51875890,0,https://korona.gov.sk/,7231219,44006895,0,0,1,0,0,7202584,44673306
Slovakia,2022-11-28,51875890,51875890,0,https://korona.gov.sk/,7231219,44006895,0,0,1,0,0,7202584,44673306
Slovakia,2022-11-29,51887740,51887740,11850,https://korona.gov.sk/,7231219,44006895,0,0,1,0,11850,7202584,44685156
Slovakia,2022-11-30,51893311,51893311,5571,https://korona.gov.sk/,7231219,44006895,0,0,1,0,5571,7202584,44690727
Slovakia,2022-12-01,51897009,51897009,3698,https://korona.gov.sk/,7231219,44006895,0,0,1,0,3698,7202584,44694425
Slovakia,2022-12-02,51899825,51899825,2816,https://korona.gov.sk/,7231219,44006895,0,0,1,0,2816,7202584,44697241
Slovakia,2022-12-03,51900733,51900733,908,https://korona.gov.sk/,7231219,44006895,0,0,1,0,908,7202584,44698149
Slovakia,2022-12-04,51901162,51901162,429,https://korona.gov.sk/,7231219,44006895,0,0,1,0,429,7202584,44698578
Slovakia,2022-12-05,51906857,51906857,5695,https://korona.gov.sk/,7231219,44006895,0,0,1,0,5695,7202584,44704273
Slovakia,2022-12-06,51912581,51912581,5724,https://korona.gov.sk/,7231219,44006895,0,0,1,0,5724,7202584,44709997
Slovakia,2022-12-07,51915207,51915207,2626,https://korona.gov.sk/,7231219,44006895,0,0,1,0,2626,7202584,44712623
Slovakia,2022-12-08,51919485,51919485,4278,https://korona.gov.sk/,7231219,44006895,0,0,1,0,4278,7202584,44716901
Slovakia,2022-12-09,51925479,51925479,5994,https://korona.gov.sk/,7231219,44006895,0,0,1,0,5994,7202584,44722895
Slovakia,2022-12-10,51926564,51926564,1085,https://korona.gov.sk/,7231219,44006895,0,0,1,0,1085,7202584,44723980
Slovakia,2022-12-11,51927548,51927548,984,https://korona.gov.sk/,7231219,44006895,0,0,1,0,984,7202584,44724964
Slovakia,2022-12-12,51931694,51931694,4146,https://korona.gov.sk/,7231219,44006895,0,0,1,0,4146,7202584,44729110
Slovakia,2022-12-13,51935896,51935896,4202,https://korona.gov.sk/,7231219,44006895,0,0,1,0,4202,7202584,44733312
Slovakia,2022-12-14,51939073,51939073,3177,https://korona.gov.sk/,7231219,44006895,0,0,1,0,3177,7202584,44736489
Slovakia,2022-12-15,51943430,51943430,4357,https://korona.gov.sk/,7231219,44006895,0,0,1,0,4357,7202584,44740846
Slovakia,2022-12-16,51947001,51947001,3571,https://korona.gov.sk/,7231219,44006895,0,0,1,0,3571,7202584,44744417
Slovakia,2022-12-17,51947710,51947710,709,https://korona.gov.sk/,7231219,44006895,0,0,1,0,709,7202584,44745126
Slovakia,2022-12-18,51948080,51948080,370,https://korona.gov.sk/,7231219,44006895,0,0,1,0,370,7202584,44745496
Slovakia,2022-12-19,51953239,51953239,5159,https://korona.gov.sk/,7231219,44006895,0,0,1,0,5159,7202584,44750655
Slovakia,2022-12-20,51957540,51957540,4301,https://korona.gov.sk/,7231219,44006895,0,0,1,0,4301,7202584,44754956
Slovakia,2022-12-21,51960396,51960396,2856,https://korona.gov.sk/,7231219,44006895,0,0,1,0,2856,7202584,44757812
Slovakia,2022-12-22,51962929,51962929,2533,https://korona.gov.sk/,7231219,44006895,0,0,1,0,2533,7202584,44760345
Slovakia,2022-12-23,51962929,51962929,0,https://korona.gov.sk/,7231219,44006895,0,0,1,0,0,7202584,44760345
Slovakia,2022-12-24,51962929,51962929,0,https://korona.gov.sk/,7231219,44006895,0,0,1,0,0,7202584,44760345
Slovakia,2022-12-25,51968355,51968355,5426,https://korona.gov.sk/,7231219,44006895,0,0,1,0,5426,7202584,44765771
Slovakia,2022-12-26,51969246,51969246,891,https://korona.gov.sk/,7231219,44006895,0,0,1,0,891,7202584,44766662
Slovakia,2022-12-27,51972843,51972843,3597,https://korona.gov.sk/,7231219,44006895,0,0,1,0,3597,7202584,44770259
Slovakia,2022-12-28,51975652,51975652,2809,https://korona.gov.sk/,7231219,44006895,0,0,1,0,2809,7202584,44773068
Slovakia,2022-12-29,51978254,51978254,2602,https://korona.gov.sk/,7231219,44006895,0,0,1,0,2602,7202584,44775670
Slovakia,2022-12-30,51980195,51980195,1941,https://korona.gov.sk/,7231219,44006895,0,0,1,0,1941,7202584,44777611
Slovakia,2022-12-31,51980822,51980822,627,https://korona.gov.sk/,7231219,44006895,0,0,1,0,627,7202584,44778238
Slovakia,2023-01-01,51981093,51981093,271,https://korona.gov.sk/,7231219,44006895,0,0,1,0,271,7202584,44778509
Slovakia,2023-01-02,51981093,51981093,0,https://korona.gov.sk/,7231219,44006895,0,0,1,0,0,7202584,44778509
Slovakia,2023-01-03,51981093,51981093,0,https://korona.gov.sk/,7231219,44006895,0,0,1,0,0,7202584,44778509
Slovakia,2023-01-04,51992041,51992041,10948,https://korona.gov.sk/,7231219,44006895,0,0,1,0,10948,7202584,44789457
Slovakia,2023-01-05,51994796,51994796,2755,https://korona.gov.sk/,7231219,44006895,0,0,1,0,2755,7202584,44792212
Slovakia,2023-01-06,51995584,51995584,788,https://korona.gov.sk/,7231219,44006895,0,0,1,0,788,7202584,44793000
Slovakia,2023-01-07,51996295,51996295,711,https://korona.gov.sk/,7231219,44006895,0,0,1,0,711,7202584,44793711
Slovakia,2023-01-08,51997219,51997219,924,https://korona.gov.sk/,7231219,44006895,0,0,1,0,924,7202584,44794635
Slovakia,2023-01-09,52001276,52001276,4057,https://korona.gov.sk/,7231219,44006895,0,0,1,0,4057,7202584,44798692
Slovakia,2023-01-10,52004324,52004324,3048,https://korona.gov.sk/,7231219,44006895,0,0,1,0,3048,7202584,44801740
Slovakia,2023-01-11,52004324,52004324,0,https://korona.gov.sk/,7231219,44006895,0,0,1,0,0,7202584,44801740
Slovakia,2023-01-12,52010799,52010799,6475,https://korona.gov.sk/,7231219,44006895,0,0,1,0,6475,7202584,44808215
Slovakia,2023-01-13,52016719,52016719,5920,https://korona.gov.sk/,7231219,44006895,0,0,1,0,5920,7202584,44814135
Slovakia,2023-01-14,52017443,52017443,724,https://korona.gov.sk/,7231219,44006895,0,0,1,0,724,7202584,44814859
Slovakia,2023-01-15,52017795,52017795,352,https://korona.gov.sk/,7231219,44006895,0,0,1,0,352,7202584,44815211
Slovakia,2023-01-16,52021926,52021926,4131,https://korona.gov.sk/,7231219,44006895,0,0,1,0,4131,7202584,44819342
Slovakia,2023-01-17,52024789,52024789,2863,https://korona.gov.sk/,7231219,44006895,0,0,1,0,2863,7202584,44822205
Slovakia,2023-01-18,52024789,52024789,0,https://korona.gov.sk/,7231219,44006895,0,0,1,0,0,7202584,44822205
Slovakia,2023-01-19,52032226,52032226,7437,https://korona.gov.sk/,7231219,44006895,0,0,1,0,7437,7202584,44829642
Slovakia,2023-01-20,52034610,52034610,2384,https://korona.gov.sk/,7231219,44006895,0,0,1,0,2384,7202584,44832026
Slovakia,2023-01-21,52035266,52035266,656,https://korona.gov.sk/,7231219,44006895,0,0,1,0,656,7202584,44832682
Slovakia,2023-01-22,52035864,52035864,598,https://korona.gov.sk/,7231219,44006895,0,0,1,0,598,7202584,44833280
Slovakia,2023-01-23,52038764,52038764,2900,https://korona.gov.sk/,7231219,44006895,0,0,1,0,2900,7202584,44836180
Slovakia,2023-01-24,52041473,52041473,2709,https://korona.gov.sk/,7231219,44006895,0,0,1,0,2709,7202584,44838889
Slovakia,2023-01-25,52045708,52045708,4235,https://korona.gov.sk/,7231219,44006895,0,0,1,0,4235,7202584,44843124
Slovakia,2023-01-26,52047932,52047932,2224,https://korona.gov.sk/,7231219,44006895,0,0,1,0,2224,7202584,44845348
Slovakia,2023-01-27,52049711,52049711,1779,https://korona.gov.sk/,7231219,44006895,0,0,1,0,1779,7202584,44847127
Slovakia,2023-01-28,52050400,52050400,689,https://korona.gov.sk/,7231219,44006895,0,0,1,0,689,7202584,44847816
Slovakia,2023-01-29,52050400,52050400,0,https://korona.gov.sk/,7231219,44006895,0,0,1,0,0,7202584,44847816
Slovakia,2023-01-30,52054247,52054247,3847,https://korona.gov.sk/,7231219,44006895,0,0,1,0,3847,7202584,44851663
Slovakia,2023-01-31,52057548,52057548,3301,https://korona.gov.sk/,7231219,44006895,0,0,1,0,3301,7202584,44854964
Slovakia,2023-02-01,52061572,52061572,4024,https://korona.gov.sk/,7231219,44006895,0,0,1,0,4024,7202584,44858988
Slovakia,2023-02-02,52064594,52064594,3022,https://korona.gov.sk/,7231219,44006895,0,0,1,0,3022,7202584,44862010
Slovakia,2023-02-03,52068374,52068374,3780,https://korona.gov.sk/,7231219,44006895,0,0,1,0,3780,7202584,44865790
Slovakia,2023-02-04,52069107,52069107,733,https://korona.gov.sk/,7231219,44006895,0,0,1,0,733,7202584,44866523
Slovakia,2023-02-05,52069940,52069940,833,https://korona.gov.sk/,7231219,44006895,0,0,1,0,833,7202584,44867356
Slovakia,2023-02-06,52073985,52073985,4045,https://korona.gov.sk/,7231219,44006895,0,0,1,0,4045,7202584,44871401
Slovakia,2023-02-07,52076661,52076661,2676,https://korona.gov.sk/,7231219,44006895,0,0,1,0,2676,7202584,44874077
Slovakia,2023-02-08,52080274,52080274,3613,https://korona.gov.sk/,7231219,44006895,0,0,1,0,3613,7202584,44877690
Slovakia,2023-02-09,52082094,52082094,1820,https://korona.gov.sk/,7231219,44006895,0,0,1,0,1820,7202584,44879510
Slovakia,2023-02-10,82085127,82085127,30003033,https://korona.gov.sk/,7231219,44006895,0,0,1,0,30003033,7202584,74882543
Slovakia,2023-02-11,82085709,82085709,582,https://korona.gov.sk/,7231219,44006895,0,0,1,0,582,7202584,74883125
Slovakia,2023-02-12,82085973,82085973,264,https://korona.gov.sk/,7231219,44006895,0,0,1,0,264,7202584,74883389
Slovakia,2023-02-13,52090386,82085973,0,https://korona.gov.sk/,7231219,44006895,0,0,1,0,0,7202584,74883389
Slovakia,2023-02-14,52090386,82085973,0,https://korona.gov.sk/,7231219,44006895,0,0,1,0,0,7202584,74883389
Slovenia,2021-03-23,2427812,2427812,53578,https://www.nijz.si/sl/dnevno-spremljanje-okuzb-s-sars-cov-2-covid-19,1014210,1413602,5022,48556,0.9062674978535966,5022,48556,1014210,1413602
Slovenia,2021-03-24,2462511,2462511,34699,https://www.nijz.si/sl/dnevno-spremljanje-okuzb-s-sars-cov-2-covid-19,1021189,1441322,6979,27720,0.7988702844462376,6979,27720,1021189,1441322
Slovenia,2021-03-25,2500287,2500287,37776,https://www.nijz.si/sl/dnevno-spremljanje-okuzb-s-sars-cov-2-covid-19,1027621,1472666,6432,31344,0.829733163913596,6432,31344,1027621,1472666
Slovenia,2021-03-26,2535274,2535274,34987,https://www.nijz.si/sl/dnevno-spremljanje-okuzb-s-sars-cov-2-covid-19,1034258,1501016,6637,28350,0.8103009689313173,6637,28350,1034258,1501016
Slovenia,2021-03-27,2575248,2575248,39974,https://www.nijz.si/sl/dnevno-spremljanje-okuzb-s-sars-cov-2-covid-19,1041034,1534214,6776,33198,0.8304898183819482,6776,33198,1041034,1534214
Slovenia,2021-03-28,2586119,2586119,10871,https://www.nijz.si/sl/dnevno-spremljanje-okuzb-s-sars-cov-2-covid-19,1044495,1541624,3461,7410,0.6816300248367215,3461,7410,1044495,1541624
Slovenia,2021-03-29,2594516,2594516,8397,https://www.nijz.si/sl/dnevno-spremljanje-okuzb-s-sars-cov-2-covid-19,1046269,1548247,1774,6623,0.788734071692271,1774,6623,1046269,1548247
Slovenia,2021-03-30,2648501,2648501,53985,https://www.nijz.si/sl/dnevno-spremljanje-okuzb-s-sars-cov-2-covid-19,1051664,1596837,5395,48590,0.9000648328239326,5395,48590,1051664,1596837
Slovenia,2021-03-31,2682080,2682080,33579,https://www.nijz.si/sl/dnevno-spremljanje-okuzb-s-sars-cov-2-covid-19,1058870,1623210,7206,26373,0.7854015902796391,7206,26373,1058870,1623210
Slovenia,2021-04-01,2710785,2710785,28705,https://www.nijz.si/sl/dnevno-spremljanje-okuzb-s-sars-cov-2-covid-19,1064492,1646293,5622,23083,0.8041456192300993,5622,23083,1064492,1646293
Slovenia,2021-04-02,2735587,2735587,24802,https://www.nijz.si/sl/dnevno-spremljanje-okuzb-s-sars-cov-2-covid-19,1069845,1665742,5353,19449,0.7841706314006935,5353,19449,1069845,1665742
Slovenia,2021-04-03,2760368,2760368,24781,https://www.nijz.si/sl/dnevno-spremljanje-okuzb-s-sars-cov-2-covid-19,1074848,1685520,5003,19778,0.7981114563576934,5003,19778,1074848,1685520
Slovenia,2021-04-04,2767404,2767404,7036,https://www.nijz.si/sl/dnevno-spremljanje-okuzb-s-sars-cov-2-covid-19,1077645,1689759,2797,4239,0.6024729960204662,2797,4239,1077645,1689759
Slovenia,2021-04-05,2770334,2770334,2930,https://www.nijz.si/sl/dnevno-spremljanje-okuzb-s-sars-cov-2-covid-19,1079181,1691153,1536,1394,0.4757679180887372,1536,1394,1079181,1691153
Slovenia,2021-04-06,2775896,2775896,5562,https://www.nijz.si/sl/dnevno-spremljanje-okuzb-s-sars-cov-2-covid-19,1081060,1694836,1879,3683,0.6621718806184825,1879,3683,1081060,1694836
Slovenia,2021-04-07,2811624,2811624,35728,https://www.nijz.si/sl/dnevno-spremljanje-okuzb-s-sars-cov-2-covid-19,1085872,1725752,4812,30916,0.8653157187639946,4812,30916,1085872,1725752
Slovenia,2021-04-08,2839758,2839758,28134,https://www.nijz.si/sl/dnevno-spremljanje-okuzb-s-sars-cov-2-covid-19,1091232,1748526,5360,22774,0.8094831876021895,5360,22774,1091232,1748526
Slovenia,2021-04-09,2867308,2867308,27550,https://www.nijz.si/sl/dnevno-spremljanje-okuzb-s-sars-cov-2-covid-19,1096430,1770878,5198,22352,0.8113248638838475,5198,22352,1096430,1770878
Slovenia,2021-04-10,2899648,2899648,32340,https://www.nijz.si/sl/dnevno-spremljanje-okuzb-s-sars-cov-2-covid-19,1101160,1798488,4730,27610,0.8537414965986394,4730,27610,1101160,1798488
Slovenia,2021-04-11,2910284,2910284,10636,https://www.nijz.si/sl/dnevno-spremljanje-okuzb-s-sars-cov-2-covid-19,1104024,1806260,2864,7772,0.7307258367807447,2864,7772,1104024,1806260
Slovenia,2021-04-12,2917836,2917836,7552,https://www.nijz.si/sl/dnevno-spremljanje-okuzb-s-sars-cov-2-covid-19,1105508,1812328,1484,6068,0.8034957627118644,1484,6068,1105508,1812328
Slovenia,2021-04-13,2967695,2967695,49859,https://www.nijz.si/sl/dnevno-spremljanje-okuzb-s-sars-cov-2-covid-19,1110096,1857599,4588,45271,0.9079805050241682,4588,45271,1110096,1857599
Slovenia,2021-04-14,2997904,2997904,30209,https://www.nijz.si/sl/dnevno-spremljanje-okuzb-s-sars-cov-2-covid-19,1115402,1882502,5306,24903,0.824356979708034,5306,24903,1115402,1882502
Slovenia,2021-04-15,3027200,3027200,29296,https://www.nijz.si/sl/dnevno-spremljanje-okuzb-s-sars-cov-2-covid-19,1119680,1907520,4278,25018,0.8539732386673948,4278,25018,1119680,1907520
Slovenia,2021-04-16,3056906,3056906,29706,https://www.nijz.si/sl/dnevno-spremljanje-okuzb-s-sars-cov-2-covid-19,1123933,1932973,4253,25453,0.8568302699791288,4253,25453,1123933,1932973
Slovenia,2021-04-17,3095660,3095660,38754,https://www.nijz.si/sl/dnevno-spremljanje-okuzb-s-sars-cov-2-covid-19,1127685,1967975,3752,35002,0.903184187438716,3752,35002,1127685,1967975
Slovenia,2021-04-18,3105803,3105803,10143,https://www.nijz.si/sl/dnevno-spremljanje-okuzb-s-sars-cov-2-covid-19,1130305,1975498,2620,7523,0.7416937789608598,2620,7523,1130305,1975498
Slovenia,2021-04-19,3114203,3114203,8400,https://www.nijz.si/sl/dnevno-spremljanje-okuzb-s-sars-cov-2-covid-19,1131910,1982293,1605,6795,0.8089285714285714,1605,6795,1131910,1982293
Slovenia,2021-04-20,3158313,3158313,44110,https://www.nijz.si/sl/dnevno-spremljanje-okuzb-s-sars-cov-2-covid-19,1135447,2022866,3537,40573,0.9198141011108593,3537,40573,1135447,2022866
Slovenia,2021-04-21,3190307,3190307,31994,https://www.nijz.si/sl/dnevno-spremljanje-okuzb-s-sars-cov-2-covid-19,1140285,2050022,4838,27156,0.8487841470275677,4838,27156,1140285,2050022
Slovenia,2021-04-22,3221939,3221939,31632,https://www.nijz.si/sl/dnevno-spremljanje-okuzb-s-sars-cov-2-covid-19,1144543,2077396,4258,27374,0.8653894790085989,4258,27374,1144543,2077396
Slovenia,2021-04-23,3259848,3259848,37909,https://www.nijz.si/sl/dnevno-spremljanje-okuzb-s-sars-cov-2-covid-19,1151493,2108355,6950,30959,0.8166662270173309,6950,30959,1151493,2108355
Slovenia,2021-04-24,3308350,3308350,48502,https://www.nijz.si/sl/dnevno-spremljanje-okuzb-s-sars-cov-2-covid-19,1156673,2151677,5180,43322,0.8932002804008082,5180,43322,1156673,2151677
Slovenia,2021-04-25,3320562,3320562,12212,https://www.nijz.si/sl/dnevno-spremljanje-okuzb-s-sars-cov-2-covid-19,1159363,2161199,2690,9522,0.7797248607926629,2690,9522,1159363,2161199
Slovenia,2021-04-26,3328568,3328568,8006,https://www.nijz.si/sl/dnevno-spremljanje-okuzb-s-sars-cov-2-covid-19,1160717,2167851,1354,6652,0.8308768423682238,1354,6652,1160717,2167851
Slovenia,2021-04-27,3364821,3364821,36253,https://www.nijz.si/sl/dnevno-spremljanje-okuzb-s-sars-cov-2-covid-19,1164370,2200451,3653,32600,0.8992359253027336,3653,32600,1164370,2200451
Slovenia,2021-04-28,3371271,3371271,6450,https://www.nijz.si/sl/dnevno-spremljanje-okuzb-s-sars-cov-2-covid-19,1166377,2204894,2007,4443,0.6888372093023256,2007,4443,1166377,2204894
Slovenia,2021-04-29,3410993,3410993,39722,https://www.nijz.si/sl/dnevno-spremljanje-okuzb-s-sars-cov-2-covid-19,1170314,2240679,3937,35785,0.9008861588036856,3937,35785,1170314,2240679
Slovenia,2021-04-30,3448776,3448776,37783,https://www.nijz.si/sl/dnevno-spremljanje-okuzb-s-sars-cov-2-covid-19,1174756,2274020,4442,33341,0.8824338988433952,4442,33341,1174756,2274020
Slovenia,2021-05-01,3488998,3488998,40222,https://www.nijz.si/sl/dnevno-spremljanje-okuzb-s-sars-cov-2-covid-19,1178953,2310045,4197,36025,0.89565411963602,4197,36025,1178953,2310045
Slovenia,2021-05-02,3496430,3496430,7432,https://www.nijz.si/sl/dnevno-spremljanje-okuzb-s-sars-cov-2-covid-19,1180780,2315650,1827,5605,0.7541711517761034,1827,5605,1180780,2315650
Slovenia,2021-05-03,3505109,3505109,8679,https://www.nijz.si/sl/dnevno-spremljanje-okuzb-s-sars-cov-2-covid-19,1182160,2322949,1380,7299,0.840995506394746,1380,7299,1182160,2322949
Slovenia,2021-05-04,3555342,3555342,50233,https://www.nijz.si/sl/dnevno-spremljanje-okuzb-s-sars-cov-2-covid-19,1186184,2369158,4024,46209,0.9198932972348854,4024,46209,1186184,2369158
Slovenia,2021-05-05,3587352,3587352,32010,https://www.nijz.si/sl/dnevno-spremljanje-okuzb-s-sars-cov-2-covid-19,1190939,2396413,4755,27255,0.8514526710402999,4755,27255,1190939,2396413
Slovenia,2021-05-06,3622285,3622285,34933,https://www.nijz.si/sl/dnevno-spremljanje-okuzb-s-sars-cov-2-covid-19,1195168,2427117,4229,30704,0.8789396845389746,4229,30704,1195168,2427117
Slovenia,2021-05-07,3658420,3658420,36135,https://www.nijz.si/sl/dnevno-spremljanje-okuzb-s-sars-cov-2-covid-19,1199197,2459223,4029,32106,0.8885014528850145,4029,32106,1199197,2459223
Slovenia,2021-05-08,3702602,3702602,44182,https://www.nijz.si/sl/dnevno-spremljanje-okuzb-s-sars-cov-2-covid-19,1203524,2499078,4327,39855,0.9020641890362591,4327,39855,1203524,2499078
Slovenia,2021-05-09,3713944,3713944,11342,https://www.nijz.si/sl/dnevno-spremljanje-okuzb-s-sars-cov-2-covid-19,1205930,2508014,2406,8936,0.7878681008640451,2406,8936,1205930,2508014
Slovenia,2021-05-10,3722637,3722637,8693,https://www.nijz.si/sl/dnevno-spremljanje-okuzb-s-sars-cov-2-covid-19,1207240,2515397,1310,7383,0.8493040377315081,1310,7383,1207240,2515397
Slovenia,2021-05-11,3771768,3771768,49131,https://www.nijz.si/sl/dnevno-spremljanje-okuzb-s-sars-cov-2-covid-19,1210882,2560886,3642,45489,0.9258716492642121,3642,45489,1210882,2560886
Slovenia,2021-05-12,3804887,3804887,33119,https://www.nijz.si/sl/dnevno-spremljanje-okuzb-s-sars-cov-2-covid-19,1215660,2589227,4778,28341,0.8557323590688125,4778,28341,1215660,2589227
Slovenia,2021-05-13,3839630,3839630,34743,https://www.nijz.si/sl/dnevno-spremljanje-okuzb-s-sars-cov-2-covid-19,1220298,2619332,4638,30105,0.8665054831189016,4638,30105,1220298,2619332
Slovenia,2021-05-14,3874926,3874926,35296,https://www.nijz.si/sl/dnevno-spremljanje-okuzb-s-sars-cov-2-covid-19,1224259,2650667,3961,31335,0.8877776518585675,3961,31335,1224259,2650667
Slovenia,2021-05-15,3921889,3921889,46963,https://www.nijz.si/sl/dnevno-spremljanje-okuzb-s-sars-cov-2-covid-19,1228436,2693453,4177,42786,0.9110576411217342,4177,42786,1228436,2693453
Slovenia,2021-05-16,3933930,3933930,12041,https://www.nijz.si/sl/dnevno-spremljanje-okuzb-s-sars-cov-2-covid-19,1230907,2703023,2471,9570,0.794784486338344,2471,9570,1230907,2703023
Slovenia,2021-05-17,3942990,3942990,9060,https://www.nijz.si/sl/dnevno-spremljanje-okuzb-s-sars-cov-2-covid-19,1232411,2710579,1504,7556,0.8339955849889624,1504,7556,1232411,2710579
Slovenia,2021-05-18,3992198,3992198,49208,https://www.nijz.si/sl/dnevno-spremljanje-okuzb-s-sars-cov-2-covid-19,1236643,2755555,4232,44976,0.9139977239473256,4232,44976,1236643,2755555
Slovenia,2021-05-19,4026829,4026829,34631,https://www.nijz.si/sl/dnevno-spremljanje-okuzb-s-sars-cov-2-covid-19,1241112,2785717,4469,30162,0.8709537697438711,4469,30162,1241112,2785717
Slovenia,2021-05-20,4060952,4060952,34123,https://www.nijz.si/sl/dnevno-spremljanje-okuzb-s-sars-cov-2-covid-19,1244964,2815988,3852,30271,0.8871142631069953,3852,30271,1244964,2815988
Slovenia,2021-05-21,4102985,4102985,42033,https://www.nijz.si/sl/dnevno-spremljanje-okuzb-s-sars-cov-2-covid-19,1249100,2853885,4136,37897,0.9016011229272238,4136,37897,1249100,2853885
Slovenia,2021-05-22,4151440,4151440,48455,https://www.nijz.si/sl/dnevno-spremljanje-okuzb-s-sars-cov-2-covid-19,1252905,2898535,3805,44650,0.9214735321432257,3805,44650,1252905,2898535
Slovenia,2021-05-23,4163636,4163636,12196,https://www.nijz.si/sl/dnevno-spremljanje-okuzb-s-sars-cov-2-covid-19,1255260,2908376,2355,9841,0.8069039029189898,2355,9841,1255260,2908376
Slovenia,2021-05-24,4172408,4172408,8772,https://www.nijz.si/sl/dnevno-spremljanje-okuzb-s-sars-cov-2-covid-19,1256665,2915743,1405,7367,0.8398312813497492,1405,7367,1256665,2915743
Slovenia,2021-05-25,4221468,4221468,49060,https://www.nijz.si/sl/dnevno-spremljanje-okuzb-s-sars-cov-2-covid-19,1260223,2961245,3558,45502,0.9274765593151243,3558,45502,1260223,2961245
Slovenia,2021-05-26,4255513,4255513,34045,https://www.nijz.si/sl/dnevno-spremljanje-okuzb-s-sars-cov-2-covid-19,1264460,2991053,4237,29808,0.8755470700543398,4237,29808,1264460,2991053
Slovenia,2021-05-27,4291136,4291136,35623,https://www.nijz.si/sl/dnevno-spremljanje-okuzb-s-sars-cov-2-covid-19,1268472,3022664,4012,31611,0.8873761333969626,4012,31611,1268472,3022664
Slovenia,2021-05-28,4329417,4329417,38281,https://www.nijz.si/sl/dnevno-spremljanje-okuzb-s-sars-cov-2-covid-19,1272058,3057359,3586,34695,0.9063242861994201,3586,34695,1272058,3057359
Slovenia,2021-05-29,4379393,4379393,49976,https://www.nijz.si/sl/dnevno-spremljanje-okuzb-s-sars-cov-2-covid-19,1275760,3103633,3702,46274,0.9259244437329919,3702,46274,1275760,3103633
Slovenia,2021-05-30,4389901,4389901,10508,https://www.nijz.si/sl/dnevno-spremljanje-okuzb-s-sars-cov-2-covid-19,1277612,3112289,1852,8656,0.8237533307955843,1852,8656,1277612,3112289
Slovenia,2021-05-31,4399594,4399594,9693,https://www.nijz.si/sl/dnevno-spremljanje-okuzb-s-sars-cov-2-covid-19,1279116,3120478,1504,8189,0.8448364799339729,1504,8189,1279116,3120478
Slovenia,2021-06-01,4447382,4447382,47788,https://www.nijz.si/sl/dnevno-spremljanje-okuzb-s-sars-cov-2-covid-19,1282498,3164884,3382,44406,0.9292290951703357,3382,44406,1282498,3164884
Slovenia,2021-06-02,4478682,4478682,31300,https://www.nijz.si/sl/dnevno-spremljanje-okuzb-s-sars-cov-2-covid-19,1286664,3192018,4166,27134,0.8669009584664537,4166,27134,1286664,3192018
Slovenia,2021-06-03,4510076,4510076,31394,https://www.nijz.si/sl/dnevno-spremljanje-okuzb-s-sars-cov-2-covid-19,1290501,3219575,3837,27557,0.8777791934764605,3837,27557,1290501,3219575
Slovenia,2021-06-04,4547029,4547029,36953,https://www.nijz.si/sl/dnevno-spremljanje-okuzb-s-sars-cov-2-covid-19,1294416,3252613,3915,33038,0.8940546099098855,3915,33038,1294416,3252613
Slovenia,2021-06-05,4594972,4594972,47943,https://www.nijz.si/sl/dnevno-spremljanje-okuzb-s-sars-cov-2-covid-19,1297880,3297092,3464,44479,0.9277475335293995,3464,44479,1297880,3297092
Slovenia,2021-06-06,4606258,4606258,11286,https://www.nijz.si/sl/dnevno-spremljanje-okuzb-s-sars-cov-2-covid-19,1300136,3306122,2256,9030,0.8001063264221159,2256,9030,1300136,3306122
Slovenia,2021-06-07,4616050,4616050,9792,https://www.nijz.si/sl/dnevno-spremljanje-okuzb-s-sars-cov-2-covid-19,1301465,3314585,1329,8463,0.8642769607843137,1329,8463,1301465,3314585
Slovenia,2021-06-08,4660062,4660062,44012,https://www.nijz.si/sl/dnevno-spremljanje-okuzb-s-sars-cov-2-covid-19,1304513,3355549,3048,40964,0.9307461601381442,3048,40964,1304513,3355549
Slovenia,2021-06-09,4689101,4689101,29039,https://www.nijz.si/sl/dnevno-spremljanje-okuzb-s-sars-cov-2-covid-19,1308019,3381082,3506,25533,0.879265814938531,3506,25533,1308019,3381082
Slovenia,2021-06-10,4689101,4689101,0,https://www.nijz.si/sl/dnevno-spremljanje-okuzb-s-sars-cov-2-covid-19,1308019,3381082,0,0,0.879265814938531,0,0,1308019,3381082
Slovenia,2021-06-11,4689101,4689101,0,https://www.nijz.si/sl/dnevno-spremljanje-okuzb-s-sars-cov-2-covid-19,1308019,3381082,0,0,0.879265814938531,0,0,1308019,3381082
Slovenia,2021-06-12,4689101,4689101,0,https://www.nijz.si/sl/dnevno-spremljanje-okuzb-s-sars-cov-2-covid-19,1308019,3381082,0,0,0.879265814938531,0,0,1308019,3381082
Slovenia,2021-06-13,4689101,4689101,0,https://www.nijz.si/sl/dnevno-spremljanje-okuzb-s-sars-cov-2-covid-19,1308019,3381082,0,0,0.879265814938531,0,0,1308019,3381082
Slovenia,2021-06-14,4689101,4689101,0,https://www.nijz.si/sl/dnevno-spremljanje-okuzb-s-sars-cov-2-covid-19,1308019,3381082,0,0,0.879265814938531,0,0,1308019,3381082
Slovenia,2021-06-15,4689101,4689101,0,https://www.nijz.si/sl/dnevno-spremljanje-okuzb-s-sars-cov-2-covid-19,1308019,3381082,0,0,0.879265814938531,0,0,1308019,3381082
Slovenia,2021-06-16,4689101,4689101,0,https://www.nijz.si/sl/dnevno-spremljanje-okuzb-s-sars-cov-2-covid-19,1308019,3381082,0,0,0.879265814938531,0,0,1308019,3381082
Slovenia,2021-06-17,4689101,4689101,0,https://www.nijz.si/sl/dnevno-spremljanje-okuzb-s-sars-cov-2-covid-19,1308019,3381082,0,0,0.879265814938531,0,0,1308019,3381082
Slovenia,2021-06-18,4689101,4689101,0,https://www.nijz.si/sl/dnevno-spremljanje-okuzb-s-sars-cov-2-covid-19,1308019,3381082,0,0,0.879265814938531,0,0,1308019,3381082
Slovenia,2021-06-19,4689101,4689101,0,https://www.nijz.si/sl/dnevno-spremljanje-okuzb-s-sars-cov-2-covid-19,1308019,3381082,0,0,0.879265814938531,0,0,1308019,3381082
Slovenia,2021-06-20,4689101,4689101,0,https://www.nijz.si/sl/dnevno-spremljanje-okuzb-s-sars-cov-2-covid-19,1308019,3381082,0,0,0.879265814938531,0,0,1308019,3381082
Slovenia,2021-06-21,4689101,4689101,0,https://www.nijz.si/sl/dnevno-spremljanje-okuzb-s-sars-cov-2-covid-19,1308019,3381082,0,0,0.879265814938531,0,0,1308019,3381082
Slovenia,2021-06-22,4689101,4689101,0,https://www.nijz.si/sl/dnevno-spremljanje-okuzb-s-sars-cov-2-covid-19,1308019,3381082,0,0,0.879265814938531,0,0,1308019,3381082
Slovenia,2021-06-23,4689101,4689101,0,https://www.nijz.si/sl/dnevno-spremljanje-okuzb-s-sars-cov-2-covid-19,1308019,3381082,0,0,0.879265814938531,0,0,1308019,3381082
Slovenia,2021-06-24,4689101,4689101,0,https://www.nijz.si/sl/dnevno-spremljanje-okuzb-s-sars-cov-2-covid-19,1308019,3381082,0,0,0.879265814938531,0,0,1308019,3381082
Slovenia,2021-06-25,4689101,4689101,0,https://www.nijz.si/sl/dnevno-spremljanje-okuzb-s-sars-cov-2-covid-19,1308019,3381082,0,0,0.879265814938531,0,0,1308019,3381082
Slovenia,2021-06-26,4689101,4689101,0,https://www.nijz.si/sl/dnevno-spremljanje-okuzb-s-sars-cov-2-covid-19,1308019,3381082,0,0,0.879265814938531,0,0,1308019,3381082
Slovenia,2021-06-27,4689101,4689101,0,https://www.nijz.si/sl/dnevno-spremljanje-okuzb-s-sars-cov-2-covid-19,1308019,3381082,0,0,0.879265814938531,0,0,1308019,3381082
Slovenia,2021-06-28,4689101,4689101,0,https://www.nijz.si/sl/dnevno-spremljanje-okuzb-s-sars-cov-2-covid-19,1308019,3381082,0,0,0.879265814938531,0,0,1308019,3381082
Slovenia,2021-06-29,4689101,4689101,0,https://www.nijz.si/sl/dnevno-spremljanje-okuzb-s-sars-cov-2-covid-19,1308019,3381082,0,0,0.879265814938531,0,0,1308019,3381082
Slovenia,2021-06-30,4689101,4689101,0,https://www.nijz.si/sl/dnevno-spremljanje-okuzb-s-sars-cov-2-covid-19,1308019,3381082,0,0,0.879265814938531,0,0,1308019,3381082
Slovenia,2021-07-01,4689101,4689101,0,https://www.nijz.si/sl/dnevno-spremljanje-okuzb-s-sars-cov-2-covid-19,1308019,3381082,0,0,0.879265814938531,0,0,1308019,3381082
Slovenia,2021-07-02,4689101,4689101,0,https://www.nijz.si/sl/dnevno-spremljanje-okuzb-s-sars-cov-2-covid-19,1308019,3381082,0,0,0.879265814938531,0,0,1308019,3381082
Slovenia,2021-07-03,4689101,4689101,0,https://www.nijz.si/sl/dnevno-spremljanje-okuzb-s-sars-cov-2-covid-19,1308019,3381082,0,0,0.879265814938531,0,0,1308019,3381082
Slovenia,2021-07-04,4689101,4689101,0,https://www.nijz.si/sl/dnevno-spremljanje-okuzb-s-sars-cov-2-covid-19,1308019,3381082,0,0,0.879265814938531,0,0,1308019,3381082
Slovenia,2021-07-05,5405692,5405692,716591,https://www.nijz.si/sl/dnevno-spremljanje-okuzb-s-sars-cov-2-covid-19,1308019,3381082,0,0,0.879265814938531,86517,630074,1394536,4011156
Slovenia,2021-07-06,5425786,5425786,20094,https://www.nijz.si/sl/dnevno-spremljanje-okuzb-s-sars-cov-2-covid-19,1308019,3381082,0,0,0.879265814938531,2426,17668,1396962,4028824
Slovenia,2021-07-07,5447476,5447476,21690,https://www.nijz.si/sl/dnevno-spremljanje-okuzb-s-sars-cov-2-covid-19,1308019,3381082,0,0,0.879265814938531,2619,19071,1399581,4047895
Slovenia,2021-07-08,5473907,5473907,26431,https://www.nijz.si/sl/dnevno-spremljanje-okuzb-s-sars-cov-2-covid-19,1308019,3381082,0,0,0.879265814938531,3191,23240,1402772,4071135
Slovenia,2021-07-09,5473907,5473907,0,https://www.nijz.si/sl/dnevno-spremljanje-okuzb-s-sars-cov-2-covid-19,1308019,3381082,0,0,0.879265814938531,0,0,1402772,4071135
Slovenia,2021-07-10,5525632,5525632,51725,https://www.nijz.si/sl/dnevno-spremljanje-okuzb-s-sars-cov-2-covid-19,1308019,3381082,0,0,0.879265814938531,6245,45480,1409017,4116615
Slovenia,2021-07-11,5532040,5532040,6408,https://www.nijz.si/sl/dnevno-spremljanje-okuzb-s-sars-cov-2-covid-19,1308019,3381082,0,0,0.879265814938531,774,5634,1409791,4122249
Slovenia,2021-07-12,5560196,5560196,28156,https://www.nijz.si/sl/dnevno-spremljanje-okuzb-s-sars-cov-2-covid-19,1308019,3381082,0,0,0.879265814938531,3399,24757,1413190,4147006
Slovenia,2021-07-13,5579222,5579222,19026,https://www.nijz.si/sl/dnevno-spremljanje-okuzb-s-sars-cov-2-covid-19,1308019,3381082,0,0,0.879265814938531,2297,16729,1415487,4163735
Slovenia,2021-07-14,5601360,5601360,22138,https://www.nijz.si/sl/dnevno-spremljanje-okuzb-s-sars-cov-2-covid-19,1308019,3381082,0,0,0.879265814938531,2673,19465,1418160,4183200
Slovenia,2021-07-15,5601360,5601360,0,https://www.nijz.si/sl/dnevno-spremljanje-okuzb-s-sars-cov-2-covid-19,1308019,3381082,0,0,0.879265814938531,0,0,1418160,4183200
Slovenia,2021-07-16,5668848,5668848,67488,https://www.nijz.si/sl/dnevno-spremljanje-okuzb-s-sars-cov-2-covid-19,1308019,3381082,0,0,0.879265814938531,8148,59340,1426308,4242540
Slovenia,2021-07-17,5684395,5684395,15547,https://www.nijz.si/sl/dnevno-spremljanje-okuzb-s-sars-cov-2-covid-19,1308019,3381082,0,0,0.879265814938531,1877,13670,1428185,4256210
Slovenia,2021-07-18,5692032,5692032,7637,https://www.nijz.si/sl/dnevno-spremljanje-okuzb-s-sars-cov-2-covid-19,1308019,3381082,0,0,0.879265814938531,922,6715,1429107,4262925
Slovenia,2021-07-19,5722104,5722104,30072,https://www.nijz.si/sl/dnevno-spremljanje-okuzb-s-sars-cov-2-covid-19,1308019,3381082,0,0,0.879265814938531,3631,26441,1432738,4289366
Slovenia,2021-07-20,5743525,5743525,21421,https://www.nijz.si/sl/dnevno-spremljanje-okuzb-s-sars-cov-2-covid-19,1308019,3381082,0,0,0.879265814938531,2586,18835,1435324,4308201
Slovenia,2021-07-21,5765930,5765930,22405,https://www.nijz.si/sl/dnevno-spremljanje-okuzb-s-sars-cov-2-covid-19,1308019,3381082,0,0,0.879265814938531,2705,19700,1438029,4327901
Slovenia,2021-07-22,5792673,5792673,26743,https://www.nijz.si/sl/dnevno-spremljanje-okuzb-s-sars-cov-2-covid-19,1308019,3381082,0,0,0.879265814938531,3229,23514,1441258,4351415
Slovenia,2021-07-23,5838758,5838758,46085,https://www.nijz.si/sl/dnevno-spremljanje-okuzb-s-sars-cov-2-covid-19,1308019,3381082,0,0,0.879265814938531,5564,40521,1446822,4391936
Slovenia,2021-07-24,5857409,5857409,18651,https://www.nijz.si/sl/dnevno-spremljanje-okuzb-s-sars-cov-2-covid-19,1308019,3381082,0,0,0.879265814938531,2252,16399,1449074,4408335
Slovenia,2021-07-25,5866347,5866347,8938,https://www.nijz.si/sl/dnevno-spremljanje-okuzb-s-sars-cov-2-covid-19,1308019,3381082,0,0,0.879265814938531,1079,7859,1450153,4416194
Slovenia,2021-07-26,5896252,5896252,29905,https://www.nijz.si/sl/dnevno-spremljanje-okuzb-s-sars-cov-2-covid-19,1308019,3381082,0,0,0.879265814938531,3611,26294,1453764,4442488
Slovenia,2021-07-27,5918361,5918361,22109,https://www.nijz.si/sl/dnevno-spremljanje-okuzb-s-sars-cov-2-covid-19,1308019,3381082,0,0,0.879265814938531,2669,19440,1456433,4461928
Slovenia,2021-07-28,5941170,5941170,22809,https://www.nijz.si/sl/dnevno-spremljanje-okuzb-s-sars-cov-2-covid-19,1308019,3381082,0,0,0.879265814938531,2754,20055,1459187,4481983
Slovenia,2021-07-29,5969700,5969700,28530,https://www.nijz.si/sl/dnevno-spremljanje-okuzb-s-sars-cov-2-covid-19,1308019,3381082,0,0,0.879265814938531,3445,25085,1462632,4507068
Slovenia,2021-07-30,6017863,6017863,48163,https://www.nijz.si/sl/dnevno-spremljanje-okuzb-s-sars-cov-2-covid-19,1308019,3381082,0,0,0.879265814938531,5815,42348,1468447,4549416
Slovenia,2021-07-31,6038084,6038084,20221,https://www.nijz.si/sl/dnevno-spremljanje-okuzb-s-sars-cov-2-covid-19,1308019,3381082,0,0,0.879265814938531,2441,17780,1470888,4567196
Slovenia,2021-08-01,6047492,6047492,9408,https://www.nijz.si/sl/dnevno-spremljanje-okuzb-s-sars-cov-2-covid-19,1308019,3381082,0,0,0.879265814938531,1136,8272,1472024,4575468
Slovenia,2021-08-02,6078924,6078924,31432,https://www.nijz.si/sl/dnevno-spremljanje-okuzb-s-sars-cov-2-covid-19,1308019,3381082,0,0,0.879265814938531,3795,27637,1475819,4603105
Slovenia,2021-08-03,6100176,6100176,21252,https://www.nijz.si/sl/dnevno-spremljanje-okuzb-s-sars-cov-2-covid-19,1308019,3381082,0,0,0.879265814938531,2566,18686,1478385,4621791
Slovenia,2021-08-04,6123201,6123201,23025,https://www.nijz.si/sl/dnevno-spremljanje-okuzb-s-sars-cov-2-covid-19,1308019,3381082,0,0,0.879265814938531,2780,20245,1481165,4642036
Slovenia,2021-08-05,6123201,6123201,0,https://www.nijz.si/sl/dnevno-spremljanje-okuzb-s-sars-cov-2-covid-19,1308019,3381082,0,0,0.879265814938531,0,0,1481165,4642036
Slovenia,2021-08-06,6194868,6194868,71667,https://www.nijz.si/sl/dnevno-spremljanje-okuzb-s-sars-cov-2-covid-19,1308019,3381082,0,0,0.879265814938531,8653,63014,1489818,4705050
Slovenia,2021-08-07,6215331,6215331,20463,https://www.nijz.si/sl/dnevno-spremljanje-okuzb-s-sars-cov-2-covid-19,1308019,3381082,0,0,0.879265814938531,2471,17992,1492289,4723042
Slovenia,2021-08-08,6223491,6223491,8160,https://www.nijz.si/sl/dnevno-spremljanje-okuzb-s-sars-cov-2-covid-19,1308019,3381082,0,0,0.879265814938531,985,7175,1493274,4730217
Slovenia,2021-08-09,6253259,6253259,29768,https://www.nijz.si/sl/dnevno-spremljanje-okuzb-s-sars-cov-2-covid-19,1308019,3381082,0,0,0.879265814938531,3594,26174,1496868,4756391
Slovenia,2021-08-10,6275053,6275053,21794,https://www.nijz.si/sl/dnevno-spremljanje-okuzb-s-sars-cov-2-covid-19,1308019,3381082,0,0,0.879265814938531,2631,19163,1499499,4775554
Slovenia,2021-08-11,6298032,6298032,22979,https://www.nijz.si/sl/dnevno-spremljanje-okuzb-s-sars-cov-2-covid-19,1308019,3381082,0,0,0.879265814938531,2774,20205,1502273,4795759
Slovenia,2021-08-12,6323383,6323383,25351,https://www.nijz.si/sl/dnevno-spremljanje-okuzb-s-sars-cov-2-covid-19,1308019,3381082,0,0,0.879265814938531,3061,22290,1505334,4818049
Slovenia,2021-08-13,6323383,6323383,0,https://www.nijz.si/sl/dnevno-spremljanje-okuzb-s-sars-cov-2-covid-19,1308019,3381082,0,0,0.879265814938531,0,0,1505334,4818049
Slovenia,2021-08-14,6392462,6392462,69079,https://www.nijz.si/sl/dnevno-spremljanje-okuzb-s-sars-cov-2-covid-19,1308019,3381082,0,0,0.879265814938531,8340,60739,1513674,4878788
Slovenia,2021-08-15,6401371,6401371,8909,https://www.nijz.si/sl/dnevno-spremljanje-okuzb-s-sars-cov-2-covid-19,1308019,3381082,0,0,0.879265814938531,1076,7833,1514750,4886621
Slovenia,2021-08-16,6432699,6432699,31328,https://www.nijz.si/sl/dnevno-spremljanje-okuzb-s-sars-cov-2-covid-19,1308019,3381082,0,0,0.879265814938531,3782,27546,1518532,4914167
Slovenia,2021-08-17,6455627,6455627,22928,https://www.nijz.si/sl/dnevno-spremljanje-okuzb-s-sars-cov-2-covid-19,1308019,3381082,0,0,0.879265814938531,2768,20160,1521300,4934327
Slovenia,2021-08-18,6479964,6479964,24337,https://www.nijz.si/sl/dnevno-spremljanje-okuzb-s-sars-cov-2-covid-19,1308019,3381082,0,0,0.879265814938531,2938,21399,1524238,4955726
Slovenia,2021-08-19,6508647,6508647,28683,https://www.nijz.si/sl/dnevno-spremljanje-okuzb-s-sars-cov-2-covid-19,1308019,3381082,0,0,0.879265814938531,3463,25220,1527701,4980946
Slovenia,2021-08-20,6508647,6508647,0,https://www.nijz.si/sl/dnevno-spremljanje-okuzb-s-sars-cov-2-covid-19,1308019,3381082,0,0,0.879265814938531,0,0,1527701,4980946
Slovenia,2021-08-21,6583592,6583592,74945,https://www.nijz.si/sl/dnevno-spremljanje-okuzb-s-sars-cov-2-covid-19,1308019,3381082,0,0,0.879265814938531,9048,65897,1536749,5046843
Slovenia,2021-08-22,6595592,6595592,12000,https://www.nijz.si/sl/dnevno-spremljanje-okuzb-s-sars-cov-2-covid-19,1308019,3381082,0,0,0.879265814938531,1449,10551,1538198,5057394
Slovenia,2021-08-23,6625815,6625815,30223,https://www.nijz.si/sl/dnevno-spremljanje-okuzb-s-sars-cov-2-covid-19,1308019,3381082,0,0,0.879265814938531,3649,26574,1541847,5083968
Slovenia,2021-08-24,6647240,6647240,21425,https://www.nijz.si/sl/dnevno-spremljanje-okuzb-s-sars-cov-2-covid-19,1308019,3381082,0,0,0.879265814938531,2587,18838,1544434,5102806
Slovenia,2021-08-25,6670328,6670328,23088,https://www.nijz.si/sl/dnevno-spremljanje-okuzb-s-sars-cov-2-covid-19,1308019,3381082,0,0,0.879265814938531,2788,20300,1547222,5123106
Slovenia,2021-08-26,6670328,6670328,0,https://www.nijz.si/sl/dnevno-spremljanje-okuzb-s-sars-cov-2-covid-19,1308019,3381082,0,0,0.879265814938531,0,0,1547222,5123106
Slovenia,2021-08-27,6730895,6730895,60567,https://www.nijz.si/sl/dnevno-spremljanje-okuzb-s-sars-cov-2-covid-19,1308019,3381082,0,0,0.879265814938531,7313,53254,1554535,5176360
Slovenia,2021-08-28,6748422,6748422,17527,https://www.nijz.si/sl/dnevno-spremljanje-okuzb-s-sars-cov-2-covid-19,1308019,3381082,0,0,0.879265814938531,2116,15411,1556651,5191771
Slovenia,2021-08-29,6748422,6748422,0,https://www.nijz.si/sl/dnevno-spremljanje-okuzb-s-sars-cov-2-covid-19,1308019,3381082,0,0,0.879265814938531,0,0,1556651,5191771
Slovenia,2021-08-30,6793788,6793788,45366,https://www.nijz.si/sl/dnevno-spremljanje-okuzb-s-sars-cov-2-covid-19,1308019,3381082,0,0,0.879265814938531,5477,39889,1562128,5231660
Slovenia,2021-08-31,6821869,6821869,28081,https://www.nijz.si/sl/dnevno-spremljanje-okuzb-s-sars-cov-2-covid-19,1308019,3381082,0,0,0.879265814938531,3390,24691,1565518,5256351
Slovenia,2021-09-01,6846162,6846162,24293,https://www.nijz.si/sl/dnevno-spremljanje-okuzb-s-sars-cov-2-covid-19,1308019,3381082,0,0,0.879265814938531,2933,21360,1568451,5277711
Slovenia,2021-09-02,6846162,6846162,0,https://www.nijz.si/sl/dnevno-spremljanje-okuzb-s-sars-cov-2-covid-19,1308019,3381082,0,0,0.879265814938531,0,0,1568451,5277711
Slovenia,2021-09-03,6846162,6846162,0,https://www.nijz.si/sl/dnevno-spremljanje-okuzb-s-sars-cov-2-covid-19,1308019,3381082,0,0,0.879265814938531,0,0,1568451,5277711
Slovenia,2021-09-04,6930283,6930283,84121,https://www.nijz.si/sl/dnevno-spremljanje-okuzb-s-sars-cov-2-covid-19,1308019,3381082,0,0,0.879265814938531,10156,73965,1578607,5351676
Slovenia,2021-09-05,6938470,6938470,8187,https://www.nijz.si/sl/dnevno-spremljanje-okuzb-s-sars-cov-2-covid-19,1308019,3381082,0,0,0.879265814938531,988,7199,1579595,5358875
Slovenia,2021-09-06,6980605,6980605,42135,https://www.nijz.si/sl/dnevno-spremljanje-okuzb-s-sars-cov-2-covid-19,1308019,3381082,0,0,0.879265814938531,5087,37048,1584682,5395923
Slovenia,2021-09-07,7009087,7009087,28482,https://www.nijz.si/sl/dnevno-spremljanje-okuzb-s-sars-cov-2-covid-19,1308019,3381082,0,0,0.879265814938531,3439,25043,1588121,5420966
Slovenia,2021-09-08,7009087,7009087,0,https://www.nijz.si/sl/dnevno-spremljanje-okuzb-s-sars-cov-2-covid-19,1308019,3381082,0,0,0.879265814938531,0,0,1588121,5420966
Slovenia,2021-09-09,7067406,7067406,58319,https://www.nijz.si/sl/dnevno-spremljanje-okuzb-s-sars-cov-2-covid-19,1308019,3381082,0,0,0.879265814938531,7041,51278,1595162,5472244
Slovenia,2021-09-10,7067406,7067406,0,https://www.nijz.si/sl/dnevno-spremljanje-okuzb-s-sars-cov-2-covid-19,1308019,3381082,0,0,0.879265814938531,0,0,1595162,5472244
Slovenia,2021-09-11,7067406,7067406,0,https://www.nijz.si/sl/dnevno-spremljanje-okuzb-s-sars-cov-2-covid-19,1308019,3381082,0,0,0.879265814938531,0,0,1595162,5472244
Slovenia,2021-09-12,7138638,7138638,71232,https://www.nijz.si/sl/dnevno-spremljanje-okuzb-s-sars-cov-2-covid-19,1308019,3381082,0,0,0.879265814938531,8600,62632,1603762,5534876
Slovenia,2021-09-13,7174037,7174037,35399,https://www.nijz.si/sl/dnevno-spremljanje-okuzb-s-sars-cov-2-covid-19,1308019,3381082,0,0,0.879265814938531,4274,31125,1608036,5566001
Slovenia,2021-09-14,7174037,7174037,0,https://www.nijz.si/sl/dnevno-spremljanje-okuzb-s-sars-cov-2-covid-19,1308019,3381082,0,0,0.879265814938531,0,0,1608036,5566001
Slovenia,2021-09-15,7254733,7254733,80696,https://www.nijz.si/sl/dnevno-spremljanje-okuzb-s-sars-cov-2-covid-19,1308019,3381082,0,0,0.879265814938531,9743,70953,1617779,5636954
Slovenia,2021-09-16,7254733,7254733,0,https://www.nijz.si/sl/dnevno-spremljanje-okuzb-s-sars-cov-2-covid-19,1308019,3381082,0,0,0.879265814938531,0,0,1617779,5636954
Slovenia,2021-09-17,7254733,7254733,0,https://www.nijz.si/sl/dnevno-spremljanje-okuzb-s-sars-cov-2-covid-19,1308019,3381082,0,0,0.879265814938531,0,0,1617779,5636954
Slovenia,2021-09-18,7363636,7363636,108903,https://www.nijz.si/sl/dnevno-spremljanje-okuzb-s-sars-cov-2-covid-19,1308019,3381082,0,0,0.879265814938531,13148,95755,1630927,5732709
Slovenia,2021-09-19,7363636,7363636,0,https://www.nijz.si/sl/dnevno-spremljanje-okuzb-s-sars-cov-2-covid-19,1308019,3381082,0,0,0.879265814938531,0,0,1630927,5732709
Slovenia,2021-09-20,7421462,7421462,57826,https://www.nijz.si/sl/dnevno-spremljanje-okuzb-s-sars-cov-2-covid-19,1308019,3381082,0,0,0.879265814938531,6982,50844,1637909,5783553
Slovenia,2021-09-21,7457010,7457010,35548,https://www.nijz.si/sl/dnevno-spremljanje-okuzb-s-sars-cov-2-covid-19,1308019,3381082,0,0,0.879265814938531,4292,31256,1642201,5814809
Slovenia,2021-09-22,7494342,7494342,37332,https://www.nijz.si/sl/dnevno-spremljanje-okuzb-s-sars-cov-2-covid-19,1308019,3381082,0,0,0.879265814938531,4507,32825,1646708,5847634
Slovenia,2021-09-23,7528025,7528025,33683,https://www.nijz.si/sl/dnevno-spremljanje-okuzb-s-sars-cov-2-covid-19,1308019,3381082,0,0,0.879265814938531,4067,29616,1650775,5877250
Slovenia,2021-09-24,7528025,7528025,0,https://www.nijz.si/sl/dnevno-spremljanje-okuzb-s-sars-cov-2-covid-19,1308019,3381082,0,0,0.879265814938531,0,0,1650775,5877250
Slovenia,2021-09-25,7528025,7528025,0,https://www.nijz.si/sl/dnevno-spremljanje-okuzb-s-sars-cov-2-covid-19,1308019,3381082,0,0,0.879265814938531,0,0,1650775,5877250
Slovenia,2021-09-26,7528025,7528025,0,https://www.nijz.si/sl/dnevno-spremljanje-okuzb-s-sars-cov-2-covid-19,1308019,3381082,0,0,0.879265814938531,0,0,1650775,5877250
Slovenia,2021-09-27,7528025,7528025,0,https://www.nijz.si/sl/dnevno-spremljanje-okuzb-s-sars-cov-2-covid-19,1308019,3381082,0,0,0.879265814938531,0,0,1650775,5877250
Slovenia,2021-09-28,7528025,7528025,0,https://www.nijz.si/sl/dnevno-spremljanje-okuzb-s-sars-cov-2-covid-19,1308019,3381082,0,0,0.879265814938531,0,0,1650775,5877250
Slovenia,2021-09-29,7528025,7528025,0,https://www.nijz.si/sl/dnevno-spremljanje-okuzb-s-sars-cov-2-covid-19,1308019,3381082,0,0,0.879265814938531,0,0,1650775,5877250
Slovenia,2021-09-30,7528025,7528025,0,https://www.nijz.si/sl/dnevno-spremljanje-okuzb-s-sars-cov-2-covid-19,1308019,3381082,0,0,0.879265814938531,0,0,1650775,5877250
Slovenia,2021-10-01,7528025,7528025,0,https://www.nijz.si/sl/dnevno-spremljanje-okuzb-s-sars-cov-2-covid-19,1308019,3381082,0,0,0.879265814938531,0,0,1650775,5877250
Slovenia,2021-10-02,7528025,7528025,0,https://www.nijz.si/sl/dnevno-spremljanje-okuzb-s-sars-cov-2-covid-19,1308019,3381082,0,0,0.879265814938531,0,0,1650775,5877250
Slovenia,2021-10-03,7528025,7528025,0,https://www.nijz.si/sl/dnevno-spremljanje-okuzb-s-sars-cov-2-covid-19,1308019,3381082,0,0,0.879265814938531,0,0,1650775,5877250
Slovenia,2021-10-04,7528025,7528025,0,https://www.nijz.si/sl/dnevno-spremljanje-okuzb-s-sars-cov-2-covid-19,1308019,3381082,0,0,0.879265814938531,0,0,1650775,5877250
Slovenia,2021-10-05,7528025,7528025,0,https://www.nijz.si/sl/dnevno-spremljanje-okuzb-s-sars-cov-2-covid-19,1308019,3381082,0,0,0.879265814938531,0,0,1650775,5877250
Slovenia,2021-10-06,7528025,7528025,0,https://www.nijz.si/sl/dnevno-spremljanje-okuzb-s-sars-cov-2-covid-19,1308019,3381082,0,0,0.879265814938531,0,0,1650775,5877250
Slovenia,2021-10-07,7528025,7528025,0,https://www.nijz.si/sl/dnevno-spremljanje-okuzb-s-sars-cov-2-covid-19,1308019,3381082,0,0,0.879265814938531,0,0,1650775,5877250
Slovenia,2021-10-08,7528025,7528025,0,https://www.nijz.si/sl/dnevno-spremljanje-okuzb-s-sars-cov-2-covid-19,1308019,3381082,0,0,0.879265814938531,0,0,1650775,5877250
Slovenia,2021-10-09,7528025,7528025,0,https://www.nijz.si/sl/dnevno-spremljanje-okuzb-s-sars-cov-2-covid-19,1308019,3381082,0,0,0.879265814938531,0,0,1650775,5877250
Slovenia,2021-10-10,7528025,7528025,0,https://www.nijz.si/sl/dnevno-spremljanje-okuzb-s-sars-cov-2-covid-19,1308019,3381082,0,0,0.879265814938531,0,0,1650775,5877250
Slovenia,2021-10-11,8025879,8025879,497854,https://www.nijz.si/sl/dnevno-spremljanje-okuzb-s-sars-cov-2-covid-19,1308019,3381082,0,0,0.879265814938531,60108,437746,1710883,6314996
Slovenia,2021-10-12,8052760,8052760,26881,https://www.nijz.si/sl/dnevno-spremljanje-okuzb-s-sars-cov-2-covid-19,1308019,3381082,0,0,0.879265814938531,3245,23636,1714128,6338632
Slovenia,2021-10-13,8082192,8082192,29432,https://www.nijz.si/sl/dnevno-spremljanje-okuzb-s-sars-cov-2-covid-19,1308019,3381082,0,0,0.879265814938531,3553,25879,1717681,6364511
Slovenia,2021-10-14,8108731,8108731,26539,https://www.nijz.si/sl/dnevno-spremljanje-okuzb-s-sars-cov-2-covid-19,1308019,3381082,0,0,0.879265814938531,3204,23335,1720885,6387846
Slovenia,2021-10-15,8108731,8108731,0,https://www.nijz.si/sl/dnevno-spremljanje-okuzb-s-sars-cov-2-covid-19,1308019,3381082,0,0,0.879265814938531,0,0,1720885,6387846
Slovenia,2021-10-16,8108731,8108731,0,https://www.nijz.si/sl/dnevno-spremljanje-okuzb-s-sars-cov-2-covid-19,1308019,3381082,0,0,0.879265814938531,0,0,1720885,6387846
Slovenia,2021-10-17,8169361,8169361,60630,https://www.nijz.si/sl/dnevno-spremljanje-okuzb-s-sars-cov-2-covid-19,1308019,3381082,0,0,0.879265814938531,7320,53310,1728205,6441156
Slovenia,2021-10-18,8205000,8205000,35639,https://www.nijz.si/sl/dnevno-spremljanje-okuzb-s-sars-cov-2-covid-19,1308019,3381082,0,0,0.879265814938531,4303,31336,1732508,6472492
Slovenia,2021-10-19,8205000,8205000,0,https://www.nijz.si/sl/dnevno-spremljanje-okuzb-s-sars-cov-2-covid-19,1308019,3381082,0,0,0.879265814938531,0,0,1732508,6472492
Slovenia,2021-10-20,8264879,8264879,59879,https://www.nijz.si/sl/dnevno-spremljanje-okuzb-s-sars-cov-2-covid-19,1308019,3381082,0,0,0.879265814938531,7229,52650,1739737,6525142
Slovenia,2021-10-21,8293799,8293799,28920,https://www.nijz.si/sl/dnevno-spremljanje-okuzb-s-sars-cov-2-covid-19,1308019,3381082,0,0,0.879265814938531,3492,25428,1743229,6550570
Slovenia,2021-10-22,8334754,8334754,40955,https://www.nijz.si/sl/dnevno-spremljanje-okuzb-s-sars-cov-2-covid-19,1308019,3381082,0,0,0.879265814938531,4945,36010,1748174,6586580
Slovenia,2021-10-23,8334754,8334754,0,https://www.nijz.si/sl/dnevno-spremljanje-okuzb-s-sars-cov-2-covid-19,1308019,3381082,0,0,0.879265814938531,0,0,1748174,6586580
Slovenia,2021-10-24,8366964,8366964,32210,https://www.nijz.si/sl/dnevno-spremljanje-okuzb-s-sars-cov-2-covid-19,1308019,3381082,0,0,0.879265814938531,3889,28321,1752063,6614901
Slovenia,2021-10-25,8404759,8404759,37795,https://www.nijz.si/sl/dnevno-spremljanje-okuzb-s-sars-cov-2-covid-19,1308019,3381082,0,0,0.879265814938531,4563,33232,1756626,6648133
Slovenia,2021-10-26,8436382,8436382,31623,https://www.nijz.si/sl/dnevno-spremljanje-okuzb-s-sars-cov-2-covid-19,1308019,3381082,0,0,0.879265814938531,3818,27805,1760444,6675938
Slovenia,2021-10-27,8470550,8470550,34168,https://www.nijz.si/sl/dnevno-spremljanje-okuzb-s-sars-cov-2-covid-19,1308019,3381082,0,0,0.879265814938531,4125,30043,1764569,6705981
Slovenia,2021-10-28,8502287,8502287,31737,https://www.nijz.si/sl/dnevno-spremljanje-okuzb-s-sars-cov-2-covid-19,1308019,3381082,0,0,0.879265814938531,3832,27905,1768401,6733886
Slovenia,2021-10-29,8543067,8543067,40780,https://www.nijz.si/sl/dnevno-spremljanje-okuzb-s-sars-cov-2-covid-19,1308019,3381082,0,0,0.879265814938531,4924,35856,1773325,6769742
Slovenia,2021-10-30,8543067,8543067,0,https://www.nijz.si/sl/dnevno-spremljanje-okuzb-s-sars-cov-2-covid-19,1308019,3381082,0,0,0.879265814938531,0,0,1773325,6769742
Slovenia,2021-10-31,8575143,8575143,32076,https://www.nijz.si/sl/dnevno-spremljanje-okuzb-s-sars-cov-2-covid-19,1308019,3381082,0,0,0.879265814938531,3873,28203,1777198,6797945
Slovenia,2021-11-01,8584809,8584809,9666,https://www.nijz.si/sl/dnevno-spremljanje-okuzb-s-sars-cov-2-covid-19,1308019,3381082,0,0,0.879265814938531,1167,8499,1778365,6806444
Slovenia,2021-11-02,8629014,8629014,44205,https://www.nijz.si/sl/dnevno-spremljanje-okuzb-s-sars-cov-2-covid-19,1308019,3381082,0,0,0.879265814938531,5337,38868,1783702,6845312
Slovenia,2021-11-03,8664991,8664991,35977,https://www.nijz.si/sl/dnevno-spremljanje-okuzb-s-sars-cov-2-covid-19,1308019,3381082,0,0,0.879265814938531,4344,31633,1788046,6876945
Slovenia,2021-11-04,8664991,8664991,0,https://www.nijz.si/sl/dnevno-spremljanje-okuzb-s-sars-cov-2-covid-19,1308019,3381082,0,0,0.879265814938531,0,0,1788046,6876945
Slovenia,2021-11-05,8664991,8664991,0,https://www.nijz.si/sl/dnevno-spremljanje-okuzb-s-sars-cov-2-covid-19,1308019,3381082,0,0,0.879265814938531,0,0,1788046,6876945
Slovenia,2021-11-06,8664991,8664991,0,https://www.nijz.si/sl/dnevno-spremljanje-okuzb-s-sars-cov-2-covid-19,1308019,3381082,0,0,0.879265814938531,0,0,1788046,6876945
Slovenia,2021-11-07,8777778,8777778,112787,https://www.nijz.si/sl/dnevno-spremljanje-okuzb-s-sars-cov-2-covid-19,1308019,3381082,0,0,0.879265814938531,13617,99170,1801663,6976115
Slovenia,2021-11-08,8841993,8841993,64215,https://www.nijz.si/sl/dnevno-spremljanje-okuzb-s-sars-cov-2-covid-19,1308019,3381082,0,0,0.879265814938531,7753,56462,1809416,7032577
Slovenia,2021-11-09,8894312,8894312,52319,https://www.nijz.si/sl/dnevno-spremljanje-okuzb-s-sars-cov-2-covid-19,1308019,3381082,0,0,0.879265814938531,6317,46002,1815733,7078579
Slovenia,2021-11-10,8961788,8961788,67476,https://www.nijz.si/sl/dnevno-spremljanje-okuzb-s-sars-cov-2-covid-19,1308019,3381082,0,0,0.879265814938531,8147,59329,1823880,7137908
Slovenia,2021-11-11,9020440,9020440,58652,https://www.nijz.si/sl/dnevno-spremljanje-okuzb-s-sars-cov-2-covid-19,1308019,3381082,0,0,0.879265814938531,7081,51571,1830961,7189479
Slovenia,2021-11-12,9020440,9020440,0,https://www.nijz.si/sl/dnevno-spremljanje-okuzb-s-sars-cov-2-covid-19,1308019,3381082,0,0,0.879265814938531,0,0,1830961,7189479
Slovenia,2021-11-13,9020440,9020440,0,https://www.nijz.si/sl/dnevno-spremljanje-okuzb-s-sars-cov-2-covid-19,1308019,3381082,0,0,0.879265814938531,0,0,1830961,7189479
Slovenia,2021-11-14,9163926,9163926,143486,https://www.nijz.si/sl/dnevno-spremljanje-okuzb-s-sars-cov-2-covid-19,1308019,3381082,0,0,0.879265814938531,17324,126162,1848285,7315641
Slovenia,2021-11-15,9254903,9254903,90977,https://www.nijz.si/sl/dnevno-spremljanje-okuzb-s-sars-cov-2-covid-19,1308019,3381082,0,0,0.879265814938531,10984,79993,1859269,7395634
Slovenia,2021-11-16,9320318,9320318,65415,https://www.nijz.si/sl/dnevno-spremljanje-okuzb-s-sars-cov-2-covid-19,1308019,3381082,0,0,0.879265814938531,7898,57517,1867167,7453151
Slovenia,2021-11-17,9400969,9400969,80651,https://www.nijz.si/sl/dnevno-spremljanje-okuzb-s-sars-cov-2-covid-19,1308019,3381082,0,0,0.879265814938531,9737,70914,1876904,7524065
Slovenia,2021-11-18,9470426,9470426,69457,https://www.nijz.si/sl/dnevno-spremljanje-okuzb-s-sars-cov-2-covid-19,1308019,3381082,0,0,0.879265814938531,8386,61071,1885290,7585136
Slovenia,2021-11-19,9470426,9470426,0,https://www.nijz.si/sl/dnevno-spremljanje-okuzb-s-sars-cov-2-covid-19,1308019,3381082,0,0,0.879265814938531,0,0,1885290,7585136
Slovenia,2021-11-20,9470426,9470426,0,https://www.nijz.si/sl/dnevno-spremljanje-okuzb-s-sars-cov-2-covid-19,1308019,3381082,0,0,0.879265814938531,0,0,1885290,7585136
Slovenia,2021-11-21,9638664,9638664,168238,https://www.nijz.si/sl/dnevno-spremljanje-okuzb-s-sars-cov-2-covid-19,1308019,3381082,0,0,0.879265814938531,20312,147926,1905602,7733062
Slovenia,2021-11-22,9736797,9736797,98133,https://www.nijz.si/sl/dnevno-spremljanje-okuzb-s-sars-cov-2-covid-19,1308019,3381082,0,0,0.879265814938531,11848,86285,1917450,7819347
Slovenia,2021-11-23,9804126,9804126,67329,https://www.nijz.si/sl/dnevno-spremljanje-okuzb-s-sars-cov-2-covid-19,1308019,3381082,0,0,0.879265814938531,8129,59200,1925579,7878547
Slovenia,2021-11-24,9889318,9889318,85192,https://www.nijz.si/sl/dnevno-spremljanje-okuzb-s-sars-cov-2-covid-19,1308019,3381082,0,0,0.879265814938531,10286,74906,1935865,7953453
Slovenia,2021-11-25,9960311,9960311,70993,https://www.nijz.si/sl/dnevno-spremljanje-okuzb-s-sars-cov-2-covid-19,1308019,3381082,0,0,0.879265814938531,8571,62422,1944436,8015875
Slovenia,2021-11-26,9960311,9960311,0,https://www.nijz.si/sl/dnevno-spremljanje-okuzb-s-sars-cov-2-covid-19,1308019,3381082,0,0,0.879265814938531,0,0,1944436,8015875
Slovenia,2021-11-27,9960311,9960311,0,https://www.nijz.si/sl/dnevno-spremljanje-okuzb-s-sars-cov-2-covid-19,1308019,3381082,0,0,0.879265814938531,0,0,1944436,8015875
Slovenia,2021-11-28,10127846,10127846,167535,https://www.nijz.si/sl/dnevno-spremljanje-okuzb-s-sars-cov-2-covid-19,1308019,3381082,0,0,0.879265814938531,20227,147308,1964663,8163183
Slovenia,2021-11-29,10228794,10228794,100948,https://www.nijz.si/sl/dnevno-spremljanje-okuzb-s-sars-cov-2-covid-19,1308019,3381082,0,0,0.879265814938531,12188,88760,1976851,8251943
Slovenia,2021-11-30,10296577,10296577,67783,https://www.nijz.si/sl/dnevno-spremljanje-okuzb-s-sars-cov-2-covid-19,1308019,3381082,0,0,0.879265814938531,8184,59599,1985035,8311542
Slovenia,2021-12-01,10383346,10383346,86769,https://www.nijz.si/sl/dnevno-spremljanje-okuzb-s-sars-cov-2-covid-19,1308019,3381082,0,0,0.879265814938531,10476,76293,1995511,8387835
Slovenia,2021-12-02,10451062,10451062,67716,https://www.nijz.si/sl/dnevno-spremljanje-okuzb-s-sars-cov-2-covid-19,1308019,3381082,0,0,0.879265814938531,8176,59540,2003687,8447375
Slovenia,2021-12-03,10451062,10451062,0,https://www.nijz.si/sl/dnevno-spremljanje-okuzb-s-sars-cov-2-covid-19,1308019,3381082,0,0,0.879265814938531,0,0,2003687,8447375
Slovenia,2021-12-04,10451062,10451062,0,https://www.nijz.si/sl/dnevno-spremljanje-okuzb-s-sars-cov-2-covid-19,1308019,3381082,0,0,0.879265814938531,0,0,2003687,8447375
Slovenia,2021-12-05,10629872,10629872,178810,https://www.nijz.si/sl/dnevno-spremljanje-okuzb-s-sars-cov-2-covid-19,1308019,3381082,0,0,0.879265814938531,21588,157222,2025275,8604597
Slovenia,2021-12-06,10731593,10731593,101721,https://www.nijz.si/sl/dnevno-spremljanje-okuzb-s-sars-cov-2-covid-19,1308019,3381082,0,0,0.879265814938531,12281,89440,2037556,8694037
Slovenia,2021-12-07,10797433,10797433,65840,https://www.nijz.si/sl/dnevno-spremljanje-okuzb-s-sars-cov-2-covid-19,1308019,3381082,0,0,0.879265814938531,7949,57891,2045505,8751928
Slovenia,2021-12-08,10885159,10885159,87726,https://www.nijz.si/sl/dnevno-spremljanje-okuzb-s-sars-cov-2-covid-19,1308019,3381082,0,0,0.879265814938531,10592,77134,2056097,8829062
Slovenia,2021-12-09,10949555,10949555,64396,https://www.nijz.si/sl/dnevno-spremljanje-okuzb-s-sars-cov-2-covid-19,1308019,3381082,0,0,0.879265814938531,7775,56621,2063872,8885683
Slovenia,2021-12-10,10949555,10949555,0,https://www.nijz.si/sl/dnevno-spremljanje-okuzb-s-sars-cov-2-covid-19,1308019,3381082,0,0,0.879265814938531,0,0,2063872,8885683
Slovenia,2021-12-11,10949555,10949555,0,https://www.nijz.si/sl/dnevno-spremljanje-okuzb-s-sars-cov-2-covid-19,1308019,3381082,0,0,0.879265814938531,0,0,2063872,8885683
Slovenia,2021-12-12,11136510,11136510,186955,https://www.nijz.si/sl/dnevno-spremljanje-okuzb-s-sars-cov-2-covid-19,1308019,3381082,0,0,0.879265814938531,22572,164383,2086444,9050066
Slovenia,2021-12-13,11239542,11239542,103032,https://www.nijz.si/sl/dnevno-spremljanje-okuzb-s-sars-cov-2-covid-19,1308019,3381082,0,0,0.879265814938531,12439,90593,2098883,9140659
Slovenia,2021-12-14,11311051,11311051,71509,https://www.nijz.si/sl/dnevno-spremljanje-okuzb-s-sars-cov-2-covid-19,1308019,3381082,0,0,0.879265814938531,8634,62875,2107517,9203534
Slovenia,2021-12-15,11406421,11406421,95370,https://www.nijz.si/sl/dnevno-spremljanje-okuzb-s-sars-cov-2-covid-19,1308019,3381082,0,0,0.879265814938531,11514,83856,2119031,9287390
Slovenia,2021-12-16,11489756,11489756,83335,https://www.nijz.si/sl/dnevno-spremljanje-okuzb-s-sars-cov-2-covid-19,1308019,3381082,0,0,0.879265814938531,10061,73274,2129092,9360664
Slovenia,2021-12-17,11600058,11600058,110302,https://www.nijz.si/sl/dnevno-spremljanje-okuzb-s-sars-cov-2-covid-19,1308019,3381082,0,0,0.879265814938531,13317,96985,2142409,9457649
Slovenia,2021-12-18,11600058,11600058,0,https://www.nijz.si/sl/dnevno-spremljanje-okuzb-s-sars-cov-2-covid-19,1308019,3381082,0,0,0.879265814938531,0,0,2142409,9457649
Slovenia,2021-12-19,11703391,11703391,103333,https://www.nijz.si/sl/dnevno-spremljanje-okuzb-s-sars-cov-2-covid-19,1308019,3381082,0,0,0.879265814938531,12476,90857,2154885,9548506
Slovenia,2021-12-20,11820316,11820316,116925,https://www.nijz.si/sl/dnevno-spremljanje-okuzb-s-sars-cov-2-covid-19,1308019,3381082,0,0,0.879265814938531,14117,102808,2169002,9651314
Slovenia,2021-12-21,11901550,11901550,81234,https://www.nijz.si/sl/dnevno-spremljanje-okuzb-s-sars-cov-2-covid-19,1308019,3381082,0,0,0.879265814938531,9808,71426,2178810,9722740
Slovenia,2021-12-22,11901550,11901550,0,https://www.nijz.si/sl/dnevno-spremljanje-okuzb-s-sars-cov-2-covid-19,1308019,3381082,0,0,0.879265814938531,0,0,2178810,9722740
Slovenia,2021-12-23,11901550,11901550,0,https://www.nijz.si/sl/dnevno-spremljanje-okuzb-s-sars-cov-2-covid-19,1308019,3381082,0,0,0.879265814938531,0,0,2178810,9722740
Slovenia,2021-12-24,11901550,11901550,0,https://www.nijz.si/sl/dnevno-spremljanje-okuzb-s-sars-cov-2-covid-19,1308019,3381082,0,0,0.879265814938531,0,0,2178810,9722740
Slovenia,2021-12-25,11901550,11901550,0,https://www.nijz.si/sl/dnevno-spremljanje-okuzb-s-sars-cov-2-covid-19,1308019,3381082,0,0,0.879265814938531,0,0,2178810,9722740
Slovenia,2021-12-26,11901550,11901550,0,https://www.nijz.si/sl/dnevno-spremljanje-okuzb-s-sars-cov-2-covid-19,1308019,3381082,0,0,0.879265814938531,0,0,2178810,9722740
Slovenia,2021-12-27,11991553,11991553,90003,https://www.nijz.si/sl/dnevno-spremljanje-okuzb-s-sars-cov-2-covid-19,1308019,3381082,0,0,0.879265814938531,10866,79137,2189676,9801877
Slovenia,2021-12-28,12091353,12091353,99800,https://www.nijz.si/sl/dnevno-spremljanje-okuzb-s-sars-cov-2-covid-19,1308019,3381082,0,0,0.879265814938531,12049,87751,2201725,9889628
Slovenia,2021-12-29,12204853,12204853,113500,https://www.nijz.si/sl/dnevno-spremljanje-okuzb-s-sars-cov-2-covid-19,1308019,3381082,0,0,0.879265814938531,13703,99797,2215428,9989425
Slovenia,2021-12-30,12309236,12309236,104383,https://www.nijz.si/sl/dnevno-spremljanje-okuzb-s-sars-cov-2-covid-19,1308019,3381082,0,0,0.879265814938531,12603,91780,2228031,10081205
Slovenia,2021-12-31,12394659,12394659,85423,https://www.nijz.si/sl/dnevno-spremljanje-okuzb-s-sars-cov-2-covid-19,1308019,3381082,0,0,0.879265814938531,10313,75110,2238344,10156315
Slovenia,2022-01-01,12407773,12407773,13114,https://www.nijz.si/sl/dnevno-spremljanje-okuzb-s-sars-cov-2-covid-19,1308019,3381082,0,0,0.879265814938531,1583,11531,2239927,10167846
Slovenia,2022-01-02,12450623,12450623,42850,https://www.nijz.si/sl/dnevno-spremljanje-okuzb-s-sars-cov-2-covid-19,1308019,3381082,0,0,0.879265814938531,5173,37677,2245100,10205523
Slovenia,2022-01-03,12557585,12557585,106962,https://www.nijz.si/sl/dnevno-spremljanje-okuzb-s-sars-cov-2-covid-19,1308019,3381082,0,0,0.879265814938531,12914,94048,2258014,10299571
Slovenia,2022-01-04,12650795,12650795,93210,https://www.nijz.si/sl/dnevno-spremljanje-okuzb-s-sars-cov-2-covid-19,1308019,3381082,0,0,0.879265814938531,11254,81956,2269268,10381527
Slovenia,2022-01-05,12751205,12751205,100410,https://www.nijz.si/sl/dnevno-spremljanje-okuzb-s-sars-cov-2-covid-19,1308019,3381082,0,0,0.879265814938531,12123,88287,2281391,10469814
Slovenia,2022-01-06,12848737,12848737,97532,https://www.nijz.si/sl/dnevno-spremljanje-okuzb-s-sars-cov-2-covid-19,1308019,3381082,0,0,0.879265814938531,11775,85757,2293166,10555571
Slovenia,2022-01-07,12959064,12959064,110327,https://www.nijz.si/sl/dnevno-spremljanje-okuzb-s-sars-cov-2-covid-19,1308019,3381082,0,0,0.879265814938531,13320,97007,2306486,10652578
Slovenia,2022-01-08,13035276,13035276,76212,https://www.nijz.si/sl/dnevno-spremljanje-okuzb-s-sars-cov-2-covid-19,1308019,3381082,0,0,0.879265814938531,9201,67011,2315687,10719589
Slovenia,2022-01-09,13078107,13078107,42831,https://www.nijz.si/sl/dnevno-spremljanje-okuzb-s-sars-cov-2-covid-19,1308019,3381082,0,0,0.879265814938531,5171,37660,2320858,10757249
Slovenia,2022-01-10,13197153,13197153,119046,https://www.nijz.si/sl/dnevno-spremljanje-okuzb-s-sars-cov-2-covid-19,1308019,3381082,0,0,0.879265814938531,14373,104673,2335231,10861922
Slovenia,2022-01-11,13296289,13296289,99136,https://www.nijz.si/sl/dnevno-spremljanje-okuzb-s-sars-cov-2-covid-19,1308019,3381082,0,0,0.879265814938531,11969,87167,2347200,10949089
Slovenia,2022-01-12,13408209,13408209,111920,https://www.nijz.si/sl/dnevno-spremljanje-okuzb-s-sars-cov-2-covid-19,1308019,3381082,0,0,0.879265814938531,13513,98407,2360713,11047496
Slovenia,2022-01-13,13509789,13509789,101580,https://www.nijz.si/sl/dnevno-spremljanje-okuzb-s-sars-cov-2-covid-19,1308019,3381082,0,0,0.879265814938531,12264,89316,2372977,11136812
Slovenia,2022-01-14,13633221,13633221,123432,https://www.nijz.si/sl/dnevno-spremljanje-okuzb-s-sars-cov-2-covid-19,1308019,3381082,0,0,0.879265814938531,14902,108530,2387879,11245342
Slovenia,2022-01-15,13719247,13719247,86026,https://www.nijz.si/sl/dnevno-spremljanje-okuzb-s-sars-cov-2-covid-19,1308019,3381082,0,0,0.879265814938531,10386,75640,2398265,11320982
Slovenia,2022-01-16,13768974,13768974,49727,https://www.nijz.si/sl/dnevno-spremljanje-okuzb-s-sars-cov-2-covid-19,1308019,3381082,0,0,0.879265814938531,6004,43723,2404269,11364705
Slovenia,2022-01-17,13894737,13894737,125763,https://www.nijz.si/sl/dnevno-spremljanje-okuzb-s-sars-cov-2-covid-19,1308019,3381082,0,0,0.879265814938531,15184,110579,2419453,11475284
Slovenia,2022-01-18,14002419,14002419,107682,https://www.nijz.si/sl/dnevno-spremljanje-okuzb-s-sars-cov-2-covid-19,1308019,3381082,0,0,0.879265814938531,13001,94681,2432454,11569965
Slovenia,2022-01-19,14002419,14002419,0,https://www.nijz.si/sl/dnevno-spremljanje-okuzb-s-sars-cov-2-covid-19,1308019,3381082,0,0,0.879265814938531,0,0,2432454,11569965
Slovenia,2022-01-20,14002419,14002419,0,https://www.nijz.si/sl/dnevno-spremljanje-okuzb-s-sars-cov-2-covid-19,1308019,3381082,0,0,0.879265814938531,0,0,2432454,11569965
Slovenia,2022-01-21,14002419,14002419,0,https://www.nijz.si/sl/dnevno-spremljanje-okuzb-s-sars-cov-2-covid-19,1308019,3381082,0,0,0.879265814938531,0,0,2432454,11569965
Slovenia,2022-01-22,14002419,14002419,0,https://www.nijz.si/sl/dnevno-spremljanje-okuzb-s-sars-cov-2-covid-19,1308019,3381082,0,0,0.879265814938531,0,0,2432454,11569965
Slovenia,2022-01-23,14002419,14002419,0,https://www.nijz.si/sl/dnevno-spremljanje-okuzb-s-sars-cov-2-covid-19,1308019,3381082,0,0,0.879265814938531,0,0,2432454,11569965
Slovenia,2022-01-24,14002419,14002419,0,https://www.nijz.si/sl/dnevno-spremljanje-okuzb-s-sars-cov-2-covid-19,1308019,3381082,0,0,0.879265814938531,0,0,2432454,11569965
Slovenia,2022-01-25,14002419,14002419,0,https://www.nijz.si/sl/dnevno-spremljanje-okuzb-s-sars-cov-2-covid-19,1308019,3381082,0,0,0.879265814938531,0,0,2432454,11569965
Slovenia,2022-01-26,15264096,15264096,1261677,https://www.nijz.si/sl/dnevno-spremljanje-okuzb-s-sars-cov-2-covid-19,1308019,3381082,0,0,0.879265814938531,152328,1109349,2584782,12679314
Slovenia,2022-01-27,15380740,15380740,116644,https://www.nijz.si/sl/dnevno-spremljanje-okuzb-s-sars-cov-2-covid-19,1308019,3381082,0,0,0.879265814938531,14083,102561,2598865,12781875
Slovenia,2022-01-28,15380740,15380740,0,https://www.nijz.si/sl/dnevno-spremljanje-okuzb-s-sars-cov-2-covid-19,1308019,3381082,0,0,0.879265814938531,0,0,2598865,12781875
Slovenia,2022-01-29,15603738,15603738,222998,https://www.nijz.si/sl/dnevno-spremljanje-okuzb-s-sars-cov-2-covid-19,1308019,3381082,0,0,0.879265814938531,26923,196075,2625788,12977950
Slovenia,2022-01-30,15667864,15667864,64126,https://www.nijz.si/sl/dnevno-spremljanje-okuzb-s-sars-cov-2-covid-19,1308019,3381082,0,0,0.879265814938531,7742,56384,2633530,13034334
Slovenia,2022-01-31,15807818,15807818,139954,https://www.nijz.si/sl/dnevno-spremljanje-okuzb-s-sars-cov-2-covid-19,1308019,3381082,0,0,0.879265814938531,16897,123057,2650427,13157391
Slovenia,2022-02-01,15925722,15925722,117904,https://www.nijz.si/sl/dnevno-spremljanje-okuzb-s-sars-cov-2-covid-19,1308019,3381082,0,0,0.879265814938531,14235,103669,2664662,13261060
Slovenia,2022-02-02,16058367,16058367,132645,https://www.nijz.si/sl/dnevno-spremljanje-okuzb-s-sars-cov-2-covid-19,1308019,3381082,0,0,0.879265814938531,16015,116630,2680677,13377690
Slovenia,2022-02-03,16168208,16168208,109841,https://www.nijz.si/sl/dnevno-spremljanje-okuzb-s-sars-cov-2-covid-19,1308019,3381082,0,0,0.879265814938531,13262,96579,2693939,13474269
Slovenia,2022-02-04,16168208,16168208,0,https://www.nijz.si/sl/dnevno-spremljanje-okuzb-s-sars-cov-2-covid-19,1308019,3381082,0,0,0.879265814938531,0,0,2693939,13474269
Slovenia,2022-02-05,16369743,16369743,201535,https://www.nijz.si/sl/dnevno-spremljanje-okuzb-s-sars-cov-2-covid-19,1308019,3381082,0,0,0.879265814938531,24332,177203,2718271,13651472
Slovenia,2022-02-06,16418645,16418645,48902,https://www.nijz.si/sl/dnevno-spremljanje-okuzb-s-sars-cov-2-covid-19,1308019,3381082,0,0,0.879265814938531,5904,42998,2724175,13694470
Slovenia,2022-02-07,16545210,16545210,126565,https://www.nijz.si/sl/dnevno-spremljanje-okuzb-s-sars-cov-2-covid-19,1308019,3381082,0,0,0.879265814938531,15281,111284,2739456,13805754
Slovenia,2022-02-08,16598325,16598325,53115,https://www.nijz.si/sl/dnevno-spremljanje-okuzb-s-sars-cov-2-covid-19,1308019,3381082,0,0,0.879265814938531,6413,46702,2745869,13852456
Slovenia,2022-02-09,16725650,16725650,127325,https://www.nijz.si/sl/dnevno-spremljanje-okuzb-s-sars-cov-2-covid-19,1308019,3381082,0,0,0.879265814938531,15372,111953,2761241,13964409
Slovenia,2022-02-10,16819598,16819598,93948,https://www.nijz.si/sl/dnevno-spremljanje-okuzb-s-sars-cov-2-covid-19,1308019,3381082,0,0,0.879265814938531,11343,82605,2772584,14047014
Slovenia,2022-02-11,16819598,16819598,0,https://www.nijz.si/sl/dnevno-spremljanje-okuzb-s-sars-cov-2-covid-19,1308019,3381082,0,0,0.879265814938531,0,0,2772584,14047014
Slovenia,2022-02-12,17001814,17001814,182216,https://www.nijz.si/sl/dnevno-spremljanje-okuzb-s-sars-cov-2-covid-19,1308019,3381082,0,0,0.879265814938531,22000,160216,2794584,14207230
Slovenia,2022-02-13,17051859,17051859,50045,https://www.nijz.si/sl/dnevno-spremljanje-okuzb-s-sars-cov-2-covid-19,1308019,3381082,0,0,0.879265814938531,6042,44003,2800626,14251233
Slovenia,2022-02-14,17164064,17164064,112205,https://www.nijz.si/sl/dnevno-spremljanje-okuzb-s-sars-cov-2-covid-19,1308019,3381082,0,0,0.879265814938531,13547,98658,2814173,14349891
Slovenia,2022-02-15,17245935,17245935,81871,https://www.nijz.si/sl/dnevno-spremljanje-okuzb-s-sars-cov-2-covid-19,1308019,3381082,0,0,0.879265814938531,9885,71986,2824058,14421877
Slovenia,2022-02-16,17346426,17346426,100491,https://www.nijz.si/sl/dnevno-spremljanje-okuzb-s-sars-cov-2-covid-19,1308019,3381082,0,0,0.879265814938531,12133,88358,2836191,14510235
Slovenia,2022-02-17,17425662,17425662,79236,https://www.nijz.si/sl/dnevno-spremljanje-okuzb-s-sars-cov-2-covid-19,1308019,3381082,0,0,0.879265814938531,9566,69670,2845757,14579905
Slovenia,2022-02-18,17425662,17425662,0,https://www.nijz.si/sl/dnevno-spremljanje-okuzb-s-sars-cov-2-covid-19,1308019,3381082,0,0,0.879265814938531,0,0,2845757,14579905
Slovenia,2022-02-19,17574088,17574088,148426,https://www.nijz.si/sl/dnevno-spremljanje-okuzb-s-sars-cov-2-covid-19,1308019,3381082,0,0,0.879265814938531,17920,130506,2863677,14710411
Slovenia,2022-02-20,17609088,17609088,35000,https://www.nijz.si/sl/dnevno-spremljanje-okuzb-s-sars-cov-2-covid-19,1308019,3381082,0,0,0.879265814938531,4226,30774,2867903,14741185
Slovenia,2022-02-21,17634955,17634955,25867,https://www.nijz.si/sl/dnevno-spremljanje-okuzb-s-sars-cov-2-covid-19,1308019,3381082,0,0,0.879265814938531,3123,22744,2871026,14763929
Slovenia,2022-02-22,17652756,17652756,17801,https://www.nijz.si/sl/dnevno-spremljanje-okuzb-s-sars-cov-2-covid-19,1308019,3381082,0,0,0.879265814938531,2149,15652,2873175,14779581
Slovenia,2022-02-23,17672425,17672425,19669,https://www.nijz.si/sl/dnevno-spremljanje-okuzb-s-sars-cov-2-covid-19,1308019,3381082,0,0,0.879265814938531,2375,17294,2875550,14796875
Slovenia,2022-02-24,17687120,17687120,14695,https://www.nijz.si/sl/dnevno-spremljanje-okuzb-s-sars-cov-2-covid-19,1308019,3381082,0,0,0.879265814938531,1774,12921,2877324,14809796
Slovenia,2022-02-25,17687120,17687120,0,https://www.nijz.si/sl/dnevno-spremljanje-okuzb-s-sars-cov-2-covid-19,1308019,3381082,0,0,0.879265814938531,0,0,2877324,14809796
Slovenia,2022-02-26,17710459,17710459,23339,https://www.nijz.si/sl/dnevno-spremljanje-okuzb-s-sars-cov-2-covid-19,1308019,3381082,0,0,0.879265814938531,2818,20521,2880142,14830317
Slovenia,2022-02-27,17715883,17715883,5424,https://www.nijz.si/sl/dnevno-spremljanje-okuzb-s-sars-cov-2-covid-19,1308019,3381082,0,0,0.879265814938531,655,4769,2880797,14835086
Slovenia,2022-02-28,17735227,17735227,19344,https://www.nijz.si/sl/dnevno-spremljanje-okuzb-s-sars-cov-2-covid-19,1308019,3381082,0,0,0.879265814938531,2335,17009,2883132,14852095
Slovenia,2022-03-01,17748952,17748952,13725,https://www.nijz.si/sl/dnevno-spremljanje-okuzb-s-sars-cov-2-covid-19,1308019,3381082,0,0,0.879265814938531,1657,12068,2884789,14864163
Slovenia,2022-03-02,17764186,17764186,15234,https://www.nijz.si/sl/dnevno-spremljanje-okuzb-s-sars-cov-2-covid-19,1308019,3381082,0,0,0.879265814938531,1839,13395,2886628,14877558
Slovenia,2022-03-03,17777879,17777879,13693,https://www.nijz.si/sl/dnevno-spremljanje-okuzb-s-sars-cov-2-covid-19,1308019,3381082,0,0,0.879265814938531,1653,12040,2888281,14889598
Slovenia,2022-03-04,17777879,17777879,0,https://www.nijz.si/sl/dnevno-spremljanje-okuzb-s-sars-cov-2-covid-19,1308019,3381082,0,0,0.879265814938531,0,0,2888281,14889598
Slovenia,2022-03-05,17798426,17798426,20547,https://www.nijz.si/sl/dnevno-spremljanje-okuzb-s-sars-cov-2-covid-19,1308019,3381082,0,0,0.879265814938531,2481,18066,2890762,14907664
Slovenia,2022-03-06,17803049,17803049,4623,https://www.nijz.si/sl/dnevno-spremljanje-okuzb-s-sars-cov-2-covid-19,1308019,3381082,0,0,0.879265814938531,558,4065,2891320,14911729
Slovenia,2022-03-07,17820373,17820373,17324,https://www.nijz.si/sl/dnevno-spremljanje-okuzb-s-sars-cov-2-covid-19,1308019,3381082,0,0,0.879265814938531,2092,15232,2893412,14926961
Slovenia,2022-03-08,17831841,17831841,11468,https://www.nijz.si/sl/dnevno-spremljanje-okuzb-s-sars-cov-2-covid-19,1308019,3381082,0,0,0.879265814938531,1385,10083,2894797,14937044
Slovenia,2022-03-09,17846639,17846639,14798,https://www.nijz.si/sl/dnevno-spremljanje-okuzb-s-sars-cov-2-covid-19,1308019,3381082,0,0,0.879265814938531,1787,13011,2896584,14950055
Slovenia,2022-03-10,17859299,17859299,12660,https://www.nijz.si/sl/dnevno-spremljanje-okuzb-s-sars-cov-2-covid-19,1308019,3381082,0,0,0.879265814938531,1528,11132,2898112,14961187
Slovenia,2022-03-11,17859299,17859299,0,https://www.nijz.si/sl/dnevno-spremljanje-okuzb-s-sars-cov-2-covid-19,1308019,3381082,0,0,0.879265814938531,0,0,2898112,14961187
Slovenia,2022-03-12,17880815,17880815,21516,https://www.nijz.si/sl/dnevno-spremljanje-okuzb-s-sars-cov-2-covid-19,1308019,3381082,0,0,0.879265814938531,2598,18918,2900710,14980105
Slovenia,2022-03-13,17885984,17885984,5169,https://www.nijz.si/sl/dnevno-spremljanje-okuzb-s-sars-cov-2-covid-19,1308019,3381082,0,0,0.879265814938531,624,4545,2901334,14984650
Slovenia,2022-03-14,17905335,17905335,19351,https://www.nijz.si/sl/dnevno-spremljanje-okuzb-s-sars-cov-2-covid-19,1308019,3381082,0,0,0.879265814938531,2336,17015,2903670,15001665
Slovenia,2022-03-15,17919608,17919608,14273,https://www.nijz.si/sl/dnevno-spremljanje-okuzb-s-sars-cov-2-covid-19,1308019,3381082,0,0,0.879265814938531,1723,12550,2905393,15014215
Slovenia,2022-03-16,17935460,17935460,15852,https://www.nijz.si/sl/dnevno-spremljanje-okuzb-s-sars-cov-2-covid-19,1308019,3381082,0,0,0.879265814938531,1914,13938,2907307,15028153
Slovenia,2022-03-17,17951305,17951305,15845,https://www.nijz.si/sl/dnevno-spremljanje-okuzb-s-sars-cov-2-covid-19,1308019,3381082,0,0,0.879265814938531,1913,13932,2909220,15042085
Slovenia,2022-03-18,17951305,17951305,0,https://www.nijz.si/sl/dnevno-spremljanje-okuzb-s-sars-cov-2-covid-19,1308019,3381082,0,0,0.879265814938531,0,0,2909220,15042085
Slovenia,2022-03-19,17951305,17951305,0,https://www.nijz.si/sl/dnevno-spremljanje-okuzb-s-sars-cov-2-covid-19,1308019,3381082,0,0,0.879265814938531,0,0,2909220,15042085
Slovenia,2022-03-20,17981411,17981411,30106,https://www.nijz.si/sl/dnevno-spremljanje-okuzb-s-sars-cov-2-covid-19,1308019,3381082,0,0,0.879265814938531,3635,26471,2912855,15068556
Slovenia,2022-03-21,18001309,18001309,19898,https://www.nijz.si/sl/dnevno-spremljanje-okuzb-s-sars-cov-2-covid-19,1308019,3381082,0,0,0.879265814938531,2402,17496,2915257,15086052
Slovenia,2022-03-22,18001309,18001309,0,https://www.nijz.si/sl/dnevno-spremljanje-okuzb-s-sars-cov-2-covid-19,2601869,15399440,1293850,12018358,0.9028072578192888,0,0,2915257,15086052
Slovenia,2022-03-23,18016987,18016987,15678,https://www.nijz.si/sl/dnevno-spremljanje-okuzb-s-sars-cov-2-covid-19,2603552,15413435,1683,13995,0.8926521239954076,1683,13995,2916940,15100047
Slovenia,2022-03-24,18033607,18033607,16620,https://www.nijz.si/sl/dnevno-spremljanje-okuzb-s-sars-cov-2-covid-19,2605467,15428140,1915,14705,0.884777376654633,1915,14705,2918855,15114752
Slovenia,2022-03-25,18047489,18047489,13882,https://www.nijz.si/sl/dnevno-spremljanje-okuzb-s-sars-cov-2-covid-19,2606797,15440692,1330,12552,0.9041924794698171,1330,12552,2920185,15127304
Slovenia,2022-03-26,18064547,18064547,17058,https://www.nijz.si/sl/dnevno-spremljanje-okuzb-s-sars-cov-2-covid-19,2608562,15455985,1765,15293,0.8965294876304374,1765,15293,2921950,15142597
Slovenia,2022-03-27,18071130,18071130,6583,https://www.nijz.si/sl/dnevno-spremljanje-okuzb-s-sars-cov-2-covid-19,2609188,15461942,626,5957,0.9049065775482303,626,5957,2922576,15148554
Slovenia,2022-03-28,18076774,18076774,5644,https://www.nijz.si/sl/dnevno-spremljanje-okuzb-s-sars-cov-2-covid-19,2609850,15466924,662,4982,0.8827072997873848,662,4982,2923238,15153536
Slovenia,2022-03-29,18098258,18098258,21484,https://www.nijz.si/sl/dnevno-spremljanje-okuzb-s-sars-cov-2-covid-19,2611877,15486381,2027,19457,0.9056507168125116,2027,19457,2925265,15172993
Slovenia,2022-03-30,18113541,18113541,15283,https://www.nijz.si/sl/dnevno-spremljanje-okuzb-s-sars-cov-2-covid-19,2613489,15500052,1612,13671,0.8945233265720081,1612,13671,2926877,15186664
Slovenia,2022-03-31,18130178,18130178,16637,https://www.nijz.si/sl/dnevno-spremljanje-okuzb-s-sars-cov-2-covid-19,2615204,15514974,1715,14922,0.8969165113902747,1715,14922,2928592,15201586
Slovenia,2022-04-01,18143401,18143401,13223,https://www.nijz.si/sl/dnevno-spremljanje-okuzb-s-sars-cov-2-covid-19,2616568,15526833,1364,11859,0.8968464039930424,1364,11859,2929956,15213445
Slovenia,2022-04-02,18158038,18158038,14637,https://www.nijz.si/sl/dnevno-spremljanje-okuzb-s-sars-cov-2-covid-19,2618130,15539908,1562,13075,0.8932841429254629,1562,13075,2931518,15226520
Slovenia,2022-04-03,18162824,18162824,4786,https://www.nijz.si/sl/dnevno-spremljanje-okuzb-s-sars-cov-2-covid-19,2618807,15544017,677,4109,0.8585457584621814,677,4109,2932195,15230629
Slovenia,2022-04-04,18167896,18167896,5072,https://www.nijz.si/sl/dnevno-spremljanje-okuzb-s-sars-cov-2-covid-19,2619480,15548416,673,4399,0.8673107255520505,673,4399,2932868,15235028
Slovenia,2022-04-05,18187390,18187390,19494,https://www.nijz.si/sl/dnevno-spremljanje-okuzb-s-sars-cov-2-covid-19,2621265,15566125,1785,17709,0.9084333641120345,1785,17709,2934653,15252737
Slovenia,2022-04-06,18201193,18201193,13803,https://www.nijz.si/sl/dnevno-spremljanje-okuzb-s-sars-cov-2-covid-19,2622692,15578501,1427,12376,0.8966166775338694,1427,12376,2936080,15265113
Slovenia,2022-04-07,18215900,18215900,14707,https://www.nijz.si/sl/dnevno-spremljanje-okuzb-s-sars-cov-2-covid-19,2624329,15591571,1637,13070,0.8886924593730876,1637,13070,2937717,15278183
Slovenia,2022-04-08,18228625,18228625,12725,https://www.nijz.si/sl/dnevno-spremljanje-okuzb-s-sars-cov-2-covid-19,2625440,15603185,1111,11614,0.9126915520628683,1111,11614,2938828,15289797
Slovenia,2022-04-09,18241800,18241800,13175,https://www.nijz.si/sl/dnevno-spremljanje-okuzb-s-sars-cov-2-covid-19,2626793,15615007,1353,11822,0.8973055028462998,1353,11822,2940181,15301619
Slovenia,2022-04-10,18246195,18246195,4395,https://www.nijz.si/sl/dnevno-spremljanje-okuzb-s-sars-cov-2-covid-19,2627279,15618916,486,3909,0.889419795221843,486,3909,2940667,15305528
Slovenia,2022-04-11,18250214,18250214,4019,https://www.nijz.si/sl/dnevno-spremljanje-okuzb-s-sars-cov-2-covid-19,2627861,15622353,582,3437,0.8551878576760388,582,3437,2941249,15308965
Slovenia,2022-04-12,18266763,18266763,16549,https://www.nijz.si/sl/dnevno-spremljanje-okuzb-s-sars-cov-2-covid-19,2629398,15637365,1537,15012,0.907124297540637,1537,15012,2942786,15323977
Slovenia,2022-04-13,18276999,18276999,10236,https://www.nijz.si/sl/dnevno-spremljanje-okuzb-s-sars-cov-2-covid-19,2630372,15646627,974,9262,0.9048456428292302,974,9262,2943760,15333239
Slovenia,2022-04-14,18289253,18289253,12254,https://www.nijz.si/sl/dnevno-spremljanje-okuzb-s-sars-cov-2-covid-19,2631657,15657596,1285,10969,0.8951362820303574,1285,10969,2945045,15344208
Slovenia,2022-04-15,18298955,18298955,9702,https://www.nijz.si/sl/dnevno-spremljanje-okuzb-s-sars-cov-2-covid-19,2632572,15666383,915,8787,0.9056895485466914,915,8787,2945960,15352995
Slovenia,2022-04-16,18309661,18309661,10706,https://www.nijz.si/sl/dnevno-spremljanje-okuzb-s-sars-cov-2-covid-19,2633634,15676027,1062,9644,0.9008032878759574,1062,9644,2947022,15362639
Slovenia,2022-04-17,18313533,18313533,3872,https://www.nijz.si/sl/dnevno-spremljanje-okuzb-s-sars-cov-2-covid-19,2634066,15679467,432,3440,0.8884297520661157,432,3440,2947454,15366079
Slovenia,2022-04-18,18315967,18315967,2434,https://www.nijz.si/sl/dnevno-spremljanje-okuzb-s-sars-cov-2-covid-19,2634477,15681490,411,2023,0.8311421528348397,411,2023,2947865,15368102
Slovenia,2022-04-19,18320305,18320305,4338,https://www.nijz.si/sl/dnevno-spremljanje-okuzb-s-sars-cov-2-covid-19,2635315,15684990,838,3500,0.8068234209313048,838,3500,2948703,15371602
Slovenia,2022-04-20,18335028,18335028,14723,https://www.nijz.si/sl/dnevno-spremljanje-okuzb-s-sars-cov-2-covid-19,2636705,15698323,1390,13333,0.9055898933641242,1390,13333,2950093,15384935
Slovenia,2022-04-21,18346542,18346542,11514,https://www.nijz.si/sl/dnevno-spremljanje-okuzb-s-sars-cov-2-covid-19,2637904,15708638,1199,10315,0.8958659023797116,1199,10315,2951292,15395250
Slovenia,2022-04-22,18357240,18357240,10698,https://www.nijz.si/sl/dnevno-spremljanje-okuzb-s-sars-cov-2-covid-19,2638921,15718319,1017,9681,0.9049355019629838,1017,9681,2952309,15404931
Slovenia,2022-04-23,18368565,18368565,11325,https://www.nijz.si/sl/dnevno-spremljanje-okuzb-s-sars-cov-2-covid-19,2640271,15728294,1350,9975,0.8807947019867549,1350,9975,2953659,15414906
Slovenia,2022-04-24,18373553,18373553,4988,https://www.nijz.si/sl/dnevno-spremljanje-okuzb-s-sars-cov-2-covid-19,2640915,15732638,644,4344,0.8708901363271853,644,4344,2954303,15419250
Slovenia,2022-04-25,18376935,18376935,3382,https://www.nijz.si/sl/dnevno-spremljanje-okuzb-s-sars-cov-2-covid-19,2641457,15735478,542,2840,0.8397397989355411,542,2840,2954845,15422090
Slovenia,2022-04-26,18390023,18390023,13088,https://www.nijz.si/sl/dnevno-spremljanje-okuzb-s-sars-cov-2-covid-19,2642767,15747256,1310,11778,0.8999083129584352,1310,11778,2956155,15433868
Slovenia,2022-04-27,18403833,18403833,13810,https://www.nijz.si/sl/dnevno-spremljanje-okuzb-s-sars-cov-2-covid-19,2643752,15760081,985,12825,0.9286748732802317,985,12825,2957140,15446693
Slovenia,2022-04-28,18408433,18408433,4600,https://www.nijz.si/sl/dnevno-spremljanje-okuzb-s-sars-cov-2-covid-19,2644435,15763998,683,3917,0.8515217391304348,683,3917,2957823,15450610
Slovenia,2022-04-29,18418846,18418846,10413,https://www.nijz.si/sl/dnevno-spremljanje-okuzb-s-sars-cov-2-covid-19,2645359,15773487,924,9489,0.9112647651973494,924,9489,2958747,15460099
Slovenia,2022-04-30,18428569,18428569,9723,https://www.nijz.si/sl/dnevno-spremljanje-okuzb-s-sars-cov-2-covid-19,2646284,15782285,925,8798,0.9048647536768487,925,8798,2959672,15468897
Slovenia,2022-05-01,18432460,18432460,3891,https://www.nijz.si/sl/dnevno-spremljanje-okuzb-s-sars-cov-2-covid-19,2646735,15785725,451,3440,0.8840914931894115,451,3440,2960123,15472337
Slovenia,2022-05-02,18434634,18434634,2174,https://www.nijz.si/sl/dnevno-spremljanje-okuzb-s-sars-cov-2-covid-19,2647116,15787518,381,1793,0.8247470101195952,381,1793,2960504,15474130
Slovenia,2022-05-03,18438501,18438501,3867,https://www.nijz.si/sl/dnevno-spremljanje-okuzb-s-sars-cov-2-covid-19,2647922,15790579,806,3061,0.791569692267908,806,3061,2961310,15477191
Slovenia,2022-05-04,18450779,18450779,12278,https://www.nijz.si/sl/dnevno-spremljanje-okuzb-s-sars-cov-2-covid-19,2648936,15801843,1014,11264,0.917413259488516,1014,11264,2962324,15488455
Slovenia,2022-05-05,18459891,18459891,9112,https://www.nijz.si/sl/dnevno-spremljanje-okuzb-s-sars-cov-2-covid-19,2649898,15809993,962,8150,0.8944249341527656,962,8150,2963286,15496605
Slovenia,2022-05-06,18468027,18468027,8136,https://www.nijz.si/sl/dnevno-spremljanje-okuzb-s-sars-cov-2-covid-19,2650830,15817197,932,7204,0.8854473942969519,932,7204,2964218,15503809
Slovenia,2022-05-07,18476052,18476052,8025,https://www.nijz.si/sl/dnevno-spremljanje-okuzb-s-sars-cov-2-covid-19,2651738,15824314,908,7117,0.8868535825545172,908,7117,2965126,15510926
Slovenia,2022-05-08,18479023,18479023,2971,https://www.nijz.si/sl/dnevno-spremljanje-okuzb-s-sars-cov-2-covid-19,2652163,15826860,425,2546,0.856950521709862,425,2546,2965551,15513472
Slovenia,2022-05-09,18481478,18481478,2455,https://www.nijz.si/sl/dnevno-spremljanje-okuzb-s-sars-cov-2-covid-19,2652710,15828768,547,1908,0.7771894093686355,547,1908,2966098,15515380
Slovenia,2022-05-10,18491466,18491466,9988,https://www.nijz.si/sl/dnevno-spremljanje-okuzb-s-sars-cov-2-covid-19,2653904,15837562,1194,8794,0.8804565478574289,1194,8794,2967292,15524174
Slovenia,2022-05-11,18498207,18498207,6741,https://www.nijz.si/sl/dnevno-spremljanje-okuzb-s-sars-cov-2-covid-19,2654619,15843588,715,6026,0.8939326509419967,715,6026,2968007,15530200
Slovenia,2022-05-12,18505449,18505449,7242,https://www.nijz.si/sl/dnevno-spremljanje-okuzb-s-sars-cov-2-covid-19,2655517,15849932,898,6344,0.876001104667219,898,6344,2968905,15536544
Slovenia,2022-05-13,18511981,18511981,6532,https://www.nijz.si/sl/dnevno-spremljanje-okuzb-s-sars-cov-2-covid-19,2656266,15855715,749,5783,0.8853337415799143,749,5783,2969654,15542327
Slovenia,2022-05-14,18518625,18518625,6644,https://www.nijz.si/sl/dnevno-spremljanje-okuzb-s-sars-cov-2-covid-19,2657090,15861535,824,5820,0.8759783263094522,824,5820,2970478,15548147
Slovenia,2022-05-15,18521184,18521184,2559,https://www.nijz.si/sl/dnevno-spremljanje-okuzb-s-sars-cov-2-covid-19,2657532,15863652,442,2117,0.8272762797967956,442,2117,2970920,15550264
Slovenia,2022-05-16,18523330,18523330,2146,https://www.nijz.si/sl/dnevno-spremljanje-okuzb-s-sars-cov-2-covid-19,2657981,15865349,449,1697,0.7907735321528425,449,1697,2971369,15551961
Slovenia,2022-05-17,18530644,18530644,7314,https://www.nijz.si/sl/dnevno-spremljanje-okuzb-s-sars-cov-2-covid-19,2658978,15871666,997,6317,0.8636860814875581,997,6317,2972366,15558278
Slovenia,2022-05-18,18535819,18535819,5175,https://www.nijz.si/sl/dnevno-spremljanje-okuzb-s-sars-cov-2-covid-19,2659645,15876174,667,4508,0.8711111111111111,667,4508,2973033,15562786
Slovenia,2022-05-19,18541367,18541367,5548,https://www.nijz.si/sl/dnevno-spremljanje-okuzb-s-sars-cov-2-covid-19,2660472,15880895,827,4721,0.8509372746935833,827,4721,2973860,15567507
Slovenia,2022-05-20,18546409,18546409,5042,https://www.nijz.si/sl/dnevno-spremljanje-okuzb-s-sars-cov-2-covid-19,2661054,15885355,582,4460,0.8845696152320508,582,4460,2974442,15571967
Slovenia,2022-05-21,18551947,18551947,5538,https://www.nijz.si/sl/dnevno-spremljanje-okuzb-s-sars-cov-2-covid-19,2661784,15890163,730,4808,0.8681834597327555,730,4808,2975172,15576775
Slovenia,2022-05-22,18554078,18554078,2131,https://www.nijz.si/sl/dnevno-spremljanje-okuzb-s-sars-cov-2-covid-19,2662105,15891973,321,1810,0.8493664946034726,321,1810,2975493,15578585
Slovenia,2022-05-23,18555726,18555726,1648,https://www.nijz.si/sl/dnevno-spremljanje-okuzb-s-sars-cov-2-covid-19,2662438,15893288,333,1315,0.7979368932038835,333,1315,2975826,15579900
Slovenia,2022-05-24,18562219,18562219,6493,https://www.nijz.si/sl/dnevno-spremljanje-okuzb-s-sars-cov-2-covid-19,2663295,15898924,857,5636,0.8680117049129832,857,5636,2976683,15585536
Slovenia,2022-05-25,18566960,18566960,4741,https://www.nijz.si/sl/dnevno-spremljanje-okuzb-s-sars-cov-2-covid-19,2663872,15903088,577,4164,0.8782957182029107,577,4164,2977260,15589700
Slovenia,2022-05-26,18571879,18571879,4919,https://www.nijz.si/sl/dnevno-spremljanje-okuzb-s-sars-cov-2-covid-19,2664590,15907289,718,4201,0.8540353730433015,718,4201,2977978,15593901
Slovenia,2022-05-27,18576900,18576900,5021,https://www.nijz.si/sl/dnevno-spremljanje-okuzb-s-sars-cov-2-covid-19,2665196,15911704,606,4415,0.8793069109739096,606,4415,2978584,15598316
Slovenia,2022-05-28,18581772,18581772,4872,https://www.nijz.si/sl/dnevno-spremljanje-okuzb-s-sars-cov-2-covid-19,2665841,15915931,645,4227,0.8676108374384236,645,4227,2979229,15602543
Slovenia,2022-05-29,18583558,18583558,1786,https://www.nijz.si/sl/dnevno-spremljanje-okuzb-s-sars-cov-2-covid-19,2666109,15917449,268,1518,0.8499440089585666,268,1518,2979497,15604061
Slovenia,2022-05-30,18585306,18585306,1748,https://www.nijz.si/sl/dnevno-spremljanje-okuzb-s-sars-cov-2-covid-19,2666498,15918808,389,1359,0.7774599542334096,389,1359,2979886,15605420
Slovenia,2022-05-31,18591486,18591486,6180,https://www.nijz.si/sl/dnevno-spremljanje-okuzb-s-sars-cov-2-covid-19,2667278,15924208,780,5400,0.8737864077669902,780,5400,2980666,15610820
Slovenia,2022-06-01,18596193,18596193,4707,https://www.nijz.si/sl/dnevno-spremljanje-okuzb-s-sars-cov-2-covid-19,2667851,15928342,573,4134,0.8782664117272148,573,4134,2981239,15614954
Slovenia,2022-06-02,18600556,18600556,4363,https://www.nijz.si/sl/dnevno-spremljanje-okuzb-s-sars-cov-2-covid-19,2668543,15932013,692,3671,0.8413935365574147,692,3671,2981931,15618625
Slovenia,2022-06-03,18604013,18604013,3457,https://www.nijz.si/sl/dnevno-spremljanje-okuzb-s-sars-cov-2-covid-19,2669032,15934981,489,2968,0.8585478738790859,489,2968,2982420,15621593
Slovenia,2022-06-04,18607639,18607639,3626,https://www.nijz.si/sl/dnevno-spremljanje-okuzb-s-sars-cov-2-covid-19,2669642,15937997,610,3016,0.8317705460562603,610,3016,2983030,15624609
Slovenia,2022-06-05,18608906,18608906,1267,https://www.nijz.si/sl/dnevno-spremljanje-okuzb-s-sars-cov-2-covid-19,2669884,15939022,242,1025,0.8089976322020521,242,1025,2983272,15625634
Slovenia,2022-06-06,18610159,18610159,1253,https://www.nijz.si/sl/dnevno-spremljanje-okuzb-s-sars-cov-2-covid-19,2670242,15939917,358,895,0.7142857142857143,358,895,2983630,15626529
Slovenia,2022-06-07,18614851,18614851,4692,https://www.nijz.si/sl/dnevno-spremljanje-okuzb-s-sars-cov-2-covid-19,2671029,15943822,787,3905,0.8322676896845694,787,3905,2984417,15630434
Slovenia,2022-06-08,18618373,18618373,3522,https://www.nijz.si/sl/dnevno-spremljanje-okuzb-s-sars-cov-2-covid-19,2671554,15946819,525,2997,0.8509369676320273,525,2997,2984942,15633431
Slovenia,2022-06-09,18622020,18622020,3647,https://www.nijz.si/sl/dnevno-spremljanje-okuzb-s-sars-cov-2-covid-19,2672149,15949871,595,3052,0.836852207293666,595,3052,2985537,15636483
Slovenia,2022-06-10,18625307,18625307,3287,https://www.nijz.si/sl/dnevno-spremljanje-okuzb-s-sars-cov-2-covid-19,2672632,15952675,483,2804,0.8530574992394281,483,2804,2986020,15639287
Slovenia,2022-06-11,18628873,18628873,3566,https://www.nijz.si/sl/dnevno-spremljanje-okuzb-s-sars-cov-2-covid-19,2673234,15955639,602,2964,0.8311833987661245,602,2964,2986622,15642251
Slovenia,2022-06-12,18630089,18630089,1216,https://www.nijz.si/sl/dnevno-spremljanje-okuzb-s-sars-cov-2-covid-19,2673516,15956573,282,934,0.7680921052631579,282,934,2986904,15643185
Slovenia,2022-06-13,18631315,18631315,1226,https://www.nijz.si/sl/dnevno-spremljanje-okuzb-s-sars-cov-2-covid-19,2673829,15957486,313,913,0.7446982055464927,313,913,2987217,15644098
Slovenia,2022-06-14,18635913,18635913,4598,https://www.nijz.si/sl/dnevno-spremljanje-okuzb-s-sars-cov-2-covid-19,2674572,15961341,743,3855,0.8384080034797738,743,3855,2987960,15647953
Slovenia,2022-06-15,18639705,18639705,3792,https://www.nijz.si/sl/dnevno-spremljanje-okuzb-s-sars-cov-2-covid-19,2675119,15964586,547,3245,0.8557489451476793,547,3245,2988507,15651198
Slovenia,2022-06-16,18643490,18643490,3785,https://www.nijz.si/sl/dnevno-spremljanje-okuzb-s-sars-cov-2-covid-19,2675736,15967754,617,3168,0.8369881109643329,617,3168,2989124,15654366
Slovenia,2022-06-17,18646845,18646845,3355,https://www.nijz.si/sl/dnevno-spremljanje-okuzb-s-sars-cov-2-covid-19,2676303,15970542,567,2788,0.8309985096870343,567,2788,2989691,15657154
Slovenia,2022-06-18,18650598,18650598,3753,https://www.nijz.si/sl/dnevno-spremljanje-okuzb-s-sars-cov-2-covid-19,2676906,15973692,603,3150,0.8393285371702638,603,3150,2990294,15660304
Slovenia,2022-06-19,18651950,18651950,1352,https://www.nijz.si/sl/dnevno-spremljanje-okuzb-s-sars-cov-2-covid-19,2677204,15974746,298,1054,0.7795857988165681,298,1054,2990592,15661358
Slovenia,2022-06-20,18653337,18653337,1387,https://www.nijz.si/sl/dnevno-spremljanje-okuzb-s-sars-cov-2-covid-19,2677548,15975789,344,1043,0.7519826964671954,344,1043,2990936,15662401
Slovenia,2022-06-21,18658370,18658370,5033,https://www.nijz.si/sl/dnevno-spremljanje-okuzb-s-sars-cov-2-covid-19,2678382,15979988,834,4199,0.83429366183190945,834,4199,2991770,15666600
Slovenia,2022-06-22,18662489,18662489,4119,https://www.nijz.si/sl/dnevno-spremljanje-okuzb-s-sars-cov-2-covid-19,2679000,15983489,618,3501,0.8499635833940277,618,3501,2992388,15670101
Slovenia,2022-06-23,18666701,18666701,4212,https://www.nijz.si/sl/dnevno-spremljanje-okuzb-s-sars-cov-2-covid-19,2679723,15986978,723,3489,0.8283475783475783,723,3489,2993111,15673590
Slovenia,2022-06-24,18670531,18670531,3830,https://www.nijz.si/sl/dnevno-spremljanje-okuzb-s-sars-cov-2-covid-19,2680255,15990276,532,3298,0.8610966057441253,532,3298,2993643,15676888
Slovenia,2022-06-25,18674997,18674997,4466,https://www.nijz.si/sl/dnevno-spremljanje-okuzb-s-sars-cov-2-covid-19,2680883,15994114,628,3838,0.8593819973130318,628,3838,2994271,15680726
Slovenia,2022-06-26,18676638,18676638,1641,https://www.nijz.si/sl/dnevno-spremljanje-okuzb-s-sars-cov-2-covid-19,2681234,15995404,351,1290,0.7861060329067642,351,1290,2994622,15682016
Slovenia,2022-06-27,18678081,18678081,1443,https://www.nijz.si/sl/dnevno-spremljanje-okuzb-s-sars-cov-2-covid-19,2681588,15996493,354,1089,0.7546777546777547,354,1089,2994976,15683105
Slovenia,2022-06-28,18683598,18683598,5517,https://www.nijz.si/sl/dnevno-spremljanje-okuzb-s-sars-cov-2-covid-19,2682351,16001247,763,4754,0.861700199383723,763,4754,2995739,15687859
Slovenia,2022-06-29,18688176,18688176,4578,https://www.nijz.si/sl/dnevno-spremljanje-okuzb-s-sars-cov-2-covid-19,2682937,16005239,586,3992,0.8719965050240279,586,3992,2996325,15691851
Slovenia,2022-06-30,18693236,18693236,5060,https://www.nijz.si/sl/dnevno-spremljanje-okuzb-s-sars-cov-2-covid-19,2683602,16009634,665,4395,0.8685770750988142,665,4395,2996990,15696246
Slovenia,2022-07-01,18697736,18697736,4500,https://www.nijz.si/sl/dnevno-spremljanje-okuzb-s-sars-cov-2-covid-19,2684240,16013496,638,3862,0.8582222222222222,638,3862,2997628,15700108
Slovenia,2022-07-02,18702617,18702617,4881,https://www.nijz.si/sl/dnevno-spremljanje-okuzb-s-sars-cov-2-covid-19,2684899,16017718,659,4222,0.8649866830567506,659,4222,2998287,15704330
Slovenia,2022-07-03,18704238,18704238,1621,https://www.nijz.si/sl/dnevno-spremljanje-okuzb-s-sars-cov-2-covid-19,2685199,16019039,300,1321,0.8149290561381863,300,1321,2998587,15705651
Slovenia,2022-07-04,18705901,18705901,1663,https://www.nijz.si/sl/dnevno-spremljanje-okuzb-s-sars-cov-2-covid-19,2685595,16020306,396,1267,0.761876127480457,396,1267,2998983,15706918
Slovenia,2022-07-05,18713520,18713520,7619,https://www.nijz.si/sl/dnevno-spremljanje-okuzb-s-sars-cov-2-covid-19,2686367,16027153,772,6847,0.898674366714792,772,6847,2999755,15713765
Slovenia,2022-07-06,18719536,18719536,6016,https://www.nijz.si/sl/dnevno-spremljanje-okuzb-s-sars-cov-2-covid-19,2687042,16032494,675,5341,0.8877992021276596,675,5341,3000430,15719106
Slovenia,2022-07-07,18725753,18725753,6217,https://www.nijz.si/sl/dnevno-spremljanje-okuzb-s-sars-cov-2-covid-19,2687702,16038051,660,5557,0.8938394724143478,660,5557,3001090,15724663
Slovenia,2022-07-08,18731023,18731023,5270,https://www.nijz.si/sl/dnevno-spremljanje-okuzb-s-sars-cov-2-covid-19,2688298,16042725,596,4674,0.8869070208728653,596,4674,3001686,15729337
Slovenia,2022-07-09,18736846,18736846,5823,https://www.nijz.si/sl/dnevno-spremljanje-okuzb-s-sars-cov-2-covid-19,2688905,16047941,607,5216,0.8957582002404259,607,5216,3002293,15734553
Slovenia,2022-07-10,18738877,18738877,2031,https://www.nijz.si/sl/dnevno-spremljanje-okuzb-s-sars-cov-2-covid-19,2689227,16049650,322,1709,0.8414574101427869,322,1709,3002615,15736262
Slovenia,2022-07-11,18740971,18740971,2094,https://www.nijz.si/sl/dnevno-spremljanje-okuzb-s-sars-cov-2-covid-19,2689601,16051370,374,1720,0.8213944603629417,374,1720,3002989,15737982
Slovenia,2022-07-12,18749674,18749674,8703,https://www.nijz.si/sl/dnevno-spremljanje-okuzb-s-sars-cov-2-covid-19,2690458,16059216,857,7846,0.9015282086636792,857,7846,3003846,15745828
Slovenia,2022-07-13,18756629,18756629,6955,https://www.nijz.si/sl/dnevno-spremljanje-okuzb-s-sars-cov-2-covid-19,2691088,16065541,630,6325,0.9094176851186196,630,6325,3004476,15752153
Slovenia,2022-07-14,18763530,18763530,6901,https://www.nijz.si/sl/dnevno-spremljanje-okuzb-s-sars-cov-2-covid-19,2691894,16071636,806,6095,0.8832053325604985,806,6095,3005282,15758248
Slovenia,2022-07-15,18769983,18769983,6453,https://www.nijz.si/sl/dnevno-spremljanje-okuzb-s-sars-cov-2-covid-19,2692619,16077364,725,5728,0.8876491554315822,725,5728,3006007,15763976
Slovenia,2022-07-16,18777484,18777484,7501,https://www.nijz.si/sl/dnevno-spremljanje-okuzb-s-sars-cov-2-covid-19,2693373,16084111,754,6747,0.8994800693240901,754,6747,3006761,15770723
Slovenia,2022-07-17,18779974,18779974,2490,https://www.nijz.si/sl/dnevno-spremljanje-okuzb-s-sars-cov-2-covid-19,2693797,16086177,424,2066,0.8297188755020081,424,2066,3007185,15772789
Slovenia,2022-07-18,18782293,18782293,2319,https://www.nijz.si/sl/dnevno-spremljanje-okuzb-s-sars-cov-2-covid-19,2694213,16088080,416,1903,0.820612332902113,416,1903,3007601,15774692
Slovenia,2022-07-19,18792276,18792276,9983,https://www.nijz.si/sl/dnevno-spremljanje-okuzb-s-sars-cov-2-covid-19,2695153,16097123,940,9043,0.9058399278773915,940,9043,3008541,15783735
Slovenia,2022-07-20,18799722,18799722,7446,https://www.nijz.si/sl/dnevno-spremljanje-okuzb-s-sars-cov-2-covid-19,2695866,16103856,713,6733,0.9042438893365565,713,6733,3009254,15790468
Slovenia,2022-07-21,18807046,18807046,7324,https://www.nijz.si/sl/dnevno-spremljanje-okuzb-s-sars-cov-2-covid-19,2696692,16110354,826,6498,0.8872200983069362,826,6498,3010080,15796966
Slovenia,2022-07-22,18813435,18813435,6389,https://www.nijz.si/sl/dnevno-spremljanje-okuzb-s-sars-cov-2-covid-19,2697361,16116074,669,5720,0.8952887775864767,669,5720,3010749,15802686
Slovenia,2022-07-23,18821131,18821131,7696,https://www.nijz.si/sl/dnevno-spremljanje-okuzb-s-sars-cov-2-covid-19,2698207,16122924,846,6850,0.8900727650727651,846,6850,3011595,15809536
Slovenia,2022-07-24,18823796,18823796,2665,https://www.nijz.si/sl/dnevno-spremljanje-okuzb-s-sars-cov-2-covid-19,2698582,16125214,375,2290,0.8592870544090057,375,2290,3011970,15811826
Slovenia,2022-07-25,18826127,18826127,2331,https://www.nijz.si/sl/dnevno-spremljanje-okuzb-s-sars-cov-2-covid-19,2699010,16127117,428,1903,0.8163878163878164,428,1903,3012398,15813729
Slovenia,2022-07-26,18836459,18836459,10332,https://www.nijz.si/sl/dnevno-spremljanje-okuzb-s-sars-cov-2-covid-19,2699967,16136492,957,9375,0.9073751451800233,957,9375,3013355,15823104
Slovenia,2022-07-27,18843581,18843581,7122,https://www.nijz.si/sl/dnevno-spremljanje-okuzb-s-sars-cov-2-covid-19,2700615,16142966,648,6474,0.9090143218197135,648,6474,3014003,15829578
Slovenia,2022-07-28,18851054,18851054,7473,https://www.nijz.si/sl/dnevno-spremljanje-okuzb-s-sars-cov-2-covid-19,2701414,16149640,799,6674,0.8930817610062893,799,6674,3014802,15836252
Slovenia,2022-07-29,18857169,18857169,6115,https://www.nijz.si/sl/dnevno-spremljanje-okuzb-s-sars-cov-2-covid-19,2702001,16155168,587,5528,0.9040065412919052,587,5528,3015389,15841780
Slovenia,2022-07-30,18864943,18864943,7774,https://www.nijz.si/sl/dnevno-spremljanje-okuzb-s-sars-cov-2-covid-19,2702760,16162183,759,7015,0.9023668639053254,759,7015,3016148,15848795
Slovenia,2022-07-31,18867410,18867410,2467,https://www.nijz.si/sl/dnevno-spremljanje-okuzb-s-sars-cov-2-covid-19,2703088,16164322,328,2139,0.8670449939197405,328,2139,3016476,15850934
Slovenia,2022-08-01,18869668,18869668,2258,https://www.nijz.si/sl/dnevno-spremljanje-okuzb-s-sars-cov-2-covid-19,2703446,16166222,358,1900,0.8414526129317981,358,1900,3016834,15852834
Slovenia,2022-08-02,18879679,18879679,10011,https://www.nijz.si/sl/dnevno-spremljanje-okuzb-s-sars-cov-2-covid-19,2704370,16175309,924,9087,0.9077015283188493,924,9087,3017758,15861921
Slovenia,2022-08-03,18886858,18886858,7179,https://www.nijz.si/sl/dnevno-spremljanje-okuzb-s-sars-cov-2-covid-19,2705036,16181822,666,6513,0.9072294191391559,666,6513,3018424,15868434
Slovenia,2022-08-04,18894136,18894136,7278,https://www.nijz.si/sl/dnevno-spremljanje-okuzb-s-sars-cov-2-covid-19,2705826,16188310,790,6488,0.891453696070349,790,6488,3019214,15874922
Slovenia,2022-08-05,18899787,18899787,5651,https://www.nijz.si/sl/dnevno-spremljanje-okuzb-s-sars-cov-2-covid-19,2706452,16193335,626,5025,0.8892231463457795,626,5025,3019840,15879947
Slovenia,2022-08-06,18906337,18906337,6550,https://www.nijz.si/sl/dnevno-spremljanje-okuzb-s-sars-cov-2-covid-19,2707131,16199206,679,5871,0.8963358778625954,679,5871,3020519,15885818
Slovenia,2022-08-07,18908719,18908719,2382,https://www.nijz.si/sl/dnevno-spremljanje-okuzb-s-sars-cov-2-covid-19,2707453,16201266,322,2060,0.8648194794290512,322,2060,3020841,15887878
Slovenia,2022-08-08,18910858,18910858,2139,https://www.nijz.si/sl/dnevno-spremljanje-okuzb-s-sars-cov-2-covid-19,2707839,16203019,386,1753,0.8195418419822347,386,1753,3021227,15889631
Slovenia,2022-08-09,18920760,18920760,9902,https://www.nijz.si/sl/dnevno-spremljanje-okuzb-s-sars-cov-2-covid-19,2708738,16212022,899,9003,0.9092102605534236,899,9003,3022126,15898634
Slovenia,2022-08-10,18927877,18927877,7117,https://www.nijz.si/sl/dnevno-spremljanje-okuzb-s-sars-cov-2-covid-19,2709377,16218500,639,6478,0.9102149782211606,639,6478,3022765,15905112
Slovenia,2022-08-11,18934533,18934533,6656,https://www.nijz.si/sl/dnevno-spremljanje-okuzb-s-sars-cov-2-covid-19,2710152,16224381,775,5881,0.8835637019230769,775,5881,3023540,15910993
Slovenia,2022-08-12,18940364,18940364,5831,https://www.nijz.si/sl/dnevno-spremljanje-okuzb-s-sars-cov-2-covid-19,2710716,16229648,564,5267,0.9032755959526668,564,5267,3024104,15916260
Slovenia,2022-08-13,18947105,18947105,6741,https://www.nijz.si/sl/dnevno-spremljanje-okuzb-s-sars-cov-2-covid-19,2711478,16235627,762,5979,0.8869603916332889,762,5979,3024866,15922239
Slovenia,2022-08-14,18949127,18949127,2022,https://www.nijz.si/sl/dnevno-spremljanje-okuzb-s-sars-cov-2-covid-19,2711737,16237390,259,1763,0.8719090009891197,259,1763,3025125,15924002
Slovenia,2022-08-15,18951286,18951286,2159,https://www.nijz.si/sl/dnevno-spremljanje-okuzb-s-sars-cov-2-covid-19,2712014,16239272,277,1882,0.8716998610467809,277,1882,3025402,15925884
Slovenia,2022-08-16,18953970,18953970,2684,https://www.nijz.si/sl/dnevno-spremljanje-okuzb-s-sars-cov-2-covid-19,2712615,16241355,601,2083,0.776080476900149,601,2083,3026003,15927967
Slovenia,2022-08-17,18963688,18963688,9718,https://www.nijz.si/sl/dnevno-spremljanje-okuzb-s-sars-cov-2-covid-19,2713395,16250293,780,8938,0.9197365713109693,780,8938,3026783,15936905
Slovenia,2022-08-18,18971173,18971173,7485,https://www.nijz.si/sl/dnevno-spremljanje-okuzb-s-sars-cov-2-covid-19,2714175,16256998,780,6705,0.8957915831663327,780,6705,3027563,15943610
Slovenia,2022-08-19,18977021,18977021,5848,https://www.nijz.si/sl/dnevno-spremljanje-okuzb-s-sars-cov-2-covid-19,2714858,16262163,683,5165,0.8832079343365253,683,5165,3028246,15948775
Slovenia,2022-08-20,18983927,18983927,6906,https://www.nijz.si/sl/dnevno-spremljanje-okuzb-s-sars-cov-2-covid-19,2715511,16268416,653,6253,0.905444540978859,653,6253,3028899,15955028
Slovenia,2022-08-21,18986091,18986091,2164,https://www.nijz.si/sl/dnevno-spremljanje-okuzb-s-sars-cov-2-covid-19,2715814,16270277,303,1861,0.859981515711645,303,1861,3029202,15956889
Slovenia,2022-08-22,18988229,18988229,2138,https://www.nijz.si/sl/dnevno-spremljanje-okuzb-s-sars-cov-2-covid-19,2716230,16271999,416,1722,0.8054256314312441,416,1722,3029618,15958611
Slovenia,2022-08-23,18997222,18997222,8993,https://www.nijz.si/sl/dnevno-spremljanje-okuzb-s-sars-cov-2-covid-19,2717162,16280060,932,8061,0.8963638385410875,932,8061,3030550,15966672
Slovenia,2022-08-24,19003951,19003951,6729,https://www.nijz.si/sl/dnevno-spremljanje-okuzb-s-sars-cov-2-covid-19,2717894,16286057,732,5997,0.8912171199286669,732,5997,3031282,15972669
Slovenia,2022-08-25,19010981,19010981,7030,https://www.nijz.si/sl/dnevno-spremljanje-okuzb-s-sars-cov-2-covid-19,2718728,16292253,834,6196,0.8813655761024182,834,6196,3032116,15978865
Slovenia,2022-08-26,19016534,19016534,5553,https://www.nijz.si/sl/dnevno-spremljanje-okuzb-s-sars-cov-2-covid-19,2719322,16297212,594,4959,0.89303079416531606,594,4959,3032710,15983824
Slovenia,2022-08-27,19023066,19023066,6532,https://www.nijz.si/sl/dnevno-spremljanje-okuzb-s-sars-cov-2-covid-19,2719959,16303107,637,5895,0.9024800979791794,637,5895,3033347,15989719
Slovenia,2022-08-28,19025213,19025213,2147,https://www.nijz.si/sl/dnevno-spremljanje-okuzb-s-sars-cov-2-covid-19,2720303,16304910,344,1803,0.83977643223102,344,1803,3033691,15991522
Slovenia,2022-08-29,19027235,19027235,2022,https://www.nijz.si/sl/dnevno-spremljanje-okuzb-s-sars-cov-2-covid-19,2720708,16306527,405,1617,0.7997032640949555,405,1617,3034096,15993139
Slovenia,2022-08-30,19036136,19036136,8901,https://www.nijz.si/sl/dnevno-spremljanje-okuzb-s-sars-cov-2-covid-19,2721547,16314589,839,8062,0.9057409279856196,839,8062,3034935,16001201
Slovenia,2022-08-31,19042774,19042774,6638,https://www.nijz.si/sl/dnevno-spremljanje-okuzb-s-sars-cov-2-covid-19,2722194,16320580,647,5991,0.9025308827960229,647,5991,3035582,16007192
Slovenia,2022-09-01,19049583,19049583,6809,https://www.nijz.si/sl/dnevno-spremljanje-okuzb-s-sars-cov-2-covid-19,2722910,16326673,716,6093,0.8948450580114554,716,6093,3036298,16013285
Slovenia,2022-09-02,19054845,19054845,5262,https://www.nijz.si/sl/dnevno-spremljanje-okuzb-s-sars-cov-2-covid-19,2723494,16331351,584,4678,0.8890155834283542,584,4678,3036882,16017963
Slovenia,2022-09-03,19060918,19060918,6073,https://www.nijz.si/sl/dnevno-spremljanje-okuzb-s-sars-cov-2-covid-19,2724210,16336708,716,5357,0.8821011032438663,716,5357,3037598,16023320
Slovenia,2022-09-04,19062736,19062736,1818,https://www.nijz.si/sl/dnevno-spremljanje-okuzb-s-sars-cov-2-covid-19,2724476,16338260,266,1552,0.8536853685368537,266,1552,3037864,16024872
Slovenia,2022-09-05,19064793,19064793,2057,https://www.nijz.si/sl/dnevno-spremljanje-okuzb-s-sars-cov-2-covid-19,2724913,16339880,437,1620,0.7875546912980068,437,1620,3038301,16026492
Slovenia,2022-09-06,19074357,19074357,9564,https://www.nijz.si/sl/dnevno-spremljanje-okuzb-s-sars-cov-2-covid-19,2725833,16348524,920,8644,0.903805938937683,920,8644,3039221,16035136
Slovenia,2022-09-07,19081036,19081036,6679,https://www.nijz.si/sl/dnevno-spremljanje-okuzb-s-sars-cov-2-covid-19,2726474,16354562,641,6038,0.9040275490342866,641,6038,3039862,16041174
Slovenia,2022-09-08,19088399,19088399,7363,https://www.nijz.si/sl/dnevno-spremljanje-okuzb-s-sars-cov-2-covid-19,2727305,16361094,831,6532,0.8871383946760831,831,6532,3040693,16047706
Slovenia,2022-09-09,19094294,19094294,5895,https://www.nijz.si/sl/dnevno-spremljanje-okuzb-s-sars-cov-2-covid-19,2728012,16366282,707,5188,0.8800678541136556,707,5188,3041400,16052894
Slovenia,2022-09-10,19101777,19101777,7483,https://www.nijz.si/sl/dnevno-spremljanje-okuzb-s-sars-cov-2-covid-19,2728899,16372878,887,6596,0.8814646532139516,887,6596,3042287,16059490
Slovenia,2022-09-11,19103824,19103824,2047,https://www.nijz.si/sl/dnevno-spremljanje-okuzb-s-sars-cov-2-covid-19,2729274,16374550,375,1672,0.8168050806057645,375,1672,3042662,16061162
Slovenia,2022-09-12,19106228,19106228,2404,https://www.nijz.si/sl/dnevno-spremljanje-okuzb-s-sars-cov-2-covid-19,2729724,16376504,450,1954,0.8128119800332779,450,1954,3043112,16063116
Slovenia,2022-09-13,19117416,19117416,11188,https://www.nijz.si/sl/dnevno-spremljanje-okuzb-s-sars-cov-2-covid-19,2730793,16386623,1069,10119,0.9044511977118341,1069,10119,3044181,16073235
Slovenia,2022-09-14,19125824,19125824,8408,https://www.nijz.si/sl/dnevno-spremljanje-okuzb-s-sars-cov-2-covid-19,2731647,16394177,854,7554,0.898430066603235,854,7554,3045035,16080789
Slovenia,2022-09-15,19134383,19134383,8559,https://www.nijz.si/sl/dnevno-spremljanje-okuzb-s-sars-cov-2-covid-19,2732669,16401714,1022,7537,0.8805935272812244,1022,7537,3046057,16088326
Slovenia,2022-09-16,19141710,19141710,7327,https://www.nijz.si/sl/dnevno-spremljanje-okuzb-s-sars-cov-2-covid-19,2733470,16408240,801,6526,0.8906783130885765,801,6526,3046858,16094852
Slovenia,2022-09-17,19150096,19150096,8386,https://www.nijz.si/sl/dnevno-spremljanje-okuzb-s-sars-cov-2-covid-19,2734306,16415790,836,7550,0.9003100405437634,836,7550,3047694,16102402
Slovenia,2022-09-18,19152693,19152693,2597,https://www.nijz.si/sl/dnevno-spremljanje-okuzb-s-sars-cov-2-covid-19,2734721,16417972,415,2182,0.8402002310358105,415,2182,3048109,16104584
Slovenia,2022-09-19,19155615,19155615,2922,https://www.nijz.si/sl/dnevno-spremljanje-okuzb-s-sars-cov-2-covid-19,2735204,16420411,483,2439,0.8347022587268994,483,2439,3048592,16107023
Slovenia,2022-09-20,19168042,19168042,12427,https://www.nijz.si/sl/dnevno-spremljanje-okuzb-s-sars-cov-2-covid-19,2736267,16431775,1063,11364,0.9144604490222902,1063,11364,3049655,16118387
Slovenia,2022-09-21,19177390,19177390,9348,https://www.nijz.si/sl/dnevno-spremljanje-okuzb-s-sars-cov-2-covid-19,2737005,16440385,738,8610,0.9210526315789473,738,8610,3050393,16126997
Slovenia,2022-09-22,19186993,19186993,9603,https://www.nijz.si/sl/dnevno-spremljanje-okuzb-s-sars-cov-2-covid-19,2737957,16449036,952,8651,0.9008643132354472,952,8651,3051345,16135648
Slovenia,2022-09-23,19194760,19194760,7767,https://www.nijz.si/sl/dnevno-spremljanje-okuzb-s-sars-cov-2-covid-19,2738635,16456125,678,7089,0.9127076091154886,678,7089,3052023,16142737
Slovenia,2022-09-24,19203968,19203968,9208,https://www.nijz.si/sl/dnevno-spremljanje-okuzb-s-sars-cov-2-covid-19,2739544,16464424,909,8299,0.9012814943527367,909,8299,3052932,16151036
Slovenia,2022-09-25,19206584,19206584,2616,https://www.nijz.si/sl/dnevno-spremljanje-okuzb-s-sars-cov-2-covid-19,2739905,16466679,361,2255,0.8620030581039755,361,2255,3053293,16153291
Slovenia,2022-09-26,19209592,19209592,3008,https://www.nijz.si/sl/dnevno-spremljanje-okuzb-s-sars-cov-2-covid-19,2740420,16469172,515,2493,0.8287898936170213,515,2493,3053808,16155784
Slovenia,2022-09-27,19223022,19223022,13430,https://www.nijz.si/sl/dnevno-spremljanje-okuzb-s-sars-cov-2-covid-19,2741506,16481516,1086,12344,0.9191362620997766,1086,12344,3054894,16168128
Slovenia,2022-09-28,19232829,19232829,9807,https://www.nijz.si/sl/dnevno-spremljanje-okuzb-s-sars-cov-2-covid-19,2742366,16490463,860,8947,0.9123075354338738,860,8947,3055754,16177075
Slovenia,2022-09-29,19243332,19243332,10503,https://www.nijz.si/sl/dnevno-spremljanje-okuzb-s-sars-cov-2-covid-19,2743408,16499924,1042,9461,0.9007902504046463,1042,9461,3056796,16186536
Slovenia,2022-09-30,19251809,19251809,8477,https://www.nijz.si/sl/dnevno-spremljanje-okuzb-s-sars-cov-2-covid-19,2744229,16507580,821,7656,0.9031496991860328,821,7656,3057617,16194192
Slovenia,2022-10-01,19261840,19261840,10031,https://www.nijz.si/sl/dnevno-spremljanje-okuzb-s-sars-cov-2-covid-19,2745129,16516711,900,9131,0.910278137772904,900,9131,3058517,16203323
Slovenia,2022-10-02,19265031,19265031,3191,https://www.nijz.si/sl/dnevno-spremljanje-okuzb-s-sars-cov-2-covid-19,2745468,16519563,339,2852,0.8937637104356001,339,2852,3058856,16206175
Slovenia,2022-10-03,19268337,19268337,3306,https://www.nijz.si/sl/dnevno-spremljanje-okuzb-s-sars-cov-2-covid-19,2745978,16522359,510,2796,0.8457350272232305,510,2796,3059366,16208971
Slovenia,2022-10-04,19283004,19283004,14667,https://www.nijz.si/sl/dnevno-spremljanje-okuzb-s-sars-cov-2-covid-19,2747083,16535921,1105,13562,0.9246608031635645,1105,13562,3060471,16222533
Slovenia,2022-10-05,19293588,19293588,10584,https://www.nijz.si/sl/dnevno-spremljanje-okuzb-s-sars-cov-2-covid-19,2747871,16545717,788,9796,0.9255479969765684,788,9796,3061259,16232329
Slovenia,2022-10-06,19304329,19304329,10741,https://www.nijz.si/sl/dnevno-spremljanje-okuzb-s-sars-cov-2-covid-19,2748888,16555441,1017,9724,0.9053160785774137,1017,9724,3062276,16242053
Slovenia,2022-10-07,19313398,19313398,9069,https://www.nijz.si/sl/dnevno-spremljanje-okuzb-s-sars-cov-2-covid-19,2749684,16563714,796,8273,0.9122284706141802,796,8273,3063072,16250326
Slovenia,2022-10-08,19323250,19323250,9852,https://www.nijz.si/sl/dnevno-spremljanje-okuzb-s-sars-cov-2-covid-19,2750552,16572698,868,8984,0.9118960617133577,868,8984,3063940,16259310
Slovenia,2022-10-09,19326282,19326282,3032,https://www.nijz.si/sl/dnevno-spremljanje-okuzb-s-sars-cov-2-covid-19,2750931,16575351,379,2653,0.875,379,2653,3064319,16261963
Slovenia,2022-10-10,19329754,19329754,3472,https://www.nijz.si/sl/dnevno-spremljanje-okuzb-s-sars-cov-2-covid-19,2751462,16578292,531,2941,0.8470622119815668,531,2941,3064850,16264904
Slovenia,2022-10-11,19343775,19343775,14021,https://www.nijz.si/sl/dnevno-spremljanje-okuzb-s-sars-cov-2-covid-19,2752551,16591224,1089,12932,0.9223307895299907,1089,12932,3065939,16277836
Slovenia,2022-10-12,19353709,19353709,9934,https://www.nijz.si/sl/dnevno-spremljanje-okuzb-s-sars-cov-2-covid-19,2753402,16600307,851,9083,0.9143346084155426,851,9083,3066790,16286919
Slovenia,2022-10-13,19363647,19363647,9938,https://www.nijz.si/sl/dnevno-spremljanje-okuzb-s-sars-cov-2-covid-19,2754332,16609315,930,9008,0.9064198027772188,930,9008,3067720,16295927
Slovenia,2022-10-14,19371582,19371582,7935,https://www.nijz.si/sl/dnevno-spremljanje-okuzb-s-sars-cov-2-covid-19,2755054,16616528,722,7213,0.9090107120352867,722,7213,3068442,16303140
Slovenia,2022-10-15,19381143,19381143,9561,https://www.nijz.si/sl/dnevno-spremljanje-okuzb-s-sars-cov-2-covid-19,2755813,16625330,759,8802,0.9206149984311265,759,8802,3069201,16311942
Slovenia,2022-10-16,19383531,19383531,2388,https://www.nijz.si/sl/dnevno-spremljanje-okuzb-s-sars-cov-2-covid-19,2756142,16627389,329,2059,0.8622278056951423,329,2059,3069530,16314001
Slovenia,2022-10-17,19386423,19386423,2892,https://www.nijz.si/sl/dnevno-spremljanje-okuzb-s-sars-cov-2-covid-19,2756587,16629836,445,2447,0.8461272475795297,445,2447,3069975,16316448
Slovenia,2022-10-18,19398668,19398668,12245,https://www.nijz.si/sl/dnevno-spremljanje-okuzb-s-sars-cov-2-covid-19,2757619,16641049,1032,11213,0.9157207023274806,1032,11213,3071007,16327661
Slovenia,2022-10-19,19406866,19406866,8198,https://www.nijz.si/sl/dnevno-spremljanje-okuzb-s-sars-cov-2-covid-19,2758328,16648538,709,7489,0.913515491583313,709,7489,3071716,16335150
Slovenia,2022-10-20,19415661,19415661,8795,https://www.nijz.si/sl/dnevno-spremljanje-okuzb-s-sars-cov-2-covid-19,2759346,16656315,1018,7777,0.8842524161455373,1018,7777,3072734,16342927
Slovenia,2022-10-21,19422653,19422653,6992,https://www.nijz.si/sl/dnevno-spremljanje-okuzb-s-sars-cov-2-covid-19,2760022,16662631,676,6316,0.9033180778032036,676,6316,3073410,16349243
Slovenia,2022-10-22,19430270,19430270,7617,https://www.nijz.si/sl/dnevno-spremljanje-okuzb-s-sars-cov-2-covid-19,2760822,16669448,800,6817,0.8949717736641722,800,6817,3074210,16356060
Slovenia,2022-10-23,19432474,19432474,2204,https://www.nijz.si/sl/dnevno-spremljanje-okuzb-s-sars-cov-2-covid-19,2761146,16671328,324,1880,0.852994555353902,324,1880,3074534,16357940
Slovenia,2022-10-24,19435043,19435043,2569,https://www.nijz.si/sl/dnevno-spremljanje-okuzb-s-sars-cov-2-covid-19,2761572,16673471,426,2143,0.8341767224601012,426,2143,3074960,16360083
Slovenia,2022-10-25,19445660,19445660,10617,https://www.nijz.si/sl/dnevno-spremljanje-okuzb-s-sars-cov-2-covid-19,2762569,16683091,997,9620,0.9060940001883772,997,9620,3075957,16369703
Slovenia,2022-10-26,19452975,19452975,7315,https://www.nijz.si/sl/dnevno-spremljanje-okuzb-s-sars-cov-2-covid-19,2763361,16689614,792,6523,0.8917293233082707,792,6523,3076749,16376226
Slovenia,2022-10-27,19460548,19460548,7573,https://www.nijz.si/sl/dnevno-spremljanje-okuzb-s-sars-cov-2-covid-19,2764318,16696230,957,6616,0.8736300013204806,957,6616,3077706,16382842
Slovenia,2022-10-28,19466690,19466690,6142,https://www.nijz.si/sl/dnevno-spremljanje-okuzb-s-sars-cov-2-covid-19,2765020,16701670,702,5440,0.8857049820905243,702,5440,3078408,16388282
Slovenia,2022-10-29,19473923,19473923,7233,https://www.nijz.si/sl/dnevno-spremljanje-okuzb-s-sars-cov-2-covid-19,2765838,16708085,818,6415,0.8869072307479607,818,6415,3079226,16394697
Slovenia,2022-10-30,19476114,19476114,2191,https://www.nijz.si/sl/dnevno-spremljanje-okuzb-s-sars-cov-2-covid-19,2766192,16709922,354,1837,0.8384299406663623,354,1837,3079580,16396534
Slovenia,2022-10-31,19478130,19478130,2016,https://www.nijz.si/sl/dnevno-spremljanje-okuzb-s-sars-cov-2-covid-19,2766682,16711448,490,1526,0.7569444444444444,490,1526,3080070,16398060
Slovenia,2022-11-01,19480439,19480439,2309,https://www.nijz.si/sl/dnevno-spremljanje-okuzb-s-sars-cov-2-covid-19,2767137,16713302,455,1854,0.8029449978345604,455,1854,3080525,16399914
Slovenia,2022-11-02,19482550,19482550,2111,https://www.nijz.si/sl/dnevno-spremljanje-okuzb-s-sars-cov-2-covid-19,2767707,16714843,570,1541,0.7299857887257224,570,1541,3081095,16401455
Slovenia,2022-11-03,19490440,19490440,7890,https://www.nijz.si/sl/dnevno-spremljanje-okuzb-s-sars-cov-2-covid-19,2768635,16721805,928,6962,0.8823827629911281,928,6962,3082023,16408417
Slovenia,2022-11-04,19496278,19496278,5838,https://www.nijz.si/sl/dnevno-spremljanje-okuzb-s-sars-cov-2-covid-19,2769448,16726830,813,5025,0.8607399794450155,813,5025,3082836,16413442
Slovenia,2022-11-05,19501774,19501774,5496,https://www.nijz.si/sl/dnevno-spremljanje-okuzb-s-sars-cov-2-covid-19,2770136,16731638,688,4808,0.8748180494905385,688,4808,3083524,16418250
Slovenia,2022-11-06,19503537,19503537,1763,https://www.nijz.si/sl/dnevno-spremljanje-okuzb-s-sars-cov-2-covid-19,2770484,16733053,348,1415,0.8026091888825865,348,1415,3083872,16419665
Slovenia,2022-11-07,19505295,19505295,1758,https://www.nijz.si/sl/dnevno-spremljanje-okuzb-s-sars-cov-2-covid-19,2770906,16734389,422,1336,0.7599544937428896,422,1336,3084294,16421001
Slovenia,2022-11-08,19512471,19512471,7176,https://www.nijz.si/sl/dnevno-spremljanje-okuzb-s-sars-cov-2-covid-19,2771804,16740667,898,6278,0.874860646599777,898,6278,3085192,16427279
Slovenia,2022-11-09,19517894,19517894,5423,https://www.nijz.si/sl/dnevno-spremljanje-okuzb-s-sars-cov-2-covid-19,2772501,16745393,697,4726,0.8714733542319749,697,4726,3085889,16432005
Slovenia,2022-11-10,19524049,19524049,6155,https://www.nijz.si/sl/dnevno-spremljanje-okuzb-s-sars-cov-2-covid-19,2773248,16750801,747,5408,0.8786352558895207,747,5408,3086636,16437413
Slovenia,2022-11-11,19528885,19528885,4836,https://www.nijz.si/sl/dnevno-spremljanje-okuzb-s-sars-cov-2-covid-19,2773867,16755018,619,4217,0.8720016542597188,619,4217,3087255,16441630
Slovenia,2022-11-12,19534334,19534334,5449,https://www.nijz.si/sl/dnevno-spremljanje-okuzb-s-sars-cov-2-covid-19,2774547,16759787,680,4769,0.8752064599008993,680,4769,3087935,16446399
Slovenia,2022-11-13,19535764,19535764,1430,https://www.nijz.si/sl/dnevno-spremljanje-okuzb-s-sars-cov-2-covid-19,2774851,16760913,304,1126,0.7874125874125875,304,1126,3088239,16447525
Slovenia,2022-11-14,19537559,19537559,1795,https://www.nijz.si/sl/dnevno-spremljanje-okuzb-s-sars-cov-2-covid-19,2775252,16762307,401,1394,0.7766016713091922,401,1394,3088640,16448919
Slovenia,2022-11-15,19545455,19545455,7896,https://www.nijz.si/sl/dnevno-spremljanje-okuzb-s-sars-cov-2-covid-19,2776084,16769371,832,7064,0.894630192502533,832,7064,3089472,16455983
Slovenia,2022-11-16,19551319,19551319,5864,https://www.nijz.si/sl/dnevno-spremljanje-okuzb-s-sars-cov-2-covid-19,2776727,16774592,643,5221,0.8903478854024557,643,5221,3090115,16461204
Slovenia,2022-11-17,19557189,19557189,5870,https://www.nijz.si/sl/dnevno-spremljanje-okuzb-s-sars-cov-2-covid-19,2777497,16779692,770,5100,0.868824531516184,770,5100,3090885,16466304
Slovenia,2022-11-18,19562330,19562330,5141,https://www.nijz.si/sl/dnevno-spremljanje-okuzb-s-sars-cov-2-covid-19,2778144,16784186,647,4494,0.8741489982493679,647,4494,3091532,16470798
Slovenia,2022-11-19,19568075,19568075,5745,https://www.nijz.si/sl/dnevno-spremljanje-okuzb-s-sars-cov-2-covid-19,2778797,16789278,653,5092,0.8863359442993908,653,5092,3092185,16475890
Slovenia,2022-11-20,19569592,19569592,1517,https://www.nijz.si/sl/dnevno-spremljanje-okuzb-s-sars-cov-2-covid-19,2779057,16790535,260,1257,0.8286090969017799,260,1257,3092445,16477147
Slovenia,2022-11-21,19571516,19571516,1924,https://www.nijz.si/sl/dnevno-spremljanje-okuzb-s-sars-cov-2-covid-19,2779414,16792102,357,1567,0.8144490644490644,357,1567,3092802,16478714
Slovenia,2022-11-22,19579894,19579894,8378,https://www.nijz.si/sl/dnevno-spremljanje-okuzb-s-sars-cov-2-covid-19,2780283,16799611,869,7509,0.8962759608498448,869,7509,3093671,16486223
Slovenia,2022-11-23,19585982,19585982,6088,https://www.nijz.si/sl/dnevno-spremljanje-okuzb-s-sars-cov-2-covid-19,2780927,16805055,644,5444,0.8942181340341656,644,5444,3094315,16491667
Slovenia,2022-11-24,19592619,19592619,6637,https://www.nijz.si/sl/dnevno-spremljanje-okuzb-s-sars-cov-2-covid-19,2781726,16810893,799,5838,0.8796142835618502,799,5838,3095114,16497505
Slovenia,2022-11-25,19598782,19598782,6163,https://www.nijz.si/sl/dnevno-spremljanje-okuzb-s-sars-cov-2-covid-19,2782309,16816473,583,5580,0.9054032127210774,583,5580,3095697,16503085
Slovenia,2022-11-26,19605325,19605325,6543,https://www.nijz.si/sl/dnevno-spremljanje-okuzb-s-sars-cov-2-covid-19,2783012,16822313,703,5840,0.892556931071374,703,5840,3096400,16508925
Slovenia,2022-11-27,19607184,19607184,1859,https://www.nijz.si/sl/dnevno-spremljanje-okuzb-s-sars-cov-2-covid-19,2783336,16823848,324,1535,0.8257127487896718,324,1535,3096724,16510460
Slovenia,2022-11-28,19609409,19609409,2225,https://www.nijz.si/sl/dnevno-spremljanje-okuzb-s-sars-cov-2-covid-19,2783745,16825664,409,1816,0.8161797752808989,409,1816,3097133,16512276
Slovenia,2022-11-29,19618675,19618675,9266,https://www.nijz.si/sl/dnevno-spremljanje-okuzb-s-sars-cov-2-covid-19,2784546,16834129,801,8465,0.9135549320094971,801,8465,3097934,16520741
Slovenia,2022-11-30,19626401,19626401,7726,https://www.nijz.si/sl/dnevno-spremljanje-okuzb-s-sars-cov-2-covid-19,2785303,16841098,757,6969,0.9020191560962982,757,6969,3098691,16527710
Slovenia,2022-12-01,19634442,19634442,8041,https://www.nijz.si/sl/dnevno-spremljanje-okuzb-s-sars-cov-2-covid-19,2786083,16848359,780,7261,0.9029971396592463,780,7261,3099471,16534971
Slovenia,2022-12-02,19641029,19641029,6587,https://www.nijz.si/sl/dnevno-spremljanje-okuzb-s-sars-cov-2-covid-19,2786759,16854270,676,5911,0.8973736146956126,676,5911,3100147,16540882
Slovenia,2022-12-03,19648228,19648228,7199,https://www.nijz.si/sl/dnevno-spremljanje-okuzb-s-sars-cov-2-covid-19,2787411,16860817,652,6547,0.9094318655368802,652,6547,3100799,16547429
Slovenia,2022-12-04,19650234,19650234,2006,https://www.nijz.si/sl/dnevno-spremljanje-okuzb-s-sars-cov-2-covid-19,2787711,16862523,300,1706,0.8504486540378864,300,1706,3101099,16549135
Slovenia,2022-12-05,19652620,19652620,2386,https://www.nijz.si/sl/dnevno-spremljanje-okuzb-s-sars-cov-2-covid-19,2788088,16864532,377,2009,0.8419949706621962,377,2009,3101476,16551144
Slovenia,2022-12-06,19663405,19663405,10785,https://www.nijz.si/sl/dnevno-spremljanje-okuzb-s-sars-cov-2-covid-19,2788995,16874410,907,9878,0.9159017153453871,907,9878,3102383,16561022
Slovenia,2022-12-07,19671986,19671986,8581,https://www.nijz.si/sl/dnevno-spremljanje-okuzb-s-sars-cov-2-covid-19,2789755,16882231,760,7821,0.9114322340053607,760,7821,3103143,16568843
Slovenia,2022-12-08,19680733,19680733,8747,https://www.nijz.si/sl/dnevno-spremljanje-okuzb-s-sars-cov-2-covid-19,2790549,16890184,794,7953,0.9092260203498342,794,7953,3103937,16576796
Slovenia,2022-12-09,19688156,19688156,7423,https://www.nijz.si/sl/dnevno-spremljanje-okuzb-s-sars-cov-2-covid-19,2791227,16896929,678,6745,0.9086622659302169,678,6745,3104615,16583541
Slovenia,2022-12-10,19696934,19696934,8778,https://www.nijz.si/sl/dnevno-spremljanje-okuzb-s-sars-cov-2-covid-19,2791968,16904966,741,8037,0.9155844155844156,741,8037,3105356,16591578
Slovenia,2022-12-11,19699309,19699309,2375,https://www.nijz.si/sl/dnevno-spremljanje-okuzb-s-sars-cov-2-covid-19,2792371,16906938,403,1972,0.8303157894736842,403,1972,3105759,16593550
Slovenia,2022-12-12,19702083,19702083,2774,https://www.nijz.si/sl/dnevno-spremljanje-okuzb-s-sars-cov-2-covid-19,2792752,16909331,381,2393,0.8626532083633742,381,2393,3106140,16595943
Slovenia,2022-12-13,19714221,19714221,12138,https://www.nijz.si/sl/dnevno-spremljanje-okuzb-s-sars-cov-2-covid-19,2793706,16920515,954,11184,0.921403855659911,954,11184,3107094,16607127
Slovenia,2022-12-14,19723779,19723779,9558,https://www.nijz.si/sl/dnevno-spremljanje-okuzb-s-sars-cov-2-covid-19,2794492,16929287,786,8772,0.9177652228499686,786,8772,3107880,16615899
Slovenia,2022-12-15,19733550,19733550,9771,https://www.nijz.si/sl/dnevno-spremljanje-okuzb-s-sars-cov-2-covid-19,2795399,16938151,907,8864,0.907174291270085,907,8864,3108787,16624763
Slovenia,2022-12-16,19741773,19741773,8223,https://www.nijz.si/sl/dnevno-spremljanje-okuzb-s-sars-cov-2-covid-19,2796244,16945529,845,7378,0.8972394503222668,845,7378,3109632,16632141
Slovenia,2022-12-17,19750596,19750596,8823,https://www.nijz.si/sl/dnevno-spremljanje-okuzb-s-sars-cov-2-covid-19,2797108,16953488,864,7959,0.9020741244474668,864,7959,3110496,16640100
Slovenia,2022-12-18,19753126,19753126,2530,https://www.nijz.si/sl/dnevno-spremljanje-okuzb-s-sars-cov-2-covid-19,2797558,16955568,450,2080,0.8221343873517787,450,2080,3110946,16642180
Slovenia,2022-12-19,19756088,19756088,2962,https://www.nijz.si/sl/dnevno-spremljanje-okuzb-s-sars-cov-2-covid-19,2797998,16958090,440,2522,0.8514517218095882,440,2522,3111386,16644702
Slovenia,2022-12-20,19768607,19768607,12519,https://www.nijz.si/sl/dnevno-spremljanje-okuzb-s-sars-cov-2-covid-19,2798922,16969685,924,11595,0.9261921878744309,924,11595,3112310,16656297
Slovenia,2022-12-21,19768607,19768607,0,https://www.nijz.si/sl/dnevno-spremljanje-okuzb-s-sars-cov-2-covid-19,2798922,16969685,0,0,0.9261921878744309,0,0,3112310,16656297
Slovenia,2022-12-22,19778843,19778843,10236,https://www.nijz.si/sl/dnevno-spremljanje-okuzb-s-sars-cov-2-covid-19,2799759,16979084,837,9399,0.9182297772567409,837,9399,3113147,16665696
Slovenia,2022-12-23,19796910,19796910,18067,https://www.nijz.si/sl/dnevno-spremljanje-okuzb-s-sars-cov-2-covid-19,2801541,16995369,1782,16285,0.9013671334477223,1782,16285,3114929,16681981
Slovenia,2022-12-24,19796910,19796910,0,https://www.nijz.si/sl/dnevno-spremljanje-okuzb-s-sars-cov-2-covid-19,2801541,16995369,0,0,0.9013671334477223,0,0,3114929,16681981
Slovenia,2022-12-25,19807511,19807511,10601,https://www.nijz.si/sl/dnevno-spremljanje-okuzb-s-sars-cov-2-covid-19,2802762,17004749,1221,9380,0.8848221865861711,1221,9380,3116150,16691361
Slovenia,2022-12-26,19809471,19809471,1960,https://www.nijz.si/sl/dnevno-spremljanje-okuzb-s-sars-cov-2-covid-19,2803128,17006343,366,1594,0.813265306122449,366,1594,3116516,16692955
Slovenia,2022-12-27,19812731,19812731,3260,https://www.nijz.si/sl/dnevno-spremljanje-okuzb-s-sars-cov-2-covid-19,2803682,17009049,554,2706,0.8300613496932515,554,2706,3117070,16695661
Slovenia,2022-12-28,19823667,19823667,10936,https://www.nijz.si/sl/dnevno-spremljanje-okuzb-s-sars-cov-2-covid-19,2804561,17019106,879,10057,0.9196232626188734,879,10057,3117949,16705718
Slovenia,2022-12-29,19831783,19831783,8116,https://www.nijz.si/sl/dnevno-spremljanje-okuzb-s-sars-cov-2-covid-19,2805418,17026365,857,7259,0.8944061113849187,857,7259,3118806,16712977
Slovenia,2022-12-30,19838199,19838199,6416,https://www.nijz.si/sl/dnevno-spremljanje-okuzb-s-sars-cov-2-covid-19,2806131,17032068,713,5703,0.8888715710723192,713,5703,3119519,16718680
Slovenia,2022-12-31,19845254,19845254,7055,https://www.nijz.si/sl/dnevno-spremljanje-okuzb-s-sars-cov-2-covid-19,2806857,17038397,726,6329,0.8970942593905031,726,6329,3120245,16725009
Slovenia,2023-01-01,19847268,19847268,2014,https://www.nijz.si/sl/dnevno-spremljanje-okuzb-s-sars-cov-2-covid-19,2807176,17040092,319,1695,0.8416087388282025,319,1695,3120564,16726704
Slovenia,2023-01-02,19848803,19848803,1535,https://www.nijz.si/sl/dnevno-spremljanje-okuzb-s-sars-cov-2-covid-19,2807476,17041327,300,1235,0.8045602605863192,300,1235,3120864,16727939
Slovenia,2023-01-03,19851769,19851769,2966,https://www.nijz.si/sl/dnevno-spremljanje-okuzb-s-sars-cov-2-covid-19,2808024,17043745,548,2418,0.8152393796358732,548,2418,3121412,16730357
Slovenia,2023-01-04,19862962,19862962,11193,https://www.nijz.si/sl/dnevno-spremljanje-okuzb-s-sars-cov-2-covid-19,2808893,17054069,869,10324,0.9223621906548736,869,10324,3122281,16740681
Slovenia,2023-01-05,19871419,19871419,8457,https://www.nijz.si/sl/dnevno-spremljanje-okuzb-s-sars-cov-2-covid-19,2809753,17061666,860,7597,0.8983090930590044,860,7597,3123141,16748278
Slovenia,2023-01-06,19877658,19877658,6239,https://www.nijz.si/sl/dnevno-spremljanje-okuzb-s-sars-cov-2-covid-19,2810482,17067176,729,5510,0.8831543516589196,729,5510,3123870,16753788
Slovenia,2023-01-07,19877658,19877658,0,https://www.nijz.si/sl/dnevno-spremljanje-okuzb-s-sars-cov-2-covid-19,2810482,17067176,0,0,0.8831543516589196,0,0,3123870,16753788
Slovenia,2023-01-08,19886243,19886243,8585,https://www.nijz.si/sl/dnevno-spremljanje-okuzb-s-sars-cov-2-covid-19,2811630,17074613,1148,7437,0.8662783925451368,1148,7437,3125018,16761225
Slovenia,2023-01-09,19888195,19888195,1952,https://www.nijz.si/sl/dnevno-spremljanje-okuzb-s-sars-cov-2-covid-19,2812044,17076151,414,1538,0.7879098360655737,414,1538,3125432,16762763
Slovenia,2023-01-10,19896011,19896011,7816,https://www.nijz.si/sl/dnevno-spremljanje-okuzb-s-sars-cov-2-covid-19,2812988,17083023,944,6872,0.8792221084953941,944,6872,3126376,16769635
Slovenia,2023-01-11,19901945,19901945,5934,https://www.nijz.si/sl/dnevno-spremljanje-okuzb-s-sars-cov-2-covid-19,2813691,17088254,703,5231,0.8815301651499832,703,5231,3127079,16774866
Slovenia,2023-01-12,19907767,19907767,5822,https://www.nijz.si/sl/dnevno-spremljanje-okuzb-s-sars-cov-2-covid-19,2814434,17093333,743,5079,0.8723806252147028,743,5079,3127822,16779945
Slovenia,2023-01-13,19912334,19912334,4567,https://www.nijz.si/sl/dnevno-spremljanje-okuzb-s-sars-cov-2-covid-19,2815061,17097273,627,3940,0.8627107510400701,627,3940,3128449,16783885
Slovenia,2023-01-14,19917638,19917638,5304,https://www.nijz.si/sl/dnevno-spremljanje-okuzb-s-sars-cov-2-covid-19,2815767,17101871,706,4598,0.8668929110105581,706,4598,3129155,16788483
Slovenia,2023-01-15,19918978,19918978,1340,https://www.nijz.si/sl/dnevno-spremljanje-okuzb-s-sars-cov-2-covid-19,2816083,17102895,316,1024,0.764179104477612,316,1024,3129471,16789507
Slovenia,2023-01-16,19920544,19920544,1566,https://www.nijz.si/sl/dnevno-spremljanje-okuzb-s-sars-cov-2-covid-19,2816430,17104114,347,1219,0.7784163473818646,347,1219,3129818,16790726
Slovenia,2023-01-17,19926469,19926469,5925,https://www.nijz.si/sl/dnevno-spremljanje-okuzb-s-sars-cov-2-covid-19,2817235,17109234,805,5120,0.8641350210970464,805,5120,3130623,16795846
Slovenia,2023-01-18,19931707,19931707,5238,https://www.nijz.si/sl/dnevno-spremljanje-okuzb-s-sars-cov-2-covid-19,2817828,17113879,593,4645,0.8867888507063765,593,4645,3131216,16800491
Slovenia,2023-01-19,19936854,19936854,5147,https://www.nijz.si/sl/dnevno-spremljanje-okuzb-s-sars-cov-2-covid-19,2818516,17118338,688,4459,0.8663299009131533,688,4459,3131904,16804950
Slovenia,2023-01-20,19940849,19940849,3995,https://www.nijz.si/sl/dnevno-spremljanje-okuzb-s-sars-cov-2-covid-19,2819058,17121791,542,3453,0.8643304130162703,542,3453,3132446,16808403
Slovenia,2023-01-21,19945552,19945552,4703,https://www.nijz.si/sl/dnevno-spremljanje-okuzb-s-sars-cov-2-covid-19,2819679,17125873,621,4082,0.867956623431852,621,4082,3133067,16812485
Slovenia,2023-01-22,19946686,19946686,1134,https://www.nijz.si/sl/dnevno-spremljanje-okuzb-s-sars-cov-2-covid-19,2819927,17126759,248,886,0.781305114638448,248,886,3133315,16813371
Slovenia,2023-01-23,19948144,19948144,1458,https://www.nijz.si/sl/dnevno-spremljanje-okuzb-s-sars-cov-2-covid-19,2820254,17127890,327,1131,0.7757201646090535,327,1131,3133642,16814502
Slovenia,2023-01-24,19958530,19958530,10386,https://www.nijz.si/sl/dnevno-spremljanje-okuzb-s-sars-cov-2-covid-19,2820254,17127890,0,0,0.7757201646090535,2329,8057,3135971,16822559
Slovenia,2023-01-25,19958530,19958530,0,https://www.nijz.si/sl/dnevno-spremljanje-okuzb-s-sars-cov-2-covid-19,2820254,17127890,0,0,0.7757201646090535,0,0,3135971,16822559
Slovenia,2023-01-26,19958530,19958530,0,https://www.nijz.si/sl/dnevno-spremljanje-okuzb-s-sars-cov-2-covid-19,2820254,17127890,0,0,0.7757201646090535,0,0,3135971,16822559
Slovenia,2023-01-27,19958530,19958530,0,https://www.nijz.si/sl/dnevno-spremljanje-okuzb-s-sars-cov-2-covid-19,2820254,17127890,0,0,0.7757201646090535,0,0,3135971,16822559
Slovenia,2023-01-28,19973022,19973022,14492,https://www.nijz.si/sl/dnevno-spremljanje-okuzb-s-sars-cov-2-covid-19,2820254,17127890,0,0,0.7757201646090535,3250,11242,3139221,16833801
Slovenia,2023-01-29,19974195,19974195,1173,https://www.nijz.si/sl/dnevno-spremljanje-okuzb-s-sars-cov-2-covid-19,2820254,17127890,0,0,0.7757201646090535,263,910,3139484,16834711
Slovenia,2023-01-30,19979992,19979992,5797,https://www.nijz.si/sl/dnevno-spremljanje-okuzb-s-sars-cov-2-covid-19,2820254,17127890,0,0,0.7757201646090535,1300,4497,3140784,16839208
Slovenia,2023-01-31,19979992,19979992,0,https://www.nijz.si/sl/dnevno-spremljanje-okuzb-s-sars-cov-2-covid-19,2824480,17155512,4226,27622,0.8673072092439086,0,0,3140784,16839208
Slovenia,2023-02-01,19984550,19984550,4558,https://www.nijz.si/sl/dnevno-spremljanje-okuzb-s-sars-cov-2-covid-19,2825007,17159543,527,4031,0.8843791136463361,527,4031,3141311,16843239
Slovenia,2023-02-02,19989129,19989129,4579,https://www.nijz.si/sl/dnevno-spremljanje-okuzb-s-sars-cov-2-covid-19,2825612,17163517,605,3974,0.8678750818956104,605,3974,3141916,16847213
Slovenia,2023-02-03,19992740,19992740,3611,https://www.nijz.si/sl/dnevno-spremljanje-okuzb-s-sars-cov-2-covid-19,2826117,17166623,505,3106,0.8601495430628635,505,3106,3142421,16850319
Slovenia,2023-02-04,19996881,19996881,4141,https://www.nijz.si/sl/dnevno-spremljanje-okuzb-s-sars-cov-2-covid-19,2826699,17170182,582,3559,0.8594542381067375,582,3559,3143003,16853878
Slovenia,2023-02-05,19998105,19998105,1224,https://www.nijz.si/sl/dnevno-spremljanje-okuzb-s-sars-cov-2-covid-19,2826935,17171170,236,988,0.8071895424836601,236,988,3143239,16854866
Slovenia,2023-02-06,19999269,19999269,1164,https://www.nijz.si/sl/dnevno-spremljanje-okuzb-s-sars-cov-2-covid-19,2827196,17172073,261,903,0.7757731958762887,261,903,3143500,16855769
Slovenia,2023-02-07,20003875,20003875,4606,https://www.nijz.si/sl/dnevno-spremljanje-okuzb-s-sars-cov-2-covid-19,2827841,17176034,645,3961,0.859965262700825,645,3961,3144145,16859730
Slovenia,2023-02-08,20007072,20007072,3197,https://www.nijz.si/sl/dnevno-spremljanje-okuzb-s-sars-cov-2-covid-19,2828235,17178837,394,2803,0.8767594619956209,394,2803,3144539,16862533
Slovenia,2023-02-09,20008460,20008460,1388,https://www.nijz.si/sl/dnevno-spremljanje-okuzb-s-sars-cov-2-covid-19,2828517,17179943,282,1106,0.7968299711815562,282,1106,3144821,16863639
Slovenia,2023-02-10,20012007,20012007,3547,https://www.nijz.si/sl/dnevno-spremljanje-okuzb-s-sars-cov-2-covid-19,2828958,17183049,441,3106,0.8756695799266986,441,3106,3145262,16866745
Slovenia,2023-02-11,20015495,20015495,3488,https://www.nijz.si/sl/dnevno-spremljanje-okuzb-s-sars-cov-2-covid-19,2829561,17185934,603,2885,0.8271215596330275,603,2885,3145865,16869630
Slovenia,2023-02-12,20016586,20016586,1091,https://www.nijz.si/sl/dnevno-spremljanje-okuzb-s-sars-cov-2-covid-19,2829805,17186781,244,847,0.7763519706691109,244,847,3146109,16870477
Slovenia,2023-02-13,20017769,20017769,1183,https://www.nijz.si/sl/dnevno-spremljanje-okuzb-s-sars-cov-2-covid-19,2830092,17187677,287,896,0.757396449704142,287,896,3146396,16871373
Slovenia,2023-02-14,20022990,20022990,5221,https://www.nijz.si/sl/dnevno-spremljanje-okuzb-s-sars-cov-2-covid-19,2830757,17192233,665,4556,0.8726297644129477,665,4556,3147061,16875929
Spain,2021-03-29,37160539,37160539,129610,https://www.sanidad.gob.es/profesionales/saludPublica/ccayes/alertasActual/nCov/pruebasRealizadas.htm,27573864,8726719,526186,250894,0.32286765841354814,87763,41847,27573864,8726719
Spain,2021-03-30,37290365,37290365,129826,https://www.sanidad.gob.es/profesionales/saludPublica/ccayes/alertasActual/nCov/pruebasRealizadas.htm,27573864,8726719,0,0,0.32286765841354814,87909,41917,27661773,8768636
Spain,2021-03-31,37416915,37416915,126550,https://www.sanidad.gob.es/profesionales/saludPublica/ccayes/alertasActual/nCov/pruebasRealizadas.htm,27573864,8726719,0,0,0.32286765841354814,85691,40859,27747464,8809495
Spain,2021-04-01,37500035,37500035,83120,https://www.sanidad.gob.es/profesionales/saludPublica/ccayes/alertasActual/nCov/pruebasRealizadas.htm,27573864,8726719,0,0,0.32286765841354814,56283,26837,27803747,8836332
Spain,2021-04-02,37553485,37553485,53450,https://www.sanidad.gob.es/profesionales/saludPublica/ccayes/alertasActual/nCov/pruebasRealizadas.htm,27573864,8726719,0,0,0.32286765841354814,36193,17257,27839940,8853589
Spain,2021-04-03,37627725,37627725,74240,https://www.sanidad.gob.es/profesionales/saludPublica/ccayes/alertasActual/nCov/pruebasRealizadas.htm,27573864,8726719,0,0,0.32286765841354814,50270,23970,27890210,8877559
Spain,2021-04-04,37689501,37689501,61776,https://www.sanidad.gob.es/profesionales/saludPublica/ccayes/alertasActual/nCov/pruebasRealizadas.htm,27573864,8726719,0,0,0.32286765841354814,41831,19945,27932041,8897504
Spain,2021-04-05,37799708,37799708,110207,https://www.sanidad.gob.es/profesionales/saludPublica/ccayes/alertasActual/nCov/pruebasRealizadas.htm,28028393,8984225,454529,257506,0.3616479526989544,70351,39856,28002392,8937360
Spain,2021-04-06,37950049,37950049,150341,https://www.sanidad.gob.es/profesionales/saludPublica/ccayes/alertasActual/nCov/pruebasRealizadas.htm,28028393,8984225,0,0,0.3616479526989544,95970,54371,28098362,8991731
Spain,2021-04-07,38099167,38099167,149118,https://www.sanidad.gob.es/profesionales/saludPublica/ccayes/alertasActual/nCov/pruebasRealizadas.htm,28028393,8984225,0,0,0.3616479526989544,95190,53928,28193552,9045659
Spain,2021-04-08,38242711,38242711,143544,https://www.sanidad.gob.es/profesionales/saludPublica/ccayes/alertasActual/nCov/pruebasRealizadas.htm,28028393,8984225,0,0,0.3616479526989544,91632,51912,28285184,9097571
Spain,2021-04-09,38391868,38391868,149157,https://www.sanidad.gob.es/profesionales/saludPublica/ccayes/alertasActual/nCov/pruebasRealizadas.htm,28028393,8984225,0,0,0.3616479526989544,95215,53942,28380399,9151513
Spain,2021-04-10,38484752,38484752,92884,https://www.sanidad.gob.es/profesionales/saludPublica/ccayes/alertasActual/nCov/pruebasRealizadas.htm,28028393,8984225,0,0,0.3616479526989544,59293,33591,28439692,9185104
Spain,2021-04-11,38544034,38544034,59282,https://www.sanidad.gob.es/profesionales/saludPublica/ccayes/alertasActual/nCov/pruebasRealizadas.htm,28028393,8984225,0,0,0.3616479526989544,37843,21439,28477535,9206543
Spain,2021-04-12,38681742,38681742,137708,https://www.sanidad.gob.es/profesionales/saludPublica/ccayes/alertasActual/nCov/pruebasRealizadas.htm,28506257,9249690,477864,265465,0.3571298846136771,88528,49180,28566063,9255723
Spain,2021-04-13,38841043,38841043,159301,https://www.sanidad.gob.es/profesionales/saludPublica/ccayes/alertasActual/nCov/pruebasRealizadas.htm,28506257,9249690,0,0,0.3571298846136771,102410,56891,28668473,9312614
Spain,2021-04-14,38999941,38999941,158898,https://www.sanidad.gob.es/profesionales/saludPublica/ccayes/alertasActual/nCov/pruebasRealizadas.htm,28506257,9249690,0,0,0.3571298846136771,102151,56747,28770624,9369361
Spain,2021-04-15,39139511,39139511,139570,https://www.sanidad.gob.es/profesionales/saludPublica/ccayes/alertasActual/nCov/pruebasRealizadas.htm,28506257,9249690,0,0,0.3571298846136771,89725,49845,28860349,9419206
Spain,2021-04-16,39286046,39286046,146535,https://www.sanidad.gob.es/profesionales/saludPublica/ccayes/alertasActual/nCov/pruebasRealizadas.htm,28506257,9249690,0,0,0.3571298846136771,94203,52332,28954552,9471538
Spain,2021-04-17,39374533,39374533,88487,https://www.sanidad.gob.es/profesionales/saludPublica/ccayes/alertasActual/nCov/pruebasRealizadas.htm,28506257,9249690,0,0,0.3571298846136771,56886,31601,29011438,9503139
Spain,2021-04-18,39434176,39434176,59643,https://www.sanidad.gob.es/profesionales/saludPublica/ccayes/alertasActual/nCov/pruebasRealizadas.htm,28506257,9249690,0,0,0.3571298846136771,38343,21300,29049781,9524439
Spain,2021-04-19,39582148,39582148,147972,https://www.sanidad.gob.es/profesionales/saludPublica/ccayes/alertasActual/nCov/pruebasRealizadas.htm,29087554,9557179,581297,307489,0.34596517046848174,96779,51193,29146560,9575632
Spain,2021-04-20,39741521,39741521,159373,https://www.sanidad.gob.es/profesionales/saludPublica/ccayes/alertasActual/nCov/pruebasRealizadas.htm,29087554,9557179,0,0,0.34596517046848174,104235,55138,29250795,9630770
Spain,2021-04-21,39890686,39890686,149165,https://www.sanidad.gob.es/profesionales/saludPublica/ccayes/alertasActual/nCov/pruebasRealizadas.htm,29087554,9557179,0,0,0.34596517046848174,97559,51606,29348354,9682376
Spain,2021-04-22,40035795,40035795,145109,https://www.sanidad.gob.es/profesionales/saludPublica/ccayes/alertasActual/nCov/pruebasRealizadas.htm,29087554,9557179,0,0,0.34596517046848174,94906,50203,29443260,9732579
Spain,2021-04-23,40177418,40177418,141623,https://www.sanidad.gob.es/profesionales/saludPublica/ccayes/alertasActual/nCov/pruebasRealizadas.htm,29087554,9557179,0,0,0.34596517046848174,92626,48997,29535886,9781576
Spain,2021-04-24,40270311,40270311,92893,https://www.sanidad.gob.es/profesionales/saludPublica/ccayes/alertasActual/nCov/pruebasRealizadas.htm,29087554,9557179,0,0,0.34596517046848174,60755,32138,29596641,9813714
Spain,2021-04-25,40331126,40331126,60815,https://www.sanidad.gob.es/profesionales/saludPublica/ccayes/alertasActual/nCov/pruebasRealizadas.htm,29087554,9557179,0,0,0.34596517046848174,39775,21040,29636416,9834754
Spain,2021-04-26,40481512,40481512,150386,https://www.sanidad.gob.es/profesionales/saludPublica/ccayes/alertasActual/nCov/pruebasRealizadas.htm,29675676,9858093,588122,300914,0.33847223284546407,99485,50901,29735901,9885655
Spain,2021-04-27,40644784,40644784,163272,https://www.sanidad.gob.es/profesionales/saludPublica/ccayes/alertasActual/nCov/pruebasRealizadas.htm,29675676,9858093,0,0,0.33847223284546407,108009,55263,29843910,9940918
Spain,2021-04-28,40794750,40794750,149966,https://www.sanidad.gob.es/profesionales/saludPublica/ccayes/alertasActual/nCov/pruebasRealizadas.htm,29675676,9858093,0,0,0.33847223284546407,99207,50759,29943117,9991677
Spain,2021-04-29,40937832,40937832,143082,https://www.sanidad.gob.es/profesionales/saludPublica/ccayes/alertasActual/nCov/pruebasRealizadas.htm,29675676,9858093,0,0,0.33847223284546407,94653,48429,30037770,10040106
Spain,2021-04-30,41089821,41089821,151989,https://www.sanidad.gob.es/profesionales/saludPublica/ccayes/alertasActual/nCov/pruebasRealizadas.htm,29675676,9858093,0,0,0.33847223284546407,100545,51444,30138315,10091550
Spain,2021-05-01,41168962,41168962,79141,https://www.sanidad.gob.es/profesionales/saludPublica/ccayes/alertasActual/nCov/pruebasRealizadas.htm,29675676,9858093,0,0,0.33847223284546407,52354,26787,30190669,10118337
Spain,2021-05-02,41227181,41227181,58219,https://www.sanidad.gob.es/profesionales/saludPublica/ccayes/alertasActual/nCov/pruebasRealizadas.htm,29675676,9858093,0,0,0.33847223284546407,38513,19706,30229182,10138043
Spain,2021-05-03,41353828,41353828,126647,https://www.sanidad.gob.es/profesionales/saludPublica/ccayes/alertasActual/nCov/pruebasRealizadas.htm,29675676,9858093,0,0,0.33847223284546407,83781,42866,30312963,10180909
Spain,2021-05-04,41503889,41503889,150061,https://www.sanidad.gob.es/profesionales/saludPublica/ccayes/alertasActual/nCov/pruebasRealizadas.htm,30277072,10185335,601396,327242,0.35238919794365514,97181,52880,30410144,10233789
Spain,2021-05-05,41648606,41648606,144717,https://www.sanidad.gob.es/profesionales/saludPublica/ccayes/alertasActual/nCov/pruebasRealizadas.htm,30277072,10185335,0,0,0.35238919794365514,93720,50997,30503864,10284786
Spain,2021-05-06,41782975,41782975,134369,https://www.sanidad.gob.es/profesionales/saludPublica/ccayes/alertasActual/nCov/pruebasRealizadas.htm,30277072,10185335,0,0,0.35238919794365514,87019,47350,30590883,10332136
Spain,2021-05-07,41923459,41923459,140484,https://www.sanidad.gob.es/profesionales/saludPublica/ccayes/alertasActual/nCov/pruebasRealizadas.htm,30277072,10185335,0,0,0.35238919794365514,90979,49505,30681862,10381641
Spain,2021-05-08,42006929,42006929,83470,https://www.sanidad.gob.es/profesionales/saludPublica/ccayes/alertasActual/nCov/pruebasRealizadas.htm,30277072,10185335,0,0,0.35238919794365514,54056,29414,30735918,10411055
Spain,2021-05-09,42065760,42065760,58831,https://www.sanidad.gob.es/profesionales/saludPublica/ccayes/alertasActual/nCov/pruebasRealizadas.htm,30277072,10185335,0,0,0.35238919794365514,38100,20731,30774018,10431786
Spain,2021-05-10,42198628,42198628,132868,https://www.sanidad.gob.es/profesionales/saludPublica/ccayes/alertasActual/nCov/pruebasRealizadas.htm,30836976,10460293,559904,274958,0.32934544870888843,89109,43759,30863127,10475545
Spain,2021-05-11,42339062,42339062,140434,https://www.sanidad.gob.es/profesionales/saludPublica/ccayes/alertasActual/nCov/pruebasRealizadas.htm,30836976,10460293,0,0,0.32934544870888843,94183,46251,30957310,10521796
Spain,2021-05-12,42470936,42470936,131874,https://www.sanidad.gob.es/profesionales/saludPublica/ccayes/alertasActual/nCov/pruebasRealizadas.htm,30836976,10460293,0,0,0.32934544870888843,88442,43432,31045752,10565228
Spain,2021-05-13,42593704,42593704,122768,https://www.sanidad.gob.es/profesionales/saludPublica/ccayes/alertasActual/nCov/pruebasRealizadas.htm,30836976,10460293,0,0,0.32934544870888843,82335,40433,31128087,10605661
Spain,2021-05-14,42725320,42725320,131616,https://www.sanidad.gob.es/profesionales/saludPublica/ccayes/alertasActual/nCov/pruebasRealizadas.htm,30836976,10460293,0,0,0.32934544870888843,88269,43347,31216356,10649008
Spain,2021-05-15,42806226,42806226,80906,https://www.sanidad.gob.es/profesionales/saludPublica/ccayes/alertasActual/nCov/pruebasRealizadas.htm,30836976,10460293,0,0,0.32934544870888843,54260,26646,31270616,10675654
Spain,2021-05-16,42861909,42861909,55683,https://www.sanidad.gob.es/profesionales/saludPublica/ccayes/alertasActual/nCov/pruebasRealizadas.htm,30836976,10460293,0,0,0.32934544870888843,37344,18339,31307960,10693993
Spain,2021-05-17,42990258,42990258,128349,https://www.sanidad.gob.es/profesionales/saludPublica/ccayes/alertasActual/nCov/pruebasRealizadas.htm,31361349,10728321,524373,268028,0.3382479325493027,84935,43414,31392895,10737407
Spain,2021-05-18,43127551,43127551,137293,https://www.sanidad.gob.es/profesionales/saludPublica/ccayes/alertasActual/nCov/pruebasRealizadas.htm,31361349,10728321,0,0,0.3382479325493027,90854,46439,31483749,10783846
Spain,2021-05-19,43252892,43252892,125341,https://www.sanidad.gob.es/profesionales/saludPublica/ccayes/alertasActual/nCov/pruebasRealizadas.htm,31361349,10728321,0,0,0.3382479325493027,82945,42396,31566694,10826242
Spain,2021-05-20,43368130,43368130,115238,https://www.sanidad.gob.es/profesionales/saludPublica/ccayes/alertasActual/nCov/pruebasRealizadas.htm,31361349,10728321,0,0,0.3382479325493027,76259,38979,31642953,10865221
Spain,2021-05-21,43490529,43490529,122399,https://www.sanidad.gob.es/profesionales/saludPublica/ccayes/alertasActual/nCov/pruebasRealizadas.htm,31361349,10728321,0,0,0.3382479325493027,80998,41401,31723951,10906622
Spain,2021-05-22,43563247,43563247,72718,https://www.sanidad.gob.es/profesionales/saludPublica/ccayes/alertasActual/nCov/pruebasRealizadas.htm,31361349,10728321,0,0,0.3382479325493027,48121,24597,31772072,10931219
Spain,2021-05-23,43616298,43616298,53051,https://www.sanidad.gob.es/profesionales/saludPublica/ccayes/alertasActual/nCov/pruebasRealizadas.htm,31361349,10728321,0,0,0.3382479325493027,35107,17944,31807179,10949163
Spain,2021-05-24,43730128,43730128,113830,https://www.sanidad.gob.es/profesionales/saludPublica/ccayes/alertasActual/nCov/pruebasRealizadas.htm,31853049,10993611,491700,265290,0.35045377085562557,73938,39892,31881117,10989055
Spain,2021-05-25,43861751,43861751,131623,https://www.sanidad.gob.es/profesionales/saludPublica/ccayes/alertasActual/nCov/pruebasRealizadas.htm,31853049,10993611,0,0,0.35045377085562557,85495,46128,31966612,11035183
Spain,2021-05-26,43982763,43982763,121012,https://www.sanidad.gob.es/profesionales/saludPublica/ccayes/alertasActual/nCov/pruebasRealizadas.htm,31853049,10993611,0,0,0.35045377085562557,78603,42409,32045215,11077592
Spain,2021-05-27,44096666,44096666,113903,https://www.sanidad.gob.es/profesionales/saludPublica/ccayes/alertasActual/nCov/pruebasRealizadas.htm,31853049,10993611,0,0,0.35045377085562557,73985,39918,32119200,11117510
Spain,2021-05-28,44216244,44216244,119578,https://www.sanidad.gob.es/profesionales/saludPublica/ccayes/alertasActual/nCov/pruebasRealizadas.htm,31853049,10993611,0,0,0.35045377085562557,77671,41907,32196871,11159417
Spain,2021-05-29,44289745,44289745,73501,https://www.sanidad.gob.es/profesionales/saludPublica/ccayes/alertasActual/nCov/pruebasRealizadas.htm,31853049,10993611,0,0,0.35045377085562557,47742,25759,32244613,11185176
Spain,2021-05-30,44339958,44339958,50213,https://www.sanidad.gob.es/profesionales/saludPublica/ccayes/alertasActual/nCov/pruebasRealizadas.htm,31853049,10993611,0,0,0.35045377085562557,32616,17597,32277229,11202773
Spain,2021-05-31,44462749,44462749,122791,https://www.sanidad.gob.es/profesionales/saludPublica/ccayes/alertasActual/nCov/pruebasRealizadas.htm,32307229,11250638,454180,257027,0.36139548682732314,78415,44376,32355644,11247149
Spain,2021-06-01,44587680,44587680,124931,https://www.sanidad.gob.es/profesionales/saludPublica/ccayes/alertasActual/nCov/pruebasRealizadas.htm,32307229,11250638,0,0,0.36139548682732314,79782,45149,32435426,11292298
Spain,2021-06-02,44705597,44705597,117917,https://www.sanidad.gob.es/profesionales/saludPublica/ccayes/alertasActual/nCov/pruebasRealizadas.htm,32307229,11250638,0,0,0.36139548682732314,75302,42615,32510728,11334913
Spain,2021-06-03,44810226,44810226,104629,https://www.sanidad.gob.es/profesionales/saludPublica/ccayes/alertasActual/nCov/pruebasRealizadas.htm,32307229,11250638,0,0,0.36139548682732314,66817,37812,32577545,11372725
Spain,2021-06-04,44926047,44926047,115821,https://www.sanidad.gob.es/profesionales/saludPublica/ccayes/alertasActual/nCov/pruebasRealizadas.htm,32307229,11250638,0,0,0.36139548682732314,73964,41857,32651509,11414582
Spain,2021-06-05,44998260,44998260,72213,https://www.sanidad.gob.es/profesionales/saludPublica/ccayes/alertasActual/nCov/pruebasRealizadas.htm,32307229,11250638,0,0,0.36139548682732314,46116,26097,32697625,11440679
Spain,2021-06-06,45047052,45047052,48792,https://www.sanidad.gob.es/profesionales/saludPublica/ccayes/alertasActual/nCov/pruebasRealizadas.htm,32307229,11250638,0,0,0.36139548682732314,31159,17633,32728784,11458312
Spain,2021-06-07,45162522,45162522,115470,https://www.sanidad.gob.es/profesionales/saludPublica/ccayes/alertasActual/nCov/pruebasRealizadas.htm,32784136,11510406,476907,259768,0.3526222554043506,74753,40717,32803537,11499029
Spain,2021-06-08,45279875,45279875,117353,https://www.sanidad.gob.es/profesionales/saludPublica/ccayes/alertasActual/nCov/pruebasRealizadas.htm,32784136,11510406,0,0,0.3526222554043506,75972,41381,32879509,11540410
Spain,2021-06-09,45387001,45387001,107126,https://www.sanidad.gob.es/profesionales/saludPublica/ccayes/alertasActual/nCov/pruebasRealizadas.htm,32784136,11510406,0,0,0.3526222554043506,69351,37775,32948860,11578185
Spain,2021-06-10,45488053,45488053,101052,https://www.sanidad.gob.es/profesionales/saludPublica/ccayes/alertasActual/nCov/pruebasRealizadas.htm,32784136,11510406,0,0,0.3526222554043506,65419,35633,33014279,11613818
Spain,2021-06-11,45593843,45593843,105790,https://www.sanidad.gob.es/profesionales/saludPublica/ccayes/alertasActual/nCov/pruebasRealizadas.htm,32784136,11510406,0,0,0.3526222554043506,68486,37304,33082765,11651122
Spain,2021-06-12,45661481,45661481,67638,https://www.sanidad.gob.es/profesionales/saludPublica/ccayes/alertasActual/nCov/pruebasRealizadas.htm,32784136,11510406,0,0,0.3526222554043506,43787,23851,33126552,11674973
Spain,2021-06-13,45708904,45708904,47423,https://www.sanidad.gob.es/profesionales/saludPublica/ccayes/alertasActual/nCov/pruebasRealizadas.htm,32784136,11510406,0,0,0.3526222554043506,30701,16722,33157253,11691695
Spain,2021-06-14,45821051,45821051,112147,https://www.sanidad.gob.es/profesionales/saludPublica/ccayes/alertasActual/nCov/pruebasRealizadas.htm,33221873,11744339,437737,233933,0.3482856164485536,73088,39059,33230341,11730754
Spain,2021-06-15,45937045,45937045,115994,https://www.sanidad.gob.es/profesionales/saludPublica/ccayes/alertasActual/nCov/pruebasRealizadas.htm,33221873,11744339,0,0,0.3482856164485536,75595,40399,33305936,11771153
Spain,2021-06-16,46040828,46040828,103783,https://www.sanidad.gob.es/profesionales/saludPublica/ccayes/alertasActual/nCov/pruebasRealizadas.htm,33221873,11744339,0,0,0.3482856164485536,67637,36146,33373573,11807299
Spain,2021-06-17,46135696,46135696,94868,https://www.sanidad.gob.es/profesionales/saludPublica/ccayes/alertasActual/nCov/pruebasRealizadas.htm,33221873,11744339,0,0,0.3482856164485536,61827,33041,33435400,11840340
Spain,2021-06-18,46237253,46237253,101557,https://www.sanidad.gob.es/profesionales/saludPublica/ccayes/alertasActual/nCov/pruebasRealizadas.htm,33221873,11744339,0,0,0.3482856164485536,66186,35371,33501586,11875711
Spain,2021-06-19,46303638,46303638,66385,https://www.sanidad.gob.es/profesionales/saludPublica/ccayes/alertasActual/nCov/pruebasRealizadas.htm,33221873,11744339,0,0,0.3482856164485536,43264,23121,33544850,11898832
Spain,2021-06-20,46349339,46349339,45701,https://www.sanidad.gob.es/profesionales/saludPublica/ccayes/alertasActual/nCov/pruebasRealizadas.htm,33221873,11744339,0,0,0.3482856164485536,29784,15917,33574634,11914749
Spain,2021-06-21,46458021,46458021,108682,https://www.sanidad.gob.es/profesionales/saludPublica/ccayes/alertasActual/nCov/pruebasRealizadas.htm,33221873,11744339,0,0,0.3482856164485536,70830,37852,33645464,11952601
Spain,2021-06-22,46565735,46565735,107714,https://www.sanidad.gob.es/profesionales/saludPublica/ccayes/alertasActual/nCov/pruebasRealizadas.htm,33221873,11744339,0,0,0.3482856164485536,70199,37515,33715663,11990116
Spain,2021-06-23,46670120,46670120,104385,https://www.sanidad.gob.es/profesionales/saludPublica/ccayes/alertasActual/nCov/pruebasRealizadas.htm,33221873,11744339,0,0,0.3482856164485536,68029,36356,33783692,12026472
Spain,2021-06-24,46750964,46750964,80844,https://www.sanidad.gob.es/profesionales/saludPublica/ccayes/alertasActual/nCov/pruebasRealizadas.htm,33221873,11744339,0,0,0.3482856164485536,52687,28157,33836379,12054629
Spain,2021-06-25,46861349,46861349,110385,https://www.sanidad.gob.es/profesionales/saludPublica/ccayes/alertasActual/nCov/pruebasRealizadas.htm,33221873,11744339,0,0,0.3482856164485536,71939,38446,33908318,12093075
Spain,2021-06-26,46935626,46935626,74277,https://www.sanidad.gob.es/profesionales/saludPublica/ccayes/alertasActual/nCov/pruebasRealizadas.htm,33221873,11744339,0,0,0.3482856164485536,48407,25870,33956725,12118945
Spain,2021-06-27,46987681,46987681,52055,https://www.sanidad.gob.es/profesionales/saludPublica/ccayes/alertasActual/nCov/pruebasRealizadas.htm,33221873,11744339,0,0,0.3482856164485536,33925,18130,33990650,12137075
Spain,2021-06-28,47111481,47111481,123800,https://www.sanidad.gob.es/profesionales/saludPublica/ccayes/alertasActual/nCov/pruebasRealizadas.htm,34044503,12212687,822630,468348,0.36278542314431383,78887,44913,34069537,12181988
Spain,2021-06-29,47247580,47247580,136099,https://www.sanidad.gob.es/profesionales/saludPublica/ccayes/alertasActual/nCov/pruebasRealizadas.htm,34044503,12212687,0,0,0.36278542314431383,86724,49375,34156261,12231363
Spain,2021-06-30,47387837,47387837,140257,https://www.sanidad.gob.es/profesionales/saludPublica/ccayes/alertasActual/nCov/pruebasRealizadas.htm,34044503,12212687,0,0,0.36278542314431383,89374,50883,34245635,12282246
Spain,2021-07-01,47527002,47527002,139165,https://www.sanidad.gob.es/profesionales/saludPublica/ccayes/alertasActual/nCov/pruebasRealizadas.htm,34044503,12212687,0,0,0.36278542314431383,88678,50487,34334313,12332733
Spain,2021-07-02,47681683,47681683,154681,https://www.sanidad.gob.es/profesionales/saludPublica/ccayes/alertasActual/nCov/pruebasRealizadas.htm,34044503,12212687,0,0,0.36278542314431383,98565,56116,34432878,12388849
Spain,2021-07-03,47787236,47787236,105553,https://www.sanidad.gob.es/profesionales/saludPublica/ccayes/alertasActual/nCov/pruebasRealizadas.htm,34044503,12212687,0,0,0.36278542314431383,67260,38293,34500138,12427142
Spain,2021-07-04,47858510,47858510,71274,https://www.sanidad.gob.es/profesionales/saludPublica/ccayes/alertasActual/nCov/pruebasRealizadas.htm,34044503,12212687,0,0,0.36278542314431383,45417,25857,34545555,12452999
Spain,2021-07-05,48011751,48011751,153241,https://www.sanidad.gob.es/profesionales/saludPublica/ccayes/alertasActual/nCov/pruebasRealizadas.htm,34520531,12520531,476028,307844,0.3927222811887655,93060,60181,34638615,12513180
Spain,2021-07-06,48183015,48183015,171264,https://www.sanidad.gob.es/profesionales/saludPublica/ccayes/alertasActual/nCov/pruebasRealizadas.htm,34520531,12520531,0,0,0.3927222811887655,104005,67259,34742620,12580439
Spain,2021-07-07,48358690,48358690,175675,https://www.sanidad.gob.es/profesionales/saludPublica/ccayes/alertasActual/nCov/pruebasRealizadas.htm,34520531,12520531,0,0,0.3927222811887655,106684,68991,34849304,12649430
Spain,2021-07-08,48535057,48535057,176367,https://www.sanidad.gob.es/profesionales/saludPublica/ccayes/alertasActual/nCov/pruebasRealizadas.htm,34520531,12520531,0,0,0.3927222811887655,107104,69263,34956408,12718693
Spain,2021-07-09,48733092,48733092,198035,https://www.sanidad.gob.es/profesionales/saludPublica/ccayes/alertasActual/nCov/pruebasRealizadas.htm,34520531,12520531,0,0,0.3927222811887655,120262,77773,35076670,12796466
Spain,2021-07-10,48858041,48858041,124949,https://www.sanidad.gob.es/profesionales/saludPublica/ccayes/alertasActual/nCov/pruebasRealizadas.htm,34520531,12520531,0,0,0.3927222811887655,75879,49070,35152549,12845536
Spain,2021-07-11,48949862,48949862,91821,https://www.sanidad.gob.es/profesionales/saludPublica/ccayes/alertasActual/nCov/pruebasRealizadas.htm,34520531,12520531,0,0,0.3927222811887655,55761,36060,35208310,12881596
Spain,2021-07-12,49133769,49133769,183907,https://www.sanidad.gob.es/profesionales/saludPublica/ccayes/alertasActual/nCov/pruebasRealizadas.htm,35140294,12888819,619763,368288,0.3727418928779992,115357,68550,35323667,12950146
Spain,2021-07-13,49340655,49340655,206886,https://www.sanidad.gob.es/profesionales/saludPublica/ccayes/alertasActual/nCov/pruebasRealizadas.htm,35140294,12888819,0,0,0.3727418928779992,129771,77115,35453438,13027261
Spain,2021-07-14,49551208,49551208,210553,https://www.sanidad.gob.es/profesionales/saludPublica/ccayes/alertasActual/nCov/pruebasRealizadas.htm,35140294,12888819,0,0,0.3727418928779992,132071,78482,35585509,13105743
Spain,2021-07-15,49764909,49764909,213701,https://www.sanidad.gob.es/profesionales/saludPublica/ccayes/alertasActual/nCov/pruebasRealizadas.htm,35140294,12888819,0,0,0.3727418928779992,134046,79655,35719555,13185398
Spain,2021-07-16,49982155,49982155,217246,https://www.sanidad.gob.es/profesionales/saludPublica/ccayes/alertasActual/nCov/pruebasRealizadas.htm,35140294,12888819,0,0,0.3727418928779992,136269,80977,35855824,13266375
Spain,2021-07-17,50118103,50118103,135948,https://www.sanidad.gob.es/profesionales/saludPublica/ccayes/alertasActual/nCov/pruebasRealizadas.htm,35140294,12888819,0,0,0.3727418928779992,85274,50674,35941098,13317049
Spain,2021-07-18,50210465,50210465,92362,https://www.sanidad.gob.es/profesionales/saludPublica/ccayes/alertasActual/nCov/pruebasRealizadas.htm,35140294,12888819,0,0,0.3727418928779992,57935,34427,35999033,13351476
Spain,2021-07-19,50413718,50413718,203253,https://www.sanidad.gob.es/profesionales/saludPublica/ccayes/alertasActual/nCov/pruebasRealizadas.htm,35844382,13348985,704088,460166,0.3952453674198242,122918,80335,36121951,13431811
Spain,2021-07-20,50633741,50633741,220023,https://www.sanidad.gob.es/profesionales/saludPublica/ccayes/alertasActual/nCov/pruebasRealizadas.htm,35844382,13348985,0,0,0.3952453674198242,133060,86963,36255011,13518774
Spain,2021-07-21,50852021,50852021,218280,https://www.sanidad.gob.es/profesionales/saludPublica/ccayes/alertasActual/nCov/pruebasRealizadas.htm,35844382,13348985,0,0,0.3952453674198242,132006,86274,36387017,13605048
Spain,2021-07-22,51067845,51067845,215824,https://www.sanidad.gob.es/profesionales/saludPublica/ccayes/alertasActual/nCov/pruebasRealizadas.htm,35844382,13348985,0,0,0.3952453674198242,130521,85303,36517538,13690351
Spain,2021-07-23,51290950,51290950,223105,https://www.sanidad.gob.es/profesionales/saludPublica/ccayes/alertasActual/nCov/pruebasRealizadas.htm,35844382,13348985,0,0,0.3952453674198242,134924,88181,36652462,13778532
Spain,2021-07-24,51432857,51432857,141907,https://www.sanidad.gob.es/profesionales/saludPublica/ccayes/alertasActual/nCov/pruebasRealizadas.htm,35844382,13348985,0,0,0.3952453674198242,85819,56088,36738281,13834620
Spain,2021-07-25,51522608,51522608,89751,https://www.sanidad.gob.es/profesionales/saludPublica/ccayes/alertasActual/nCov/pruebasRealizadas.htm,35844382,13348985,0,0,0.3952453674198242,54277,35474,36792558,13870094
Spain,2021-07-26,51716352,51716352,193744,https://www.sanidad.gob.es/profesionales/saludPublica/ccayes/alertasActual/nCov/pruebasRealizadas.htm,36635856,13838367,791474,489382,0.38207417539520444,119719,74025,36912277,13944119
Spain,2021-07-27,51932527,51932527,216175,https://www.sanidad.gob.es/profesionales/saludPublica/ccayes/alertasActual/nCov/pruebasRealizadas.htm,36635856,13838367,0,0,0.38207417539520444,133580,82595,37045857,14026714
Spain,2021-07-28,52146706,52146706,214179,https://www.sanidad.gob.es/profesionales/saludPublica/ccayes/alertasActual/nCov/pruebasRealizadas.htm,36635856,13838367,0,0,0.38207417539520444,132347,81832,37178204,14108546
Spain,2021-07-29,52357397,52357397,210691,https://www.sanidad.gob.es/profesionales/saludPublica/ccayes/alertasActual/nCov/pruebasRealizadas.htm,36635856,13838367,0,0,0.38207417539520444,130191,80500,37308395,14189046
Spain,2021-07-30,52578846,52578846,221449,https://www.sanidad.gob.es/profesionales/saludPublica/ccayes/alertasActual/nCov/pruebasRealizadas.htm,36635856,13838367,0,0,0.38207417539520444,136839,84610,37445234,14273656
Spain,2021-07-31,52716040,52716040,137194,https://www.sanidad.gob.es/profesionales/saludPublica/ccayes/alertasActual/nCov/pruebasRealizadas.htm,36635856,13838367,0,0,0.38207417539520444,84776,52418,37530010,14326074
Spain,2021-08-01,52800857,52800857,84817,https://www.sanidad.gob.es/profesionales/saludPublica/ccayes/alertasActual/nCov/pruebasRealizadas.htm,36635856,13838367,0,0,0.38207417539520444,52411,32406,37582421,14358480
Spain,2021-08-02,52979358,52979358,178501,https://www.sanidad.gob.es/profesionales/saludPublica/ccayes/alertasActual/nCov/pruebasRealizadas.htm,37436536,14303185,800680,464818,0.3673004619525278,112938,65563,37695359,14424043
Spain,2021-08-03,53172600,53172600,193242,https://www.sanidad.gob.es/profesionales/saludPublica/ccayes/alertasActual/nCov/pruebasRealizadas.htm,37436536,14303185,0,0,0.3673004619525278,122264,70978,37817623,14495021
Spain,2021-08-04,53361938,53361938,189338,https://www.sanidad.gob.es/profesionales/saludPublica/ccayes/alertasActual/nCov/pruebasRealizadas.htm,37436536,14303185,0,0,0.3673004619525278,119794,69544,37937417,14564565
Spain,2021-08-05,53538078,53538078,176140,https://www.sanidad.gob.es/profesionales/saludPublica/ccayes/alertasActual/nCov/pruebasRealizadas.htm,37436536,14303185,0,0,0.3673004619525278,111444,64696,38048861,14629261
Spain,2021-08-06,53716418,53716418,178340,https://www.sanidad.gob.es/profesionales/saludPublica/ccayes/alertasActual/nCov/pruebasRealizadas.htm,37436536,14303185,0,0,0.3673004619525278,112836,65504,38161697,14694765
Spain,2021-08-07,53826833,53826833,110415,https://www.sanidad.gob.es/profesionales/saludPublica/ccayes/alertasActual/nCov/pruebasRealizadas.htm,37436536,14303185,0,0,0.3673004619525278,69860,40555,38231557,14735320
Spain,2021-08-08,53895582,53895582,68749,https://www.sanidad.gob.es/profesionales/saludPublica/ccayes/alertasActual/nCov/pruebasRealizadas.htm,37436536,14303185,0,0,0.3673004619525278,43497,25252,38275054,14760572
Spain,2021-08-09,54049593,54049593,154011,https://www.sanidad.gob.es/profesionales/saludPublica/ccayes/alertasActual/nCov/pruebasRealizadas.htm,38172268,14715248,735732,412063,0.35900400332812044,98720,55291,38373774,14815863
Spain,2021-08-10,54220397,54220397,170804,https://www.sanidad.gob.es/profesionales/saludPublica/ccayes/alertasActual/nCov/pruebasRealizadas.htm,38172268,14715248,0,0,0.35900400332812044,109485,61319,38483259,14877182
Spain,2021-08-11,54381992,54381992,161595,https://www.sanidad.gob.es/profesionales/saludPublica/ccayes/alertasActual/nCov/pruebasRealizadas.htm,38172268,14715248,0,0,0.35900400332812044,103582,58013,38586841,14935195
Spain,2021-08-12,54540517,54540517,158525,https://www.sanidad.gob.es/profesionales/saludPublica/ccayes/alertasActual/nCov/pruebasRealizadas.htm,38172268,14715248,0,0,0.35900400332812044,101614,56911,38688455,14992106
Spain,2021-08-13,54694898,54694898,154381,https://www.sanidad.gob.es/profesionales/saludPublica/ccayes/alertasActual/nCov/pruebasRealizadas.htm,38172268,14715248,0,0,0.35900400332812044,98958,55423,38787413,15047529
Spain,2021-08-14,54791457,54791457,96559,https://www.sanidad.gob.es/profesionales/saludPublica/ccayes/alertasActual/nCov/pruebasRealizadas.htm,38172268,14715248,0,0,0.35900400332812044,61894,34665,38849307,15082194
Spain,2021-08-15,54856152,54856152,64695,https://www.sanidad.gob.es/profesionales/saludPublica/ccayes/alertasActual/nCov/pruebasRealizadas.htm,38172268,14715248,0,0,0.35900400332812044,41469,23226,38890776,15105420
Spain,2021-08-16,54979828,54979828,123676,https://www.sanidad.gob.es/profesionales/saludPublica/ccayes/alertasActual/nCov/pruebasRealizadas.htm,38828914,15064085,656646,348837,0.3469347567288557,80768,42908,38971544,15148328
Spain,2021-08-17,55128357,55128357,148529,https://www.sanidad.gob.es/profesionales/saludPublica/ccayes/alertasActual/nCov/pruebasRealizadas.htm,38828914,15064085,0,0,0.3469347567288557,96999,51530,39068543,15199858
Spain,2021-08-18,55279359,55279359,151002,https://www.sanidad.gob.es/profesionales/saludPublica/ccayes/alertasActual/nCov/pruebasRealizadas.htm,38828914,15064085,0,0,0.3469347567288557,98614,52388,39167157,15252246
Spain,2021-08-19,55422286,55422286,142927,https://www.sanidad.gob.es/profesionales/saludPublica/ccayes/alertasActual/nCov/pruebasRealizadas.htm,38828914,15064085,0,0,0.3469347567288557,93341,49586,39260498,15301832
Spain,2021-08-20,55562488,55562488,140202,https://www.sanidad.gob.es/profesionales/saludPublica/ccayes/alertasActual/nCov/pruebasRealizadas.htm,38828914,15064085,0,0,0.3469347567288557,91561,48641,39352059,15350473
Spain,2021-08-21,55647891,55647891,85403,https://www.sanidad.gob.es/profesionales/saludPublica/ccayes/alertasActual/nCov/pruebasRealizadas.htm,38828914,15064085,0,0,0.3469347567288557,55774,29629,39407833,15380102
Spain,2021-08-22,55703840,55703840,55949,https://www.sanidad.gob.es/profesionales/saludPublica/ccayes/alertasActual/nCov/pruebasRealizadas.htm,38828914,15064085,0,0,0.3469347567288557,36538,19411,39444371,15399513
Spain,2021-08-23,55839343,55839343,135503,https://www.sanidad.gob.es/profesionales/saludPublica/ccayes/alertasActual/nCov/pruebasRealizadas.htm,39358008,15361102,529094,297017,0.3595364303344224,86785,48718,39531156,15448231
Spain,2021-08-24,55977070,55977070,137727,https://www.sanidad.gob.es/profesionales/saludPublica/ccayes/alertasActual/nCov/pruebasRealizadas.htm,39358008,15361102,0,0,0.3595364303344224,88209,49518,39619365,15497749
Spain,2021-08-25,56114971,56114971,137901,https://www.sanidad.gob.es/profesionales/saludPublica/ccayes/alertasActual/nCov/pruebasRealizadas.htm,39358008,15361102,0,0,0.3595364303344224,88321,49580,39707686,15547329
Spain,2021-08-26,56240831,56240831,125860,https://www.sanidad.gob.es/profesionales/saludPublica/ccayes/alertasActual/nCov/pruebasRealizadas.htm,39358008,15361102,0,0,0.3595364303344224,80609,45251,39788295,15592580
Spain,2021-08-27,56366453,56366453,125622,https://www.sanidad.gob.es/profesionales/saludPublica/ccayes/alertasActual/nCov/pruebasRealizadas.htm,39358008,15361102,0,0,0.3595364303344224,80456,45166,39868751,15637746
Spain,2021-08-28,56443085,56443085,76632,https://www.sanidad.gob.es/profesionales/saludPublica/ccayes/alertasActual/nCov/pruebasRealizadas.htm,39358008,15361102,0,0,0.3595364303344224,49080,27552,39917831,15665298
Spain,2021-08-29,56497329,56497329,54244,https://www.sanidad.gob.es/profesionales/saludPublica/ccayes/alertasActual/nCov/pruebasRealizadas.htm,39358008,15361102,0,0,0.3595364303344224,34741,19503,39952572,15684801
Spain,2021-08-30,56627271,56627271,129942,https://www.sanidad.gob.es/profesionales/saludPublica/ccayes/alertasActual/nCov/pruebasRealizadas.htm,39840576,15637634,482568,276532,0.36428928994862336,82606,47336,40035178,15732137
Spain,2021-08-31,56763605,56763605,136334,https://www.sanidad.gob.es/profesionales/saludPublica/ccayes/alertasActual/nCov/pruebasRealizadas.htm,39840576,15637634,0,0,0.36428928994862336,86669,49665,40121847,15781802
Spain,2021-09-01,56894663,56894663,131058,https://www.sanidad.gob.es/profesionales/saludPublica/ccayes/alertasActual/nCov/pruebasRealizadas.htm,39840576,15637634,0,0,0.36428928994862336,83315,47743,40205162,15829545
Spain,2021-09-02,57009382,57009382,114719,https://www.sanidad.gob.es/profesionales/saludPublica/ccayes/alertasActual/nCov/pruebasRealizadas.htm,39840576,15637634,0,0,0.36428928994862336,72928,41791,40278090,15871336
Spain,2021-09-03,57120631,57120631,111249,https://www.sanidad.gob.es/profesionales/saludPublica/ccayes/alertasActual/nCov/pruebasRealizadas.htm,39840576,15637634,0,0,0.36428928994862336,70722,40527,40348812,15911863
Spain,2021-09-04,57190068,57190068,69437,https://www.sanidad.gob.es/profesionales/saludPublica/ccayes/alertasActual/nCov/pruebasRealizadas.htm,39840576,15637634,0,0,0.36428928994862336,44142,25295,40392954,15937158
Spain,2021-09-05,57237257,57237257,47189,https://www.sanidad.gob.es/profesionales/saludPublica/ccayes/alertasActual/nCov/pruebasRealizadas.htm,39840576,15637634,0,0,0.36428928994862336,29999,17190,40422953,15954348
Spain,2021-09-06,57347545,57347545,110288,https://www.sanidad.gob.es/profesionales/saludPublica/ccayes/alertasActual/nCov/pruebasRealizadas.htm,40347879,15906952,507303,269318,0.34678176356292195,72042,38246,40494995,15992594
Spain,2021-09-07,57462992,57462992,115447,https://www.sanidad.gob.es/profesionales/saludPublica/ccayes/alertasActual/nCov/pruebasRealizadas.htm,40347879,15906952,0,0,0.34678176356292195,75412,40035,40570407,16032629
Spain,2021-09-08,57567351,57567351,104359,https://www.sanidad.gob.es/profesionales/saludPublica/ccayes/alertasActual/nCov/pruebasRealizadas.htm,40347879,15906952,0,0,0.34678176356292195,68169,36190,40638576,16068819
Spain,2021-09-09,57668051,57668051,100700,https://www.sanidad.gob.es/profesionales/saludPublica/ccayes/alertasActual/nCov/pruebasRealizadas.htm,40347879,15906952,0,0,0.34678176356292195,65779,34921,40704355,16103740
Spain,2021-09-10,57767989,57767989,99938,https://www.sanidad.gob.es/profesionales/saludPublica/ccayes/alertasActual/nCov/pruebasRealizadas.htm,40347879,15906952,0,0,0.34678176356292195,65281,34657,40769636,16138397
Spain,2021-09-11,57830708,57830708,62719,https://www.sanidad.gob.es/profesionales/saludPublica/ccayes/alertasActual/nCov/pruebasRealizadas.htm,40347879,15906952,0,0,0.34678176356292195,40969,21750,40810605,16160147
Spain,2021-09-12,57875971,57875971,45263,https://www.sanidad.gob.es/profesionales/saludPublica/ccayes/alertasActual/nCov/pruebasRealizadas.htm,40347879,15906952,0,0,0.34678176356292195,29567,15696,40840172,16175843
Spain,2021-09-13,57986209,57986209,110238,https://www.sanidad.gob.es/profesionales/saludPublica/ccayes/alertasActual/nCov/pruebasRealizadas.htm,40772029,16117597,424150,210645,0.3318315361652187,73658,36580,40913830,16212423
Spain,2021-09-14,58099508,58099508,113299,https://www.sanidad.gob.es/profesionales/saludPublica/ccayes/alertasActual/nCov/pruebasRealizadas.htm,40772029,16117597,0,0,0.3318315361652187,75703,37596,40989533,16250019
Spain,2021-09-15,58210989,58210989,111481,https://www.sanidad.gob.es/profesionales/saludPublica/ccayes/alertasActual/nCov/pruebasRealizadas.htm,40772029,16117597,0,0,0.3318315361652187,74488,36993,41064021,16287012
Spain,2021-09-16,58309341,58309341,98352,https://www.sanidad.gob.es/profesionales/saludPublica/ccayes/alertasActual/nCov/pruebasRealizadas.htm,40772029,16117597,0,0,0.3318315361652187,65716,32636,41129737,16319648
Spain,2021-09-17,58413936,58413936,104595,https://www.sanidad.gob.es/profesionales/saludPublica/ccayes/alertasActual/nCov/pruebasRealizadas.htm,40772029,16117597,0,0,0.3318315361652187,69887,34708,41199624,16354356
Spain,2021-09-18,58474576,58474576,60640,https://www.sanidad.gob.es/profesionales/saludPublica/ccayes/alertasActual/nCov/pruebasRealizadas.htm,40772029,16117597,0,0,0.3318315361652187,40518,20122,41240142,16374478
Spain,2021-09-19,58520732,58520732,46156,https://www.sanidad.gob.es/profesionales/saludPublica/ccayes/alertasActual/nCov/pruebasRealizadas.htm,40772029,16117597,0,0,0.3318315361652187,30840,15316,41270982,16389794
Spain,2021-09-20,58636159,58636159,115427,https://www.sanidad.gob.es/profesionales/saludPublica/ccayes/alertasActual/nCov/pruebasRealizadas.htm,41220650,16329288,448621,211691,0.32059238662935097,78422,37005,41349404,16426799
Spain,2021-09-21,58754124,58754124,117965,https://www.sanidad.gob.es/profesionales/saludPublica/ccayes/alertasActual/nCov/pruebasRealizadas.htm,41220650,16329288,0,0,0.32059238662935097,80146,37819,41429550,16464618
Spain,2021-09-22,58868086,58868086,113962,https://www.sanidad.gob.es/profesionales/saludPublica/ccayes/alertasActual/nCov/pruebasRealizadas.htm,41220650,16329288,0,0,0.32059238662935097,77427,36535,41506977,16501153
Spain,2021-09-23,58971539,58971539,103453,https://www.sanidad.gob.es/profesionales/saludPublica/ccayes/alertasActual/nCov/pruebasRealizadas.htm,41220650,16329288,0,0,0.32059238662935097,70287,33166,41577264,16534319
Spain,2021-09-24,59072506,59072506,100967,https://www.sanidad.gob.es/profesionales/saludPublica/ccayes/alertasActual/nCov/pruebasRealizadas.htm,41220650,16329288,0,0,0.32059238662935097,68598,32369,41645862,16566688
Spain,2021-09-25,59135822,59135822,63316,https://www.sanidad.gob.es/profesionales/saludPublica/ccayes/alertasActual/nCov/pruebasRealizadas.htm,41220650,16329288,0,0,0.32059238662935097,43017,20299,41688879,16586987
Spain,2021-09-26,59184420,59184420,48598,https://www.sanidad.gob.es/profesionales/saludPublica/ccayes/alertasActual/nCov/pruebasRealizadas.htm,41220650,16329288,0,0,0.32059238662935097,33018,15580,41721897,16602567
Spain,2021-09-27,59306960,59306960,122540,https://www.sanidad.gob.es/profesionales/saludPublica/ccayes/alertasActual/nCov/pruebasRealizadas.htm,41702534,16678831,481884,349543,0.42041333755098165,71023,51517,41792920,16654084
Spain,2021-09-28,59430309,59430309,123349,https://www.sanidad.gob.es/profesionales/saludPublica/ccayes/alertasActual/nCov/pruebasRealizadas.htm,41702534,16678831,0,0,0.42041333755098165,71491,51858,41864411,16705942
Spain,2021-09-29,59548408,59548408,118099,https://www.sanidad.gob.es/profesionales/saludPublica/ccayes/alertasActual/nCov/pruebasRealizadas.htm,41702534,16678831,0,0,0.42041333755098165,68449,49650,41932860,16755592
Spain,2021-09-30,59650997,59650997,102589,https://www.sanidad.gob.es/profesionales/saludPublica/ccayes/alertasActual/nCov/pruebasRealizadas.htm,41702534,16678831,0,0,0.42041333755098165,59459,43130,41992319,16798722
Spain,2021-10-01,59751114,59751114,100117,https://www.sanidad.gob.es/profesionales/saludPublica/ccayes/alertasActual/nCov/pruebasRealizadas.htm,41702534,16678831,0,0,0.42041333755098165,58026,42091,42050345,16840813
Spain,2021-10-02,59811176,59811176,60062,https://www.sanidad.gob.es/profesionales/saludPublica/ccayes/alertasActual/nCov/pruebasRealizadas.htm,41702534,16678831,0,0,0.42041333755098165,34811,25251,42085156,16866064
Spain,2021-10-03,59855596,59855596,44420,https://www.sanidad.gob.es/profesionales/saludPublica/ccayes/alertasActual/nCov/pruebasRealizadas.htm,41702534,16678831,0,0,0.42041333755098165,25745,18675,42110901,16884739
Spain,2021-10-04,59966526,59966526,110930,https://www.sanidad.gob.es/profesionales/saludPublica/ccayes/alertasActual/nCov/pruebasRealizadas.htm,42247856,17066487,545322,387656,0.41550390255718783,64838,46092,42175739,16930831
Spain,2021-10-05,60076413,60076413,109887,https://www.sanidad.gob.es/profesionales/saludPublica/ccayes/alertasActual/nCov/pruebasRealizadas.htm,42247856,17066487,0,0,0.41550390255718783,64229,45658,42239968,16976489
Spain,2021-10-06,60182326,60182326,105913,https://www.sanidad.gob.es/profesionales/saludPublica/ccayes/alertasActual/nCov/pruebasRealizadas.htm,42247856,17066487,0,0,0.41550390255718783,61906,44007,42301874,17020496
Spain,2021-10-07,60271530,60271530,89204,https://www.sanidad.gob.es/profesionales/saludPublica/ccayes/alertasActual/nCov/pruebasRealizadas.htm,42247856,17066487,0,0,0.41550390255718783,52139,37065,42354013,17057561
Spain,2021-10-08,60353462,60353462,81932,https://www.sanidad.gob.es/profesionales/saludPublica/ccayes/alertasActual/nCov/pruebasRealizadas.htm,42247856,17066487,0,0,0.41550390255718783,47889,34043,42401902,17091604
Spain,2021-10-09,60398042,60398042,44580,https://www.sanidad.gob.es/profesionales/saludPublica/ccayes/alertasActual/nCov/pruebasRealizadas.htm,42247856,17066487,0,0,0.41550390255718783,26057,18523,42427959,17110127
Spain,2021-10-10,60430000,60430000,31958,https://www.sanidad.gob.es/profesionales/saludPublica/ccayes/alertasActual/nCov/pruebasRealizadas.htm,42247856,17066487,0,0,0.41550390255718783,18679,13279,42446638,17123406
Spain,2021-10-11,60523078,60523078,93078,https://www.sanidad.gob.es/profesionales/saludPublica/ccayes/alertasActual/nCov/pruebasRealizadas.htm,42676882,17325690,429026,259203,0.3766231879214622,58023,35055,42504661,17158461
Spain,2021-10-12,60572494,60572494,49416,https://www.sanidad.gob.es/profesionales/saludPublica/ccayes/alertasActual/nCov/pruebasRealizadas.htm,42676882,17325690,0,0,0.3766231879214622,30805,18611,42535466,17177072
Spain,2021-10-13,60682665,60682665,110171,https://www.sanidad.gob.es/profesionales/saludPublica/ccayes/alertasActual/nCov/pruebasRealizadas.htm,42676882,17325690,0,0,0.3766231879214622,68678,41493,42604144,17218565
Spain,2021-10-14,60782151,60782151,99486,https://www.sanidad.gob.es/profesionales/saludPublica/ccayes/alertasActual/nCov/pruebasRealizadas.htm,42676882,17325690,0,0,0.3766231879214622,62017,37469,42666161,17256034
Spain,2021-10-15,60876905,60876905,94754,https://www.sanidad.gob.es/profesionales/saludPublica/ccayes/alertasActual/nCov/pruebasRealizadas.htm,42676882,17325690,0,0,0.3766231879214622,59067,35687,42725228,17291721
Spain,2021-10-16,60931022,60931022,54117,https://www.sanidad.gob.es/profesionales/saludPublica/ccayes/alertasActual/nCov/pruebasRealizadas.htm,42676882,17325690,0,0,0.3766231879214622,33735,20382,42758963,17312103
Spain,2021-10-17,60969682,60969682,38660,https://www.sanidad.gob.es/profesionales/saludPublica/ccayes/alertasActual/nCov/pruebasRealizadas.htm,42676882,17325690,0,0,0.3766231879214622,24100,14560,42783063,17326663
Spain,2021-10-18,61074479,61074479,104797,https://www.sanidad.gob.es/profesionales/saludPublica/ccayes/alertasActual/nCov/pruebasRealizadas.htm,42987382,17543260,310500,217570,0.4120097714318178,61620,43177,42844683,17369840
Spain,2021-10-19,61180372,61180372,105893,https://www.sanidad.gob.es/profesionales/saludPublica/ccayes/alertasActual/nCov/pruebasRealizadas.htm,42987382,17543260,0,0,0.4120097714318178,62264,43629,42906947,17413469
Spain,2021-10-20,61278797,61278797,98425,https://www.sanidad.gob.es/profesionales/saludPublica/ccayes/alertasActual/nCov/pruebasRealizadas.htm,42987382,17543260,0,0,0.4120097714318178,57873,40552,42964820,17454021
Spain,2021-10-21,61366536,61366536,87739,https://www.sanidad.gob.es/profesionales/saludPublica/ccayes/alertasActual/nCov/pruebasRealizadas.htm,42987382,17543260,0,0,0.4120097714318178,51590,36149,43016410,17490170
Spain,2021-10-22,61456210,61456210,89674,https://www.sanidad.gob.es/profesionales/saludPublica/ccayes/alertasActual/nCov/pruebasRealizadas.htm,42987382,17543260,0,0,0.4120097714318178,52727,36947,43069137,17527117
Spain,2021-10-23,61507756,61507756,51546,https://www.sanidad.gob.es/profesionales/saludPublica/ccayes/alertasActual/nCov/pruebasRealizadas.htm,42987382,17543260,0,0,0.4120097714318178,30309,21237,43099446,17548354
Spain,2021-10-24,61545741,61545741,37985,https://www.sanidad.gob.es/profesionales/saludPublica/ccayes/alertasActual/nCov/pruebasRealizadas.htm,42987382,17543260,0,0,0.4120097714318178,22335,15650,43121781,17564004
Spain,2021-10-25,61647540,61647540,101799,https://www.sanidad.gob.es/profesionales/saludPublica/ccayes/alertasActual/nCov/pruebasRealizadas.htm,43333416,17780437,346034,237177,0.4066744282943909,60400,41399,43182181,17605403
Spain,2021-10-26,61752428,61752428,104888,https://www.sanidad.gob.es/profesionales/saludPublica/ccayes/alertasActual/nCov/pruebasRealizadas.htm,43333416,17780437,0,0,0.4066744282943909,62233,42655,43244414,17648058
Spain,2021-10-27,61853518,61853518,101090,https://www.sanidad.gob.es/profesionales/saludPublica/ccayes/alertasActual/nCov/pruebasRealizadas.htm,43333416,17780437,0,0,0.4066744282943909,59979,41111,43304393,17689169
Spain,2021-10-28,61940587,61940587,87069,https://www.sanidad.gob.es/profesionales/saludPublica/ccayes/alertasActual/nCov/pruebasRealizadas.htm,43333416,17780437,0,0,0.4066744282943909,51660,35409,43356053,17724578
Spain,2021-10-29,62022675,62022675,82088,https://www.sanidad.gob.es/profesionales/saludPublica/ccayes/alertasActual/nCov/pruebasRealizadas.htm,43333416,17780437,0,0,0.4066744282943909,48705,33383,43404758,17757961
Spain,2021-10-30,62070982,62070982,48307,https://www.sanidad.gob.es/profesionales/saludPublica/ccayes/alertasActual/nCov/pruebasRealizadas.htm,43333416,17780437,0,0,0.4066744282943909,28662,19645,43433420,17777606
Spain,2021-10-31,62110272,62110272,39290,https://www.sanidad.gob.es/profesionales/saludPublica/ccayes/alertasActual/nCov/pruebasRealizadas.htm,43333416,17780437,0,0,0.4066744282943909,23312,15978,43456732,17793584
Spain,2021-11-01,62153069,62153069,42797,https://www.sanidad.gob.es/profesionales/saludPublica/ccayes/alertasActual/nCov/pruebasRealizadas.htm,43333416,17780437,0,0,0.4066744282943909,25393,17404,43482125,17810988
Spain,2021-11-02,62257969,62257969,104900,https://www.sanidad.gob.es/profesionales/saludPublica/ccayes/alertasActual/nCov/pruebasRealizadas.htm,43698032,18029142,364616,248705,0.40550543679410944,62362,42538,43544487,17853526
Spain,2021-11-03,62364965,62364965,106996,https://www.sanidad.gob.es/profesionales/saludPublica/ccayes/alertasActual/nCov/pruebasRealizadas.htm,43698032,18029142,0,0,0.40550543679410944,63609,43387,43608096,17896913
Spain,2021-11-04,62460170,62460170,95205,https://www.sanidad.gob.es/profesionales/saludPublica/ccayes/alertasActual/nCov/pruebasRealizadas.htm,43698032,18029142,0,0,0.40550543679410944,56599,38606,43664695,17935519
Spain,2021-11-05,62554510,62554510,94340,https://www.sanidad.gob.es/profesionales/saludPublica/ccayes/alertasActual/nCov/pruebasRealizadas.htm,43698032,18029142,0,0,0.40550543679410944,56085,38255,43720780,17973774
Spain,2021-11-06,62609896,62609896,55386,https://www.sanidad.gob.es/profesionales/saludPublica/ccayes/alertasActual/nCov/pruebasRealizadas.htm,43698032,18029142,0,0,0.40550543679410944,32927,22459,43753707,17996233
Spain,2021-11-07,62650196,62650196,40300,https://www.sanidad.gob.es/profesionales/saludPublica/ccayes/alertasActual/nCov/pruebasRealizadas.htm,43698032,18029142,0,0,0.40550543679410944,23958,16342,43777665,18012575
Spain,2021-11-08,62756390,62756390,106194,https://www.sanidad.gob.es/profesionales/saludPublica/ccayes/alertasActual/nCov/pruebasRealizadas.htm,43698032,18029142,0,0,0.40550543679410944,63132,43062,43840797,18055637
Spain,2021-11-09,62866257,62866257,109867,https://www.sanidad.gob.es/profesionales/saludPublica/ccayes/alertasActual/nCov/pruebasRealizadas.htm,43698032,18029142,0,0,0.40550543679410944,65315,44552,43906112,18100189
Spain,2021-11-10,62980611,62980611,114354,https://www.sanidad.gob.es/profesionales/saludPublica/ccayes/alertasActual/nCov/pruebasRealizadas.htm,44031458,18236332,333426,207190,0.38324799857939834,70528,43826,43976640,18144015
Spain,2021-11-11,63084545,63084545,103934,https://www.sanidad.gob.es/profesionales/saludPublica/ccayes/alertasActual/nCov/pruebasRealizadas.htm,44031458,18236332,0,0,0.38324799857939834,64102,39832,44040742,18183847
Spain,2021-11-12,63189415,63189415,104870,https://www.sanidad.gob.es/profesionales/saludPublica/ccayes/alertasActual/nCov/pruebasRealizadas.htm,44031458,18236332,0,0,0.38324799857939834,64679,40191,44105421,18224038
Spain,2021-11-13,63251862,63251862,62447,https://www.sanidad.gob.es/profesionales/saludPublica/ccayes/alertasActual/nCov/pruebasRealizadas.htm,44031458,18236332,0,0,0.38324799857939834,38514,23933,44143935,18247971
Spain,2021-11-14,63299000,63299000,47138,https://www.sanidad.gob.es/profesionales/saludPublica/ccayes/alertasActual/nCov/pruebasRealizadas.htm,44031458,18236332,0,0,0.38324799857939834,29072,18066,44173007,18266037
Spain,2021-11-15,63420271,63420271,121271,https://www.sanidad.gob.es/profesionales/saludPublica/ccayes/alertasActual/nCov/pruebasRealizadas.htm,44427888,18558969,396430,322637,0.4486883697902977,66858,54413,44239865,18320450
Spain,2021-11-16,63551874,63551874,131603,https://www.sanidad.gob.es/profesionales/saludPublica/ccayes/alertasActual/nCov/pruebasRealizadas.htm,44427888,18558969,0,0,0.4486883697902977,72554,59049,44312419,18379499
Spain,2021-11-17,63680218,63680218,128344,https://www.sanidad.gob.es/profesionales/saludPublica/ccayes/alertasActual/nCov/pruebasRealizadas.htm,44427888,18558969,0,0,0.4486883697902977,70758,57586,44383177,18437085
Spain,2021-11-18,63802707,63802707,122489,https://www.sanidad.gob.es/profesionales/saludPublica/ccayes/alertasActual/nCov/pruebasRealizadas.htm,44427888,18558969,0,0,0.4486883697902977,67530,54959,44450707,18492044
Spain,2021-11-19,63931203,63931203,128496,https://www.sanidad.gob.es/profesionales/saludPublica/ccayes/alertasActual/nCov/pruebasRealizadas.htm,44427888,18558969,0,0,0.4486883697902977,70841,57655,44521548,18549699
Spain,2021-11-20,64006181,64006181,74978,https://www.sanidad.gob.es/profesionales/saludPublica/ccayes/alertasActual/nCov/pruebasRealizadas.htm,44427888,18558969,0,0,0.4486883697902977,41336,33642,44562884,18583341
Spain,2021-11-21,64059992,64059992,53811,https://www.sanidad.gob.es/profesionales/saludPublica/ccayes/alertasActual/nCov/pruebasRealizadas.htm,44427888,18558969,0,0,0.4486883697902977,29667,24144,44592551,18607485
Spain,2021-11-22,64202012,64202012,142020,https://www.sanidad.gob.es/profesionales/saludPublica/ccayes/alertasActual/nCov/pruebasRealizadas.htm,44427888,18558969,0,0,0.4486883697902977,78297,63723,44670848,18671208
Spain,2021-11-23,64354204,64354204,152192,https://www.sanidad.gob.es/profesionales/saludPublica/ccayes/alertasActual/nCov/pruebasRealizadas.htm,44427888,18558969,0,0,0.4486883697902977,83905,68287,44754753,18739495
Spain,2021-11-24,64506929,64506929,152725,https://www.sanidad.gob.es/profesionales/saludPublica/ccayes/alertasActual/nCov/pruebasRealizadas.htm,44427888,18558969,0,0,0.4486883697902977,84199,68526,44838952,18808021
Spain,2021-11-25,64651211,64651211,144282,https://www.sanidad.gob.es/profesionales/saludPublica/ccayes/alertasActual/nCov/pruebasRealizadas.htm,44427888,18558969,0,0,0.4486883697902977,79544,64738,44918496,18872759
Spain,2021-11-26,64801134,64801134,149923,https://www.sanidad.gob.es/profesionales/saludPublica/ccayes/alertasActual/nCov/pruebasRealizadas.htm,44427888,18558969,0,0,0.4486883697902977,82654,67269,45001150,18940028
Spain,2021-11-27,64888605,64888605,87471,https://www.sanidad.gob.es/profesionales/saludPublica/ccayes/alertasActual/nCov/pruebasRealizadas.htm,44427888,18558969,0,0,0.4486883697902977,48224,39247,45049374,18979275
Spain,2021-11-28,64950962,64950962,62357,https://www.sanidad.gob.es/profesionales/saludPublica/ccayes/alertasActual/nCov/pruebasRealizadas.htm,44427888,18558969,0,0,0.4486883697902977,34378,27979,45083752,19007254
Spain,2021-11-29,65108676,65108676,157714,https://www.sanidad.gob.es/profesionales/saludPublica/ccayes/alertasActual/nCov/pruebasRealizadas.htm,44427888,18558969,0,0,0.4486883697902977,86950,70764,45170702,19078018
Spain,2021-11-30,65288782,65288782,180106,https://www.sanidad.gob.es/profesionales/saludPublica/ccayes/alertasActual/nCov/pruebasRealizadas.htm,44427888,18558969,0,0,0.4486883697902977,99295,80811,45269997,19158829
Spain,2021-12-01,65474193,65474193,185411,https://www.sanidad.gob.es/profesionales/saludPublica/ccayes/alertasActual/nCov/pruebasRealizadas.htm,44427888,18558969,0,0,0.4486883697902977,102219,83192,45372216,19242021
Spain,2021-12-02,65664382,65664382,190189,https://www.sanidad.gob.es/profesionales/saludPublica/ccayes/alertasActual/nCov/pruebasRealizadas.htm,44427888,18558969,0,0,0.4486883697902977,104853,85336,45477069,19327357
Spain,2021-12-03,65855347,65855347,190965,https://www.sanidad.gob.es/profesionales/saludPublica/ccayes/alertasActual/nCov/pruebasRealizadas.htm,44427888,18558969,0,0,0.4486883697902977,105281,85684,45582350,19413041
Spain,2021-12-04,65966046,65966046,110699,https://www.sanidad.gob.es/profesionales/saludPublica/ccayes/alertasActual/nCov/pruebasRealizadas.htm,44427888,18558969,0,0,0.4486883697902977,61030,49669,45643380,19462710
Spain,2021-12-05,66042560,66042560,76514,https://www.sanidad.gob.es/profesionales/saludPublica/ccayes/alertasActual/nCov/pruebasRealizadas.htm,44427888,18558969,0,0,0.4486883697902977,42183,34331,45685563,19497041
Spain,2021-12-06,66121323,66121323,78763,https://www.sanidad.gob.es/profesionales/saludPublica/ccayes/alertasActual/nCov/pruebasRealizadas.htm,44427888,18558969,0,0,0.4486883697902977,43423,35340,45728986,19532381
Spain,2021-12-07,66295304,66295304,173981,https://www.sanidad.gob.es/profesionales/saludPublica/ccayes/alertasActual/nCov/pruebasRealizadas.htm,44427888,18558969,0,0,0.4486883697902977,95918,78063,45824904,19610444
Spain,2021-12-08,66405601,66405601,110297,https://www.sanidad.gob.es/profesionales/saludPublica/ccayes/alertasActual/nCov/pruebasRealizadas.htm,44427888,18558969,0,0,0.4486883697902977,60808,49489,45885712,19659933
Spain,2021-12-09,66610503,66610503,204902,https://www.sanidad.gob.es/profesionales/saludPublica/ccayes/alertasActual/nCov/pruebasRealizadas.htm,44427888,18558969,0,0,0.4486883697902977,112965,91937,45998677,19751870
Spain,2021-12-10,66833157,66833157,222654,https://www.sanidad.gob.es/profesionales/saludPublica/ccayes/alertasActual/nCov/pruebasRealizadas.htm,44427888,18558969,0,0,0.4486883697902977,122752,99902,46121429,19851772
Spain,2021-12-11,66971749,66971749,138592,https://www.sanidad.gob.es/profesionales/saludPublica/ccayes/alertasActual/nCov/pruebasRealizadas.htm,44427888,18558969,0,0,0.4486883697902977,76407,62185,46197836,19913957
Spain,2021-12-12,67077037,67077037,105288,https://www.sanidad.gob.es/profesionales/saludPublica/ccayes/alertasActual/nCov/pruebasRealizadas.htm,44427888,18558969,0,0,0.4486883697902977,58046,47242,46255882,19961199
Spain,2021-12-13,67300400,67300400,223363,https://www.sanidad.gob.es/profesionales/saludPublica/ccayes/alertasActual/nCov/pruebasRealizadas.htm,44427888,18558969,0,0,0.4486883697902977,123143,100220,46379025,20061419
Spain,2021-12-14,67557973,67557973,257573,https://www.sanidad.gob.es/profesionales/saludPublica/ccayes/alertasActual/nCov/pruebasRealizadas.htm,44427888,18558969,0,0,0.4486883697902977,142003,115570,46521028,20176989
Spain,2021-12-15,67832988,67832988,275015,https://www.sanidad.gob.es/profesionales/saludPublica/ccayes/alertasActual/nCov/pruebasRealizadas.htm,44427888,18558969,0,0,0.4486883697902977,151619,123396,46672647,20300385
Spain,2021-12-16,68116739,68116739,283751,https://www.sanidad.gob.es/profesionales/saludPublica/ccayes/alertasActual/nCov/pruebasRealizadas.htm,44427888,18558969,0,0,0.4486883697902977,156435,127316,46829082,20427701
Spain,2021-12-17,68432060,68432060,315321,https://www.sanidad.gob.es/profesionales/saludPublica/ccayes/alertasActual/nCov/pruebasRealizadas.htm,44427888,18558969,0,0,0.4486883697902977,173840,141481,47002922,20569182
Spain,2021-12-18,68629702,68629702,197642,https://www.sanidad.gob.es/profesionales/saludPublica/ccayes/alertasActual/nCov/pruebasRealizadas.htm,44427888,18558969,0,0,0.4486883697902977,108962,88680,47111884,20657862
Spain,2021-12-19,68777195,68777195,147493,https://www.sanidad.gob.es/profesionales/saludPublica/ccayes/alertasActual/nCov/pruebasRealizadas.htm,44427888,18558969,0,0,0.4486883697902977,81315,66178,47193199,20724040
Spain,2021-12-20,69111335,69111335,334140,https://www.sanidad.gob.es/profesionales/saludPublica/ccayes/alertasActual/nCov/pruebasRealizadas.htm,44427888,18558969,0,0,0.4486883697902977,184215,149925,47377414,20873965
Spain,2021-12-21,69522344,69522344,411009,https://www.sanidad.gob.es/profesionales/saludPublica/ccayes/alertasActual/nCov/pruebasRealizadas.htm,44427888,18558969,0,0,0.4486883697902977,226594,184415,47604008,21058380
Spain,2021-12-22,69977874,69977874,455530,https://www.sanidad.gob.es/profesionales/saludPublica/ccayes/alertasActual/nCov/pruebasRealizadas.htm,44427888,18558969,0,0,0.4486883697902977,251139,204391,47855147,21262771
Spain,2021-12-23,70483243,70483243,505369,https://www.sanidad.gob.es/profesionales/saludPublica/ccayes/alertasActual/nCov/pruebasRealizadas.htm,44427888,18558969,0,0,0.4486883697902977,278616,226753,48133763,21489524
Spain,2021-12-24,70863577,70863577,380334,https://www.sanidad.gob.es/profesionales/saludPublica/ccayes/alertasActual/nCov/pruebasRealizadas.htm,44427888,18558969,0,0,0.4486883697902977,209683,170651,48343446,21660175
Spain,2021-12-25,71060928,71060928,197351,https://www.sanidad.gob.es/profesionales/saludPublica/ccayes/alertasActual/nCov/pruebasRealizadas.htm,44427888,18558969,0,0,0.4486883697902977,108802,88549,48452248,21748724
Spain,2021-12-26,71267612,71267612,206684,https://www.sanidad.gob.es/profesionales/saludPublica/ccayes/alertasActual/nCov/pruebasRealizadas.htm,44427888,18558969,0,0,0.4486883697902977,113947,92737,48566195,21841461
Spain,2021-12-27,71682205,71682205,414593,https://www.sanidad.gob.es/profesionales/saludPublica/ccayes/alertasActual/nCov/pruebasRealizadas.htm,44427888,18558969,0,0,0.4486883697902977,228570,186023,48794765,22027484
Spain,2021-12-28,72155694,72155694,473489,https://www.sanidad.gob.es/profesionales/saludPublica/ccayes/alertasActual/nCov/pruebasRealizadas.htm,44427888,18558969,0,0,0.4486883697902977,261040,212449,49055805,22239933
Spain,2021-12-29,72644005,72644005,488311,https://www.sanidad.gob.es/profesionales/saludPublica/ccayes/alertasActual/nCov/pruebasRealizadas.htm,44427888,18558969,0,0,0.4486883697902977,269212,219099,49325017,22459032
Spain,2021-12-30,73115676,73115676,471671,https://www.sanidad.gob.es/profesionales/saludPublica/ccayes/alertasActual/nCov/pruebasRealizadas.htm,44427888,18558969,0,0,0.4486883697902977,260038,211633,49585055,22670665
Spain,2021-12-31,73454765,73454765,339089,https://www.sanidad.gob.es/profesionales/saludPublica/ccayes/alertasActual/nCov/pruebasRealizadas.htm,44427888,18558969,0,0,0.4486883697902977,186944,152145,49771999,22822810
Spain,2022-01-01,73621012,73621012,166247,https://www.sanidad.gob.es/profesionales/saludPublica/ccayes/alertasActual/nCov/pruebasRealizadas.htm,44427888,18558969,0,0,0.4486883697902977,91654,74593,49863653,22897403
Spain,2022-01-02,73815595,73815595,194583,https://www.sanidad.gob.es/profesionales/saludPublica/ccayes/alertasActual/nCov/pruebasRealizadas.htm,44427888,18558969,0,0,0.4486883697902977,107276,87307,49970929,22984710
Spain,2022-01-03,74207741,74207741,392146,https://www.sanidad.gob.es/profesionales/saludPublica/ccayes/alertasActual/nCov/pruebasRealizadas.htm,44427888,18558969,0,0,0.4486883697902977,216195,175951,50187124,23160661
Spain,2022-01-04,74640501,74640501,432760,https://www.sanidad.gob.es/profesionales/saludPublica/ccayes/alertasActual/nCov/pruebasRealizadas.htm,44427888,18558969,0,0,0.4486883697902977,238586,194174,50425710,23354835
Spain,2022-01-05,75058813,75058813,418312,https://www.sanidad.gob.es/profesionales/saludPublica/ccayes/alertasActual/nCov/pruebasRealizadas.htm,44427888,18558969,0,0,0.4486883697902977,230620,187692,50656330,23542527
Spain,2022-01-06,75244010,75244010,185197,https://www.sanidad.gob.es/profesionales/saludPublica/ccayes/alertasActual/nCov/pruebasRealizadas.htm,44427888,18558969,0,0,0.4486883697902977,102101,83096,50758431,23625623
Spain,2022-01-07,75610243,75610243,366233,https://www.sanidad.gob.es/profesionales/saludPublica/ccayes/alertasActual/nCov/pruebasRealizadas.htm,44427888,18558969,0,0,0.4486883697902977,201909,164324,50960340,23789947
Spain,2022-01-08,75828552,75828552,218309,https://www.sanidad.gob.es/profesionales/saludPublica/ccayes/alertasActual/nCov/pruebasRealizadas.htm,44427888,18558969,0,0,0.4486883697902977,120356,97953,51080696,23887900
Spain,2022-01-09,76014502,76014502,185950,https://www.sanidad.gob.es/profesionales/saludPublica/ccayes/alertasActual/nCov/pruebasRealizadas.htm,44427888,18558969,0,0,0.4486883697902977,102516,83434,51183212,23971334
Spain,2022-01-10,76416025,76416025,401523,https://www.sanidad.gob.es/profesionales/saludPublica/ccayes/alertasActual/nCov/pruebasRealizadas.htm,44427888,18558969,0,0,0.4486883697902977,221364,180159,51404576,24151493
Spain,2022-01-11,76829977,76829977,413952,https://www.sanidad.gob.es/profesionales/saludPublica/ccayes/alertasActual/nCov/pruebasRealizadas.htm,44427888,18558969,0,0,0.4486883697902977,228217,185735,51632793,24337228
Spain,2022-01-12,77240901,77240901,410924,https://www.sanidad.gob.es/profesionales/saludPublica/ccayes/alertasActual/nCov/pruebasRealizadas.htm,44427888,18558969,0,0,0.4486883697902977,226547,184377,51859340,24521605
Spain,2022-01-13,77637161,77637161,396260,https://www.sanidad.gob.es/profesionales/saludPublica/ccayes/alertasActual/nCov/pruebasRealizadas.htm,44427888,18558969,0,0,0.4486883697902977,218463,177797,52077803,24699402
Spain,2022-01-14,78023222,78023222,386061,https://www.sanidad.gob.es/profesionales/saludPublica/ccayes/alertasActual/nCov/pruebasRealizadas.htm,44427888,18558969,0,0,0.4486883697902977,212840,173221,52290643,24872623
Spain,2022-01-15,78226475,78226475,203253,https://www.sanidad.gob.es/profesionales/saludPublica/ccayes/alertasActual/nCov/pruebasRealizadas.htm,44427888,18558969,0,0,0.4486883697902977,112056,91197,52402699,24963820
Spain,2022-01-16,78372734,78372734,146259,https://www.sanidad.gob.es/profesionales/saludPublica/ccayes/alertasActual/nCov/pruebasRealizadas.htm,44427888,18558969,0,0,0.4486883697902977,80634,65625,52483333,25029445
Spain,2022-01-17,78752189,78752189,379455,https://www.sanidad.gob.es/profesionales/saludPublica/ccayes/alertasActual/nCov/pruebasRealizadas.htm,44427888,18558969,0,0,0.4486883697902977,209198,170257,52692531,25199702
Spain,2022-01-18,79135960,79135960,383771,https://www.sanidad.gob.es/profesionales/saludPublica/ccayes/alertasActual/nCov/pruebasRealizadas.htm,44427888,18558969,0,0,0.4486883697902977,211577,172194,52904108,25371896
Spain,2022-01-19,79504181,79504181,368221,https://www.sanidad.gob.es/profesionales/saludPublica/ccayes/alertasActual/nCov/pruebasRealizadas.htm,44427888,18558969,0,0,0.4486883697902977,203005,165216,53107113,25537112
Spain,2022-01-20,79838643,79838643,334462,https://www.sanidad.gob.es/profesionales/saludPublica/ccayes/alertasActual/nCov/pruebasRealizadas.htm,44427888,18558969,0,0,0.4486883697902977,184393,150069,53291506,25687181
Spain,2022-01-21,80167046,80167046,328403,https://www.sanidad.gob.es/profesionales/saludPublica/ccayes/alertasActual/nCov/pruebasRealizadas.htm,44427888,18558969,0,0,0.4486883697902977,181052,147351,53472558,25834532
Spain,2022-01-22,80329806,80329806,162760,https://www.sanidad.gob.es/profesionales/saludPublica/ccayes/alertasActual/nCov/pruebasRealizadas.htm,44427888,18558969,0,0,0.4486883697902977,89731,73029,53562289,25907561
Spain,2022-01-23,80452831,80452831,123025,https://www.sanidad.gob.es/profesionales/saludPublica/ccayes/alertasActual/nCov/pruebasRealizadas.htm,44427888,18558969,0,0,0.4486883697902977,67825,55200,53630114,25962761
Spain,2022-01-24,80788073,80788073,335242,https://www.sanidad.gob.es/profesionales/saludPublica/ccayes/alertasActual/nCov/pruebasRealizadas.htm,44427888,18558969,0,0,0.4486883697902977,184823,150419,53814937,26113180
Spain,2022-01-25,81106179,81106179,318106,https://www.sanidad.gob.es/profesionales/saludPublica/ccayes/alertasActual/nCov/pruebasRealizadas.htm,44427888,18558969,0,0,0.4486883697902977,175376,142730,53990313,26255910
Spain,2022-01-26,81395540,81395540,289361,https://www.sanidad.gob.es/profesionales/saludPublica/ccayes/alertasActual/nCov/pruebasRealizadas.htm,44427888,18558969,0,0,0.4486883697902977,159528,129833,54149841,26385743
Spain,2022-01-27,81661004,81661004,265464,https://www.sanidad.gob.es/profesionales/saludPublica/ccayes/alertasActual/nCov/pruebasRealizadas.htm,44427888,18558969,0,0,0.4486883697902977,146353,119111,54296194,26504854
Spain,2022-01-28,81916287,81916287,255283,https://www.sanidad.gob.es/profesionales/saludPublica/ccayes/alertasActual/nCov/pruebasRealizadas.htm,44427888,18558969,0,0,0.4486883697902977,140740,114543,54436934,26619397
Spain,2022-01-29,82042728,82042728,126441,https://www.sanidad.gob.es/profesionales/saludPublica/ccayes/alertasActual/nCov/pruebasRealizadas.htm,44427888,18558969,0,0,0.4486883697902977,69708,56733,54506642,26676130
Spain,2022-01-30,82135391,82135391,92663,https://www.sanidad.gob.es/profesionales/saludPublica/ccayes/alertasActual/nCov/pruebasRealizadas.htm,44427888,18558969,0,0,0.4486883697902977,51086,41577,54557728,26717707
Spain,2022-01-31,82393487,82393487,258096,https://www.sanidad.gob.es/profesionales/saludPublica/ccayes/alertasActual/nCov/pruebasRealizadas.htm,44427888,18558969,0,0,0.4486883697902977,142291,115805,54700019,26833512
Spain,2022-02-01,82627057,82627057,233570,https://www.sanidad.gob.es/profesionales/saludPublica/ccayes/alertasActual/nCov/pruebasRealizadas.htm,44427888,18558969,0,0,0.4486883697902977,128770,104800,54828789,26938312
Spain,2022-02-02,82839746,82839746,212689,https://www.sanidad.gob.es/profesionales/saludPublica/ccayes/alertasActual/nCov/pruebasRealizadas.htm,44427888,18558969,0,0,0.4486883697902977,117258,95431,54946047,27033743
Spain,2022-02-03,83031215,83031215,191469,https://www.sanidad.gob.es/profesionales/saludPublica/ccayes/alertasActual/nCov/pruebasRealizadas.htm,44427888,18558969,0,0,0.4486883697902977,105559,85910,55051606,27119653
Spain,2022-02-04,83220152,83220152,188937,https://www.sanidad.gob.es/profesionales/saludPublica/ccayes/alertasActual/nCov/pruebasRealizadas.htm,44427888,18558969,0,0,0.4486883697902977,104163,84774,55155769,27204427
Spain,2022-02-05,83313167,83313167,93015,https://www.sanidad.gob.es/profesionales/saludPublica/ccayes/alertasActual/nCov/pruebasRealizadas.htm,44427888,18558969,0,0,0.4486883697902977,51280,41735,55207049,27246162
Spain,2022-02-06,83385628,83385628,72461,https://www.sanidad.gob.es/profesionales/saludPublica/ccayes/alertasActual/nCov/pruebasRealizadas.htm,44427888,18558969,0,0,0.4486883697902977,39949,32512,55246998,27278674
Spain,2022-02-07,83583829,83583829,198201,https://www.sanidad.gob.es/profesionales/saludPublica/ccayes/alertasActual/nCov/pruebasRealizadas.htm,44427888,18558969,0,0,0.4486883697902977,109271,88930,55356269,27367604
Spain,2022-02-08,83764427,83764427,180598,https://www.sanidad.gob.es/profesionales/saludPublica/ccayes/alertasActual/nCov/pruebasRealizadas.htm,44427888,18558969,0,0,0.4486883697902977,99566,81032,55455835,27448636
Spain,2022-02-09,83928637,83928637,164210,https://www.sanidad.gob.es/profesionales/saludPublica/ccayes/alertasActual/nCov/pruebasRealizadas.htm,44427888,18558969,0,0,0.4486883697902977,90531,73679,55546366,27522315
Spain,2022-02-10,84073805,84073805,145168,https://www.sanidad.gob.es/profesionales/saludPublica/ccayes/alertasActual/nCov/pruebasRealizadas.htm,44427888,18558969,0,0,0.4486883697902977,80033,65135,55626399,27587450
Spain,2022-02-11,84210592,84210592,136787,https://www.sanidad.gob.es/profesionales/saludPublica/ccayes/alertasActual/nCov/pruebasRealizadas.htm,44427888,18558969,0,0,0.4486883697902977,75412,61375,55701811,27648825
Spain,2022-02-12,84285168,84285168,74576,https://www.sanidad.gob.es/profesionales/saludPublica/ccayes/alertasActual/nCov/pruebasRealizadas.htm,44427888,18558969,0,0,0.4486883697902977,41115,33461,55742926,27682286
Spain,2022-02-13,84343121,84343121,57953,https://www.sanidad.gob.es/profesionales/saludPublica/ccayes/alertasActual/nCov/pruebasRealizadas.htm,44427888,18558969,0,0,0.4486883697902977,31950,26003,55774876,27708289
Spain,2022-02-14,84501920,84501920,158799,https://www.sanidad.gob.es/profesionales/saludPublica/ccayes/alertasActual/nCov/pruebasRealizadas.htm,44427888,18558969,0,0,0.4486883697902977,87548,71251,55862424,27779540
Spain,2022-02-15,84649617,84649617,147697,https://www.sanidad.gob.es/profesionales/saludPublica/ccayes/alertasActual/nCov/pruebasRealizadas.htm,44427888,18558969,0,0,0.4486883697902977,81427,66270,55943851,27845810
Spain,2022-02-16,84785845,84785845,136228,https://www.sanidad.gob.es/profesionales/saludPublica/ccayes/alertasActual/nCov/pruebasRealizadas.htm,44427888,18558969,0,0,0.4486883697902977,75104,61124,56018955,27906934
Spain,2022-02-17,84904894,84904894,119049,https://www.sanidad.gob.es/profesionales/saludPublica/ccayes/alertasActual/nCov/pruebasRealizadas.htm,44427888,18558969,0,0,0.4486883697902977,65633,53416,56084588,27960350
Spain,2022-02-18,85027417,85027417,122523,https://www.sanidad.gob.es/profesionales/saludPublica/ccayes/alertasActual/nCov/pruebasRealizadas.htm,44427888,18558969,0,0,0.4486883697902977,67548,54975,56152136,28015325
Spain,2022-02-19,85089922,85089922,62505,https://www.sanidad.gob.es/profesionales/saludPublica/ccayes/alertasActual/nCov/pruebasRealizadas.htm,44427888,18558969,0,0,0.4486883697902977,34460,28045,56186596,28043370
Spain,2022-02-20,85139232,85139232,49310,https://www.sanidad.gob.es/profesionales/saludPublica/ccayes/alertasActual/nCov/pruebasRealizadas.htm,44427888,18558969,0,0,0.4486883697902977,27185,22125,56213781,28065495
Spain,2022-02-21,85281814,85281814,142582,https://www.sanidad.gob.es/profesionales/saludPublica/ccayes/alertasActual/nCov/pruebasRealizadas.htm,44427888,18558969,0,0,0.4486883697902977,78607,63975,56292388,28129470
Spain,2022-02-22,85412661,85412661,130847,https://www.sanidad.gob.es/profesionales/saludPublica/ccayes/alertasActual/nCov/pruebasRealizadas.htm,44427888,18558969,0,0,0.4486883697902977,72137,58710,56364525,28188180
Spain,2022-02-23,85534534,85534534,121873,https://www.sanidad.gob.es/profesionales/saludPublica/ccayes/alertasActual/nCov/pruebasRealizadas.htm,44427888,18558969,0,0,0.4486883697902977,67190,54683,56431715,28242863
Spain,2022-02-24,85637453,85637453,102919,https://www.sanidad.gob.es/profesionales/saludPublica/ccayes/alertasActual/nCov/pruebasRealizadas.htm,44427888,18558969,0,0,0.4486883697902977,56740,46179,56488455,28289042
Spain,2022-02-25,85737790,85737790,100337,https://www.sanidad.gob.es/profesionales/saludPublica/ccayes/alertasActual/nCov/pruebasRealizadas.htm,44427888,18558969,0,0,0.4486883697902977,55317,45020,56543772,28334062
Spain,2022-02-26,85791261,85791261,53471,https://www.sanidad.gob.es/profesionales/saludPublica/ccayes/alertasActual/nCov/pruebasRealizadas.htm,44427888,18558969,0,0,0.4486883697902977,29479,23992,56573251,28358054
Spain,2022-02-27,85836752,85836752,45491,https://www.sanidad.gob.es/profesionales/saludPublica/ccayes/alertasActual/nCov/pruebasRealizadas.htm,44427888,18558969,0,0,0.4486883697902977,25080,20411,56598331,28378465
Spain,2022-02-28,85951161,85951161,114409,https://www.sanidad.gob.es/profesionales/saludPublica/ccayes/alertasActual/nCov/pruebasRealizadas.htm,44427888,18558969,0,0,0.4486883697902977,63075,51334,56661406,28429799
Spain,2022-03-01,86065737,86065737,114576,https://www.sanidad.gob.es/profesionales/saludPublica/ccayes/alertasActual/nCov/pruebasRealizadas.htm,44427888,18558969,0,0,0.4486883697902977,63167,51409,56724573,28481208
Spain,2022-03-02,86183829,86183829,118092,https://www.sanidad.gob.es/profesionales/saludPublica/ccayes/alertasActual/nCov/pruebasRealizadas.htm,44427888,18558969,0,0,0.4486883697902977,65105,52987,56789678,28534195
Spain,2022-03-03,86289967,86289967,106138,https://www.sanidad.gob.es/profesionales/saludPublica/ccayes/alertasActual/nCov/pruebasRealizadas.htm,44427888,18558969,0,0,0.4486883697902977,58515,47623,56848193,28581818
Spain,2022-03-04,86395389,86395389,105422,https://www.sanidad.gob.es/profesionales/saludPublica/ccayes/alertasActual/nCov/pruebasRealizadas.htm,44427888,18558969,0,0,0.4486883697902977,58120,47302,56906313,28629120
Spain,2022-03-05,86454213,86454213,58824,https://www.sanidad.gob.es/profesionales/saludPublica/ccayes/alertasActual/nCov/pruebasRealizadas.htm,44427888,18558969,0,0,0.4486883697902977,32430,26394,56938743,28655514
Spain,2022-03-06,86502024,86502024,47811,https://www.sanidad.gob.es/profesionales/saludPublica/ccayes/alertasActual/nCov/pruebasRealizadas.htm,44427888,18558969,0,0,0.4486883697902977,26359,21452,56965102,28676966
Spain,2022-03-07,86631034,86631034,129010,https://www.sanidad.gob.es/profesionales/saludPublica/ccayes/alertasActual/nCov/pruebasRealizadas.htm,44427888,18558969,0,0,0.4486883697902977,71125,57885,57036227,28734851
Spain,2022-03-08,86751595,86751595,120561,https://www.sanidad.gob.es/profesionales/saludPublica/ccayes/alertasActual/nCov/pruebasRealizadas.htm,44427888,18558969,0,0,0.4486883697902977,66467,54094,57102694,28788945
Spain,2022-03-09,86866881,86866881,115286,https://www.sanidad.gob.es/profesionales/saludPublica/ccayes/alertasActual/nCov/pruebasRealizadas.htm,44427888,18558969,0,0,0.4486883697902977,63559,51727,57166253,28840672
Spain,2022-03-10,86967512,86967512,100631,https://www.sanidad.gob.es/profesionales/saludPublica/ccayes/alertasActual/nCov/pruebasRealizadas.htm,44427888,18558969,0,0,0.4486883697902977,55479,45152,57221732,28885824
Spain,2022-03-11,87064549,87064549,97037,https://www.sanidad.gob.es/profesionales/saludPublica/ccayes/alertasActual/nCov/pruebasRealizadas.htm,44427888,18558969,0,0,0.4486883697902977,53498,43539,57275230,28929363
Spain,2022-03-12,87118740,87118740,54191,https://www.sanidad.gob.es/profesionales/saludPublica/ccayes/alertasActual/nCov/pruebasRealizadas.htm,44427888,18558969,0,0,0.4486883697902977,29876,24315,57305106,28953678
Spain,2022-03-13,87166134,87166134,47394,https://www.sanidad.gob.es/profesionales/saludPublica/ccayes/alertasActual/nCov/pruebasRealizadas.htm,44427888,18558969,0,0,0.4486883697902977,26129,21265,57331235,28974943
Spain,2022-03-14,87295346,87295346,129212,https://www.sanidad.gob.es/profesionales/saludPublica/ccayes/alertasActual/nCov/pruebasRealizadas.htm,44427888,18558969,0,0,0.4486883697902977,71236,57976,57402471,29032919
Spain,2022-03-15,87417353,87417353,122007,https://www.sanidad.gob.es/profesionales/saludPublica/ccayes/alertasActual/nCov/pruebasRealizadas.htm,44427888,18558969,0,0,0.4486883697902977,67264,54743,57469735,29087662
Spain,2022-03-16,87531875,87531875,114522,https://www.sanidad.gob.es/profesionales/saludPublica/ccayes/alertasActual/nCov/pruebasRealizadas.htm,44427888,18558969,0,0,0.4486883697902977,63137,51385,57532872,29139047
Spain,2022-03-17,87629248,87629248,97373,https://www.sanidad.gob.es/profesionales/saludPublica/ccayes/alertasActual/nCov/pruebasRealizadas.htm,44427888,18558969,0,0,0.4486883697902977,53683,43690,57586555,29182737
Spain,2022-03-18,87722454,87722454,93206,https://www.sanidad.gob.es/profesionales/saludPublica/ccayes/alertasActual/nCov/pruebasRealizadas.htm,44427888,18558969,0,0,0.4486883697902977,51386,41820,57637941,29224557
Spain,2022-03-19,87773446,87773446,50992,https://www.sanidad.gob.es/profesionales/saludPublica/ccayes/alertasActual/nCov/pruebasRealizadas.htm,44427888,18558969,0,0,0.4486883697902977,28112,22880,57666053,29247437
Spain,2022-03-20,87818364,87818364,44918,https://www.sanidad.gob.es/profesionales/saludPublica/ccayes/alertasActual/nCov/pruebasRealizadas.htm,44427888,18558969,0,0,0.4486883697902977,24764,20154,57690817,29267591
Spain,2022-03-21,87944727,87944727,126363,https://www.sanidad.gob.es/profesionales/saludPublica/ccayes/alertasActual/nCov/pruebasRealizadas.htm,44427888,18558969,0,0,0.4486883697902977,69665,56698,57760482,29324289
Spain,2022-03-22,88066495,88066495,121768,https://www.sanidad.gob.es/profesionales/saludPublica/ccayes/alertasActual/nCov/pruebasRealizadas.htm,44427888,18558969,0,0,0.4486883697902977,67132,54636,57827614,29378925
Spain,2022-03-23,88178248,88178248,111753,https://www.sanidad.gob.es/profesionales/saludPublica/ccayes/alertasActual/nCov/pruebasRealizadas.htm,44427888,18558969,0,0,0.4486883697902977,61611,50142,57889225,29429067
Spain,2022-03-24,88269685,88269685,91437,https://www.sanidad.gob.es/profesionales/saludPublica/ccayes/alertasActual/nCov/pruebasRealizadas.htm,44427888,18558969,0,0,0.4486883697902977,50410,41027,57939635,29470094
Spain,2022-03-25,88358322,88358322,88637,https://www.sanidad.gob.es/profesionales/saludPublica/ccayes/alertasActual/nCov/pruebasRealizadas.htm,44427888,18558969,0,0,0.4486883697902977,48867,39770,57988502,29509864
Spain,2022-03-26,88406315,88406315,47993,https://www.sanidad.gob.es/profesionales/saludPublica/ccayes/alertasActual/nCov/pruebasRealizadas.htm,44427888,18558969,0,0,0.4486883697902977,26459,21534,58014961,29531398
Spain,2022-03-27,88445418,88445418,39103,https://www.sanidad.gob.es/profesionales/saludPublica/ccayes/alertasActual/nCov/pruebasRealizadas.htm,44427888,18558969,0,0,0.4486883697902977,21558,17545,58036519,29548943
Spain,2022-03-28,88540116,88540116,94698,https://www.sanidad.gob.es/profesionales/saludPublica/ccayes/alertasActual/nCov/pruebasRealizadas.htm,44427888,18558969,0,0,0.4486883697902977,52208,42490,58088727,29591433
Spain,2022-03-29,88622371,88622371,82255,https://www.sanidad.gob.es/profesionales/saludPublica/ccayes/alertasActual/nCov/pruebasRealizadas.htm,44427888,18558969,0,0,0.4486883697902977,45348,36907,58134075,29628340
Spain,2022-03-30,88696295,88696295,73924,https://www.sanidad.gob.es/profesionales/saludPublica/ccayes/alertasActual/nCov/pruebasRealizadas.htm,44427888,18558969,0,0,0.4486883697902977,40755,33169,58174830,29661509
Spain,2022-03-31,88757849,88757849,61554,https://www.sanidad.gob.es/profesionales/saludPublica/ccayes/alertasActual/nCov/pruebasRealizadas.htm,44427888,18558969,0,0,0.4486883697902977,33935,27619,58208765,29689128
Spain,2022-04-01,88821368,88821368,63519,https://www.sanidad.gob.es/profesionales/saludPublica/ccayes/alertasActual/nCov/pruebasRealizadas.htm,44427888,18558969,0,0,0.4486883697902977,35019,28500,58243784,29717628
Spain,2022-04-02,88858230,88858230,36862,https://www.sanidad.gob.es/profesionales/saludPublica/ccayes/alertasActual/nCov/pruebasRealizadas.htm,44427888,18558969,0,0,0.4486883697902977,20322,16540,58264106,29734168
Spain,2022-04-03,88888175,88888175,29945,https://www.sanidad.gob.es/profesionales/saludPublica/ccayes/alertasActual/nCov/pruebasRealizadas.htm,44427888,18558969,0,0,0.4486883697902977,16509,13436,58280615,29747604
Spain,2022-04-04,88968218,88968218,80043,https://www.sanidad.gob.es/profesionales/saludPublica/ccayes/alertasActual/nCov/pruebasRealizadas.htm,44427888,18558969,0,0,0.4486883697902977,44129,35914,58324744,29783518
Spain,2022-04-05,89041292,89041292,73074,https://www.sanidad.gob.es/profesionales/saludPublica/ccayes/alertasActual/nCov/pruebasRealizadas.htm,44427888,18558969,0,0,0.4486883697902977,40287,32787,58365031,29816305
Spain,2022-04-06,89110597,89110597,69305,https://www.sanidad.gob.es/profesionales/saludPublica/ccayes/alertasActual/nCov/pruebasRealizadas.htm,44427888,18558969,0,0,0.4486883697902977,38209,31096,58403240,29847401
Spain,2022-04-07,89172959,89172959,62362,https://www.sanidad.gob.es/profesionales/saludPublica/ccayes/alertasActual/nCov/pruebasRealizadas.htm,44427888,18558969,0,0,0.4486883697902977,34381,27981,58437621,29875382
Spain,2022-04-08,89232966,89232966,60007,https://www.sanidad.gob.es/profesionales/saludPublica/ccayes/alertasActual/nCov/pruebasRealizadas.htm,44427888,18558969,0,0,0.4486883697902977,33083,26924,58470704,29902306
Spain,2022-04-09,89269627,89269627,36661,https://www.sanidad.gob.es/profesionales/saludPublica/ccayes/alertasActual/nCov/pruebasRealizadas.htm,44427888,18558969,0,0,0.4486883697902977,20212,16449,58490916,29918755
Spain,2022-04-10,89299381,89299381,29754,https://www.sanidad.gob.es/profesionales/saludPublica/ccayes/alertasActual/nCov/pruebasRealizadas.htm,44427888,18558969,0,0,0.4486883697902977,16404,13350,58507320,29932105
Spain,2022-04-11,89372927,89372927,73546,https://www.sanidad.gob.es/profesionales/saludPublica/ccayes/alertasActual/nCov/pruebasRealizadas.htm,44427888,18558969,0,0,0.4486883697902977,40547,32999,58547867,29965104
Spain,2022-04-12,89436726,89436726,63799,https://www.sanidad.gob.es/profesionales/saludPublica/ccayes/alertasActual/nCov/pruebasRealizadas.htm,44427888,18558969,0,0,0.4486883697902977,35173,28626,58583040,29993730
Spain,2022-04-13,89498016,89498016,61290,https://www.sanidad.gob.es/profesionales/saludPublica/ccayes/alertasActual/nCov/pruebasRealizadas.htm,44427888,18558969,0,0,0.4486883697902977,33790,27500,58616830,30021230
Spain,2022-04-14,89532655,89532655,34639,https://www.sanidad.gob.es/profesionales/saludPublica/ccayes/alertasActual/nCov/pruebasRealizadas.htm,44427888,18558969,0,0,0.4486883697902977,19097,15542,58635927,30036772
Spain,2022-04-15,89559709,89559709,27054,https://www.sanidad.gob.es/profesionales/saludPublica/ccayes/alertasActual/nCov/pruebasRealizadas.htm,44427888,18558969,0,0,0.4486883697902977,14915,12139,58650842,30048911
Spain,2022-04-16,89596499,89596499,36790,https://www.sanidad.gob.es/profesionales/saludPublica/ccayes/alertasActual/nCov/pruebasRealizadas.htm,44427888,18558969,0,0,0.4486883697902977,20283,16507,58671125,30065418
Spain,2022-04-17,89629554,89629554,33055,https://www.sanidad.gob.es/profesionales/saludPublica/ccayes/alertasActual/nCov/pruebasRealizadas.htm,44427888,18558969,0,0,0.4486883697902977,18224,14831,58689349,30080249
Spain,2022-04-18,89696778,89696778,67224,https://www.sanidad.gob.es/profesionales/saludPublica/ccayes/alertasActual/nCov/pruebasRealizadas.htm,44427888,18558969,0,0,0.4486883697902977,37061,30163,58726410,30110412
Spain,2022-04-19,89779756,89779756,82978,https://www.sanidad.gob.es/profesionales/saludPublica/ccayes/alertasActual/nCov/pruebasRealizadas.htm,44427888,18558969,0,0,0.4486883697902977,45747,37231,58772157,30147643
Spain,2022-04-20,89857406,89857406,77650,https://www.sanidad.gob.es/profesionales/saludPublica/ccayes/alertasActual/nCov/pruebasRealizadas.htm,44427888,18558969,0,0,0.4486883697902977,42809,34841,58814966,30182484
Spain,2022-04-21,89922288,89922288,64882,https://www.sanidad.gob.es/profesionales/saludPublica/ccayes/alertasActual/nCov/pruebasRealizadas.htm,44427888,18558969,0,0,0.4486883697902977,35770,29112,58850736,30211596
Spain,2022-04-22,89989580,89989580,67292,https://www.sanidad.gob.es/profesionales/saludPublica/ccayes/alertasActual/nCov/pruebasRealizadas.htm,44427888,18558969,0,0,0.4486883697902977,37099,30193,58887835,30241789
Spain,2022-04-23,90025422,90025422,35842,https://www.sanidad.gob.es/profesionales/saludPublica/ccayes/alertasActual/nCov/pruebasRealizadas.htm,44427888,18558969,0,0,0.4486883697902977,19760,16082,58907595,30257871
Spain,2022-04-24,90056635,90056635,31213,https://www.sanidad.gob.es/profesionales/saludPublica/ccayes/alertasActual/nCov/pruebasRealizadas.htm,44427888,18558969,0,0,0.4486883697902977,17208,14005,58924803,30271876
Spain,2022-04-25,90143929,90143929,87294,https://www.sanidad.gob.es/profesionales/saludPublica/ccayes/alertasActual/nCov/pruebasRealizadas.htm,44427888,18558969,0,0,0.4486883697902977,48126,39168,58972929,30311044
Spain,2022-04-26,90227264,90227264,83335,https://www.sanidad.gob.es/profesionales/saludPublica/ccayes/alertasActual/nCov/pruebasRealizadas.htm,44427888,18558969,0,0,0.4486883697902977,45944,37391,59018873,30348435
Spain,2022-04-27,90306798,90306798,79534,https://www.sanidad.gob.es/profesionales/saludPublica/ccayes/alertasActual/nCov/pruebasRealizadas.htm,44427888,18558969,0,0,0.4486883697902977,43848,35686,59062721,30384121
Spain,2022-04-28,90376513,90376513,69715,https://www.sanidad.gob.es/profesionales/saludPublica/ccayes/alertasActual/nCov/pruebasRealizadas.htm,44427888,18558969,0,0,0.4486883697902977,38435,31280,59101156,30415401
Spain,2022-04-29,90449303,90449303,72790,https://www.sanidad.gob.es/profesionales/saludPublica/ccayes/alertasActual/nCov/pruebasRealizadas.htm,44427888,18558969,0,0,0.4486883697902977,40130,32660,59141286,30448061
Spain,2022-04-30,90486055,90486055,36752,https://www.sanidad.gob.es/profesionales/saludPublica/ccayes/alertasActual/nCov/pruebasRealizadas.htm,44427888,18558969,0,0,0.4486883697902977,20262,16490,59161548,30464551
Spain,2022-05-01,90516767,90516767,30712,https://www.sanidad.gob.es/profesionales/saludPublica/ccayes/alertasActual/nCov/pruebasRealizadas.htm,44427888,18558969,0,0,0.4486883697902977,16932,13780,59178480,30478331
Spain,2022-05-02,90583176,90583176,66409,https://www.sanidad.gob.es/profesionales/saludPublica/ccayes/alertasActual/nCov/pruebasRealizadas.htm,44427888,18558969,0,0,0.4486883697902977,36612,29797,59215092,30508128
Spain,2022-05-03,90672459,90672459,89283,https://www.sanidad.gob.es/profesionales/saludPublica/ccayes/alertasActual/nCov/pruebasRealizadas.htm,44427888,18558969,0,0,0.4486883697902977,49223,40060,59264315,30548188
Spain,2022-05-04,90753748,90753748,81289,https://www.sanidad.gob.es/profesionales/saludPublica/ccayes/alertasActual/nCov/pruebasRealizadas.htm,44427888,18558969,0,0,0.4486883697902977,44816,36473,59309131,30584661
Spain,2022-05-05,90827241,90827241,73493,https://www.sanidad.gob.es/profesionales/saludPublica/ccayes/alertasActual/nCov/pruebasRealizadas.htm,44427888,18558969,0,0,0.4486883697902977,40518,32975,59349649,30617636
Spain,2022-05-06,90902447,90902447,75206,https://www.sanidad.gob.es/profesionales/saludPublica/ccayes/alertasActual/nCov/pruebasRealizadas.htm,44427888,18558969,0,0,0.4486883697902977,41462,33744,59391111,30651380
Spain,2022-05-07,90940072,90940072,37625,https://www.sanidad.gob.es/profesionales/saludPublica/ccayes/alertasActual/nCov/pruebasRealizadas.htm,44427888,18558969,0,0,0.4486883697902977,20743,16882,59411854,30668262
Spain,2022-05-08,90972439,90972439,32367,https://www.sanidad.gob.es/profesionales/saludPublica/ccayes/alertasActual/nCov/pruebasRealizadas.htm,44427888,18558969,0,0,0.4486883697902977,17844,14523,59429698,30682785
Spain,2022-05-09,91069251,91069251,96812,https://www.sanidad.gob.es/profesionales/saludPublica/ccayes/alertasActual/nCov/pruebasRealizadas.htm,44427888,18558969,0,0,0.4486883697902977,53374,43438,59483072,30726223
Spain,2022-05-10,91154139,91154139,84888,https://www.sanidad.gob.es/profesionales/saludPublica/ccayes/alertasActual/nCov/pruebasRealizadas.htm,44427888,18558969,0,0,0.4486883697902977,46800,38088,59529872,30764311
Spain,2022-05-11,91234928,91234928,80789,https://www.sanidad.gob.es/profesionales/saludPublica/ccayes/alertasActual/nCov/pruebasRealizadas.htm,44427888,18558969,0,0,0.4486883697902977,44540,36249,59574412,30800560
Spain,2022-05-12,91307029,91307029,72101,https://www.sanidad.gob.es/profesionales/saludPublica/ccayes/alertasActual/nCov/pruebasRealizadas.htm,44427888,18558969,0,0,0.4486883697902977,39750,32351,59614162,30832911
Spain,2022-05-13,91375164,91375164,68135,https://www.sanidad.gob.es/profesionales/saludPublica/ccayes/alertasActual/nCov/pruebasRealizadas.htm,44427888,18558969,0,0,0.4486883697902977,37564,30571,59651726,30863482
Spain,2022-05-14,91411204,91411204,36040,https://www.sanidad.gob.es/profesionales/saludPublica/ccayes/alertasActual/nCov/pruebasRealizadas.htm,44427888,18558969,0,0,0.4486883697902977,19869,16171,59671595,30879653
Spain,2022-05-15,91441775,91441775,30571,https://www.sanidad.gob.es/profesionales/saludPublica/ccayes/alertasActual/nCov/pruebasRealizadas.htm,44427888,18558969,0,0,0.4486883697902977,16854,13717,59688449,30893370
Spain,2022-05-16,91525610,91525610,83835,https://www.sanidad.gob.es/profesionales/saludPublica/ccayes/alertasActual/nCov/pruebasRealizadas.htm,44427888,18558969,0,0,0.4486883697902977,46219,37616,59734668,30930986
Spain,2022-05-17,91603134,91603134,77524,https://www.sanidad.gob.es/profesionales/saludPublica/ccayes/alertasActual/nCov/pruebasRealizadas.htm,44427888,18558969,0,0,0.4486883697902977,42740,34784,59777408,30965770
Spain,2022-05-18,91677418,91677418,74284,https://www.sanidad.gob.es/profesionales/saludPublica/ccayes/alertasActual/nCov/pruebasRealizadas.htm,44427888,18558969,0,0,0.4486883697902977,40954,33330,59818362,30999100
Spain,2022-05-19,91742198,91742198,64780,https://www.sanidad.gob.es/profesionales/saludPublica/ccayes/alertasActual/nCov/pruebasRealizadas.htm,44427888,18558969,0,0,0.4486883697902977,35714,29066,59854076,31028166
Spain,2022-05-20,91808316,91808316,66118,https://www.sanidad.gob.es/profesionales/saludPublica/ccayes/alertasActual/nCov/pruebasRealizadas.htm,44427888,18558969,0,0,0.4486883697902977,36452,29666,59890528,31057832
Spain,2022-05-21,91840416,91840416,32100,https://www.sanidad.gob.es/profesionales/saludPublica/ccayes/alertasActual/nCov/pruebasRealizadas.htm,44427888,18558969,0,0,0.4486883697902977,17697,14403,59908225,31072235
Spain,2022-05-22,91868566,91868566,28150,https://www.sanidad.gob.es/profesionales/saludPublica/ccayes/alertasActual/nCov/pruebasRealizadas.htm,44427888,18558969,0,0,0.4486883697902977,15519,12631,59923744,31084866
Spain,2022-05-23,91951732,91951732,83166,https://www.sanidad.gob.es/profesionales/saludPublica/ccayes/alertasActual/nCov/pruebasRealizadas.htm,44427888,18558969,0,0,0.4486883697902977,45850,37316,59969594,31122182
Spain,2022-05-24,92020923,92020923,69191,https://www.sanidad.gob.es/profesionales/saludPublica/ccayes/alertasActual/nCov/pruebasRealizadas.htm,44427888,18558969,0,0,0.4486883697902977,38146,31045,60007740,31153227
Spain,2022-05-25,92083555,92083555,62632,https://www.sanidad.gob.es/profesionales/saludPublica/ccayes/alertasActual/nCov/pruebasRealizadas.htm,44427888,18558969,0,0,0.4486883697902977,34530,28102,60042270,31181329
Spain,2022-05-26,92136438,92136438,52883,https://www.sanidad.gob.es/profesionales/saludPublica/ccayes/alertasActual/nCov/pruebasRealizadas.htm,44427888,18558969,0,0,0.4486883697902977,29155,23728,60071425,31205057
Spain,2022-05-27,92192602,92192602,56164,https://www.sanidad.gob.es/profesionales/saludPublica/ccayes/alertasActual/nCov/pruebasRealizadas.htm,44427888,18558969,0,0,0.4486883697902977,30964,25200,60102389,31230257
Spain,2022-05-28,92220315,92220315,27713,https://www.sanidad.gob.es/profesionales/saludPublica/ccayes/alertasActual/nCov/pruebasRealizadas.htm,44427888,18558969,0,0,0.4486883697902977,15278,12435,60117667,31242692
Spain,2022-05-29,92245968,92245968,25653,https://www.sanidad.gob.es/profesionales/saludPublica/ccayes/alertasActual/nCov/pruebasRealizadas.htm,44427888,18558969,0,0,0.4486883697902977,14143,11510,60131810,31254202
Spain,2022-05-30,92316620,92316620,70652,https://www.sanidad.gob.es/profesionales/saludPublica/ccayes/alertasActual/nCov/pruebasRealizadas.htm,44427888,18558969,0,0,0.4486883697902977,38951,31701,60170761,31285903
Spain,2022-05-31,92379711,92379711,63091,https://www.sanidad.gob.es/profesionales/saludPublica/ccayes/alertasActual/nCov/pruebasRealizadas.htm,44427888,18558969,0,0,0.4486883697902977,34783,28308,60205544,31314211
Spain,2022-06-01,92440185,92440185,60474,https://www.sanidad.gob.es/profesionales/saludPublica/ccayes/alertasActual/nCov/pruebasRealizadas.htm,44427888,18558969,0,0,0.4486883697902977,33340,27134,60238884,31341345
Spain,2022-06-02,92492121,92492121,51936,https://www.sanidad.gob.es/profesionales/saludPublica/ccayes/alertasActual/nCov/pruebasRealizadas.htm,44427888,18558969,0,0,0.4486883697902977,28633,23303,60267517,31364648
Spain,2022-06-03,92544874,92544874,52753,https://www.sanidad.gob.es/profesionales/saludPublica/ccayes/alertasActual/nCov/pruebasRealizadas.htm,44427888,18558969,0,0,0.4486883697902977,29083,23670,60296600,31388318
Spain,2022-06-04,92572375,92572375,27501,https://www.sanidad.gob.es/profesionales/saludPublica/ccayes/alertasActual/nCov/pruebasRealizadas.htm,44427888,18558969,0,0,0.4486883697902977,15162,12339,60311762,31400657
Spain,2022-06-05,92596371,92596371,23996,https://www.sanidad.gob.es/profesionales/saludPublica/ccayes/alertasActual/nCov/pruebasRealizadas.htm,44427888,18558969,0,0,0.4486883697902977,13229,10767,60324991,31411424
Spain,2022-06-06,92655521,92655521,59150,https://www.sanidad.gob.es/profesionales/saludPublica/ccayes/alertasActual/nCov/pruebasRealizadas.htm,44427888,18558969,0,0,0.4486883697902977,32610,26540,60357601,31437964
Spain,2022-06-07,92722796,92722796,67275,https://www.sanidad.gob.es/profesionales/saludPublica/ccayes/alertasActual/nCov/pruebasRealizadas.htm,44427888,18558969,0,0,0.4486883697902977,37089,30186,60394690,31468150
Spain,2022-06-08,92782161,92782161,59365,https://www.sanidad.gob.es/profesionales/saludPublica/ccayes/alertasActual/nCov/pruebasRealizadas.htm,44427888,18558969,0,0,0.4486883697902977,32729,26636,60427419,31494786
Spain,2022-06-09,92831820,92831820,49659,https://www.sanidad.gob.es/profesionales/saludPublica/ccayes/alertasActual/nCov/pruebasRealizadas.htm,44427888,18558969,0,0,0.4486883697902977,27378,22281,60454797,31517067
Spain,2022-06-10,92881734,92881734,49914,https://www.sanidad.gob.es/profesionales/saludPublica/ccayes/alertasActual/nCov/pruebasRealizadas.htm,44427888,18558969,0,0,0.4486883697902977,27518,22396,60482315,31539463
Spain,2022-06-11,92908648,92908648,26914,https://www.sanidad.gob.es/profesionales/saludPublica/ccayes/alertasActual/nCov/pruebasRealizadas.htm,44427888,18558969,0,0,0.4486883697902977,14838,12076,60497153,31551539
Spain,2022-06-12,92931965,92931965,23317,https://www.sanidad.gob.es/profesionales/saludPublica/ccayes/alertasActual/nCov/pruebasRealizadas.htm,44427888,18558969,0,0,0.4486883697902977,12855,10462,60510008,31562001
Spain,2022-06-13,92998152,92998152,66187,https://www.sanidad.gob.es/profesionales/saludPublica/ccayes/alertasActual/nCov/pruebasRealizadas.htm,44427888,18558969,0,0,0.4486883697902977,36490,29697,60546498,31591698
Spain,2022-06-14,93058821,93058821,60669,https://www.sanidad.gob.es/profesionales/saludPublica/ccayes/alertasActual/nCov/pruebasRealizadas.htm,44427888,18558969,0,0,0.4486883697902977,33448,27221,60579946,31618919
Spain,2022-06-15,93119522,93119522,60701,https://www.sanidad.gob.es/profesionales/saludPublica/ccayes/alertasActual/nCov/pruebasRealizadas.htm,44427888,18558969,0,0,0.4486883697902977,33465,27236,60613411,31646155
Spain,2022-06-16,93167813,93167813,48291,https://www.sanidad.gob.es/profesionales/saludPublica/ccayes/alertasActual/nCov/pruebasRealizadas.htm,44427888,18558969,0,0,0.4486883697902977,26623,21668,60640034,31667823
Spain,2022-06-17,93221519,93221519,53706,https://www.sanidad.gob.es/profesionales/saludPublica/ccayes/alertasActual/nCov/pruebasRealizadas.htm,44427888,18558969,0,0,0.4486883697902977,29609,24097,60669643,31691920
Spain,2022-06-18,93249219,93249219,27700,https://www.sanidad.gob.es/profesionales/saludPublica/ccayes/alertasActual/nCov/pruebasRealizadas.htm,44427888,18558969,0,0,0.4486883697902977,15271,12429,60684914,31704349
Spain,2022-06-19,93273888,93273888,24669,https://www.sanidad.gob.es/profesionales/saludPublica/ccayes/alertasActual/nCov/pruebasRealizadas.htm,44427888,18558969,0,0,0.4486883697902977,13600,11069,60698514,31715418
Spain,2022-06-20,93347929,93347929,74041,https://www.sanidad.gob.es/profesionales/saludPublica/ccayes/alertasActual/nCov/pruebasRealizadas.htm,44427888,18558969,0,0,0.4486883697902977,40820,33221,60739334,31748639
Spain,2022-06-21,93414327,93414327,66398,https://www.sanidad.gob.es/profesionales/saludPublica/ccayes/alertasActual/nCov/pruebasRealizadas.htm,44427888,18558969,0,0,0.4486883697902977,36606,29792,60775940,31778431
Spain,2022-06-22,93477135,93477135,62808,https://www.sanidad.gob.es/profesionales/saludPublica/ccayes/alertasActual/nCov/pruebasRealizadas.htm,44427888,18558969,0,0,0.4486883697902977,34627,28181,60810567,31806612
Spain,2022-06-23,93535251,93535251,58116,https://www.sanidad.gob.es/profesionales/saludPublica/ccayes/alertasActual/nCov/pruebasRealizadas.htm,44427888,18558969,0,0,0.4486883697902977,32040,26076,60842607,31832688
Spain,2022-06-24,93581048,93581048,45797,https://www.sanidad.gob.es/profesionales/saludPublica/ccayes/alertasActual/nCov/pruebasRealizadas.htm,44427888,18558969,0,0,0.4486883697902977,25248,20549,60867855,31853237
Spain,2022-06-25,93613271,93613271,32223,https://www.sanidad.gob.es/profesionales/saludPublica/ccayes/alertasActual/nCov/pruebasRealizadas.htm,44427888,18558969,0,0,0.4486883697902977,17765,14458,60885620,31867695
Spain,2022-06-26,93640499,93640499,27228,https://www.sanidad.gob.es/profesionales/saludPublica/ccayes/alertasActual/nCov/pruebasRealizadas.htm,44427888,18558969,0,0,0.4486883697902977,15011,12217,60900631,31879912
Spain,2022-06-27,93722274,93722274,81775,https://www.sanidad.gob.es/profesionales/saludPublica/ccayes/alertasActual/nCov/pruebasRealizadas.htm,44427888,18558969,0,0,0.4486883697902977,45084,36691,60945715,31916603
Spain,2022-06-28,93794869,93794869,72595,https://www.sanidad.gob.es/profesionales/saludPublica/ccayes/alertasActual/nCov/pruebasRealizadas.htm,44427888,18558969,0,0,0.4486883697902977,40022,32573,60985737,31949176
Spain,2022-06-29,93860455,93860455,65586,https://www.sanidad.gob.es/profesionales/saludPublica/ccayes/alertasActual/nCov/pruebasRealizadas.htm,44427888,18558969,0,0,0.4486883697902977,36158,29428,61021895,31978604
Spain,2022-06-30,93918746,93918746,58291,https://www.sanidad.gob.es/profesionales/saludPublica/ccayes/alertasActual/nCov/pruebasRealizadas.htm,44427888,18558969,0,0,0.4486883697902977,32137,26154,61054032,32004758
Spain,2022-07-01,93953638,93953638,34892,https://www.sanidad.gob.es/profesionales/saludPublica/ccayes/alertasActual/nCov/pruebasRealizadas.htm,44427888,18558969,0,0,0.4486883697902977,19236,15656,61073268,32020414
Spain,2022-07-02,93968398,93968398,14760,https://www.sanidad.gob.es/profesionales/saludPublica/ccayes/alertasActual/nCov/pruebasRealizadas.htm,44427888,18558969,0,0,0.4486883697902977,8137,6623,61081405,32027037
Spain,2022-07-03,93968398,93968398,0,https://www.sanidad.gob.es/profesionales/saludPublica/ccayes/alertasActual/nCov/pruebasRealizadas.htm,44427888,18558969,0,0,0.4486883697902977,0,0,61081405,32027037
Spain,2022-07-04,93968398,93968398,0,https://www.sanidad.gob.es/profesionales/saludPublica/ccayes/alertasActual/nCov/pruebasRealizadas.htm,59504281,34464117,15076393,15905148,0.5133749802826141,0,0,61081405,32027037
Spain,2022-07-05,94168866,94168866,200468,https://www.sanidad.gob.es/profesionales/saludPublica/ccayes/alertasActual/nCov/pruebasRealizadas.htm,59584900,34583966,80619,119849,0.597846040265778,80619,119849,61162024,32146886
Spain,2022-07-06,94254819,94254819,85953,https://www.sanidad.gob.es/profesionales/saludPublica/ccayes/alertasActual/nCov/pruebasRealizadas.htm,59615838,34638981,30938,55015,0.6400591020674089,30938,55015,61192962,32201901
Spain,2022-07-07,94327788,94327788,72969,https://www.sanidad.gob.es/profesionales/saludPublica/ccayes/alertasActual/nCov/pruebasRealizadas.htm,59642751,34685037,26913,46056,0.6311721415943757,26913,46056,61219875,32247957
Spain,2022-07-08,94397982,94397982,70194,https://www.sanidad.gob.es/profesionales/saludPublica/ccayes/alertasActual/nCov/pruebasRealizadas.htm,59670389,34727593,27638,42556,0.6062626435307861,27638,42556,61247513,32290513
Spain,2022-07-09,94397982,94397982,0,https://www.sanidad.gob.es/profesionales/saludPublica/ccayes/alertasActual/nCov/pruebasRealizadas.htm,59670389,34727593,0,0,0.6062626435307861,0,0,61247513,32290513
Spain,2022-07-10,94397982,94397982,0,https://www.sanidad.gob.es/profesionales/saludPublica/ccayes/alertasActual/nCov/pruebasRealizadas.htm,59670389,34727593,0,0,0.6062626435307861,0,0,61247513,32290513
Spain,2022-07-11,94515685,94515685,117703,https://www.sanidad.gob.es/profesionales/saludPublica/ccayes/alertasActual/nCov/pruebasRealizadas.htm,59713543,34802142,43154,74549,0.6333653347833106,43154,74549,61290667,32365062
Spain,2022-07-12,94574884,94574884,59199,https://www.sanidad.gob.es/profesionales/saludPublica/ccayes/alertasActual/nCov/pruebasRealizadas.htm,59737372,34837512,23829,35370,0.5974763087214311,23829,35370,61314496,32400432
Spain,2022-07-13,94655428,94655428,80544,https://www.sanidad.gob.es/profesionales/saludPublica/ccayes/alertasActual/nCov/pruebasRealizadas.htm,59766475,34888953,29103,51441,0.638669547079857,29103,51441,61343599,32451873
Spain,2022-07-14,94693195,94693195,37767,https://www.sanidad.gob.es/profesionales/saludPublica/ccayes/alertasActual/nCov/pruebasRealizadas.htm,59784379,34908816,17904,19863,0.5259353403765192,17904,19863,61361503,32471736
Spain,2022-07-15,94776895,94776895,83700,https://www.sanidad.gob.es/profesionales/saludPublica/ccayes/alertasActual/nCov/pruebasRealizadas.htm,59815162,34961733,30783,52917,0.6322222222222222,30783,52917,61392286,32524653
Spain,2022-07-16,94776895,94776895,0,https://www.sanidad.gob.es/profesionales/saludPublica/ccayes/alertasActual/nCov/pruebasRealizadas.htm,59815162,34961733,0,0,0.6322222222222222,0,0,61392286,32524653
Spain,2022-07-17,94776895,94776895,0,https://www.sanidad.gob.es/profesionales/saludPublica/ccayes/alertasActual/nCov/pruebasRealizadas.htm,59815162,34961733,0,0,0.6322222222222222,0,0,61392286,32524653
Spain,2022-07-18,94874533,94874533,97638,https://www.sanidad.gob.es/profesionales/saludPublica/ccayes/alertasActual/nCov/pruebasRealizadas.htm,59857776,35016757,42614,55024,0.5635510764251623,42614,55024,61434900,32579677
Spain,2022-07-19,94922833,94922833,48300,https://www.sanidad.gob.es/profesionales/saludPublica/ccayes/alertasActual/nCov/pruebasRealizadas.htm,59878365,35044468,20589,27711,0.5737267080745342,20589,27711,61455489,32607388
Spain,2022-07-20,94982204,94982204,59371,https://www.sanidad.gob.es/profesionales/saludPublica/ccayes/alertasActual/nCov/pruebasRealizadas.htm,59903096,35079108,24731,34640,0.5834498324097623,24731,34640,61480220,32642028
Spain,2022-07-21,95028200,95028200,45996,https://www.sanidad.gob.es/profesionales/saludPublica/ccayes/alertasActual/nCov/pruebasRealizadas.htm,59924808,35103392,21712,24284,0.5279589529524307,21712,24284,61501932,32666312
Spain,2022-07-22,95078012,95078012,49812,https://www.sanidad.gob.es/profesionales/saludPublica/ccayes/alertasActual/nCov/pruebasRealizadas.htm,59945380,35132632,20572,29240,0.5870071468722396,20572,29240,61522504,32695552
Spain,2022-07-23,95078012,95078012,0,https://www.sanidad.gob.es/profesionales/saludPublica/ccayes/alertasActual/nCov/pruebasRealizadas.htm,59945380,35132632,0,0,0.5870071468722396,0,0,61522504,32695552
Spain,2022-07-24,95078012,95078012,0,https://www.sanidad.gob.es/profesionales/saludPublica/ccayes/alertasActual/nCov/pruebasRealizadas.htm,59945380,35132632,0,0,0.5870071468722396,0,0,61522504,32695552
Spain,2022-07-25,95078012,95078012,0,https://www.sanidad.gob.es/profesionales/saludPublica/ccayes/alertasActual/nCov/pruebasRealizadas.htm,59945380,35132632,0,0,0.5870071468722396,0,0,61522504,32695552
Spain,2022-07-26,95443012,95443012,365000,https://www.sanidad.gob.es/profesionales/saludPublica/ccayes/alertasActual/nCov/pruebasRealizadas.htm,60152433,35290579,207053,157947,0.43273150684931505,207053,157947,61729557,32853499
Spain,2022-07-27,95485574,95485574,42562,https://www.sanidad.gob.es/profesionales/saludPublica/ccayes/alertasActual/nCov/pruebasRealizadas.htm,60169848,35315726,17415,25147,0.5908321977350688,17415,25147,61746972,32878646
Spain,2022-07-28,95527214,95527214,41640,https://www.sanidad.gob.es/profesionales/saludPublica/ccayes/alertasActual/nCov/pruebasRealizadas.htm,60188826,35338388,18978,22662,0.5442363112391931,18978,22662,61765950,32901308
Spain,2022-07-29,95569401,95569401,42187,https://www.sanidad.gob.es/profesionales/saludPublica/ccayes/alertasActual/nCov/pruebasRealizadas.htm,60207806,35361595,18980,23207,0.5500983715362553,18980,23207,61784930,32924515
Spain,2022-07-30,95569401,95569401,0,https://www.sanidad.gob.es/profesionales/saludPublica/ccayes/alertasActual/nCov/pruebasRealizadas.htm,60207806,35361595,0,0,0.5500983715362553,0,0,61784930,32924515
Spain,2022-07-31,95569401,95569401,0,https://www.sanidad.gob.es/profesionales/saludPublica/ccayes/alertasActual/nCov/pruebasRealizadas.htm,60207806,35361595,0,0,0.5500983715362553,0,0,61784930,32924515
Spain,2022-08-01,95640236,95640236,70835,https://www.sanidad.gob.es/profesionales/saludPublica/ccayes/alertasActual/nCov/pruebasRealizadas.htm,60238437,35401799,30631,40204,0.5675725277052305,30631,40204,61815561,32964719
Spain,2022-08-02,95675016,95675016,34780,https://www.sanidad.gob.es/profesionales/saludPublica/ccayes/alertasActual/nCov/pruebasRealizadas.htm,60254619,35420397,16182,18598,0.5347326049453709,16182,18598,61831743,32983317
Spain,2022-08-03,95713062,95713062,38046,https://www.sanidad.gob.es/profesionales/saludPublica/ccayes/alertasActual/nCov/pruebasRealizadas.htm,60274536,35438526,19917,18129,0.4765021290017347,19917,18129,61851660,33001446
Spain,2022-08-04,95752146,95752146,39084,https://www.sanidad.gob.es/profesionales/saludPublica/ccayes/alertasActual/nCov/pruebasRealizadas.htm,60293254,35458892,18718,20366,0.5210827960290656,18718,20366,61870378,33021812
Spain,2022-08-05,95787626,95787626,35480,https://www.sanidad.gob.es/profesionales/saludPublica/ccayes/alertasActual/nCov/pruebasRealizadas.htm,60310035,35477591,16781,18699,0.5270293122886133,16781,18699,61887159,33040511
Spain,2022-08-06,95787626,95787626,0,https://www.sanidad.gob.es/profesionales/saludPublica/ccayes/alertasActual/nCov/pruebasRealizadas.htm,60310035,35477591,0,0,0.5270293122886133,0,0,61887159,33040511
Spain,2022-08-07,95787626,95787626,0,https://www.sanidad.gob.es/profesionales/saludPublica/ccayes/alertasActual/nCov/pruebasRealizadas.htm,60310035,35477591,0,0,0.5270293122886133,0,0,61887159,33040511
Spain,2022-08-08,95846067,95846067,58441,https://www.sanidad.gob.es/profesionales/saludPublica/ccayes/alertasActual/nCov/pruebasRealizadas.htm,60335147,35510920,25112,33329,0.5703016717715302,25112,33329,61912271,33073840
Spain,2022-08-09,95878339,95878339,32272,https://www.sanidad.gob.es/profesionales/saludPublica/ccayes/alertasActual/nCov/pruebasRealizadas.htm,60350857,35527482,15710,16562,0.5132002974714923,15710,16562,61927981,33090402
Spain,2022-08-10,95910590,95910590,32251,https://www.sanidad.gob.es/profesionales/saludPublica/ccayes/alertasActual/nCov/pruebasRealizadas.htm,60366803,35543787,15946,16305,0.5055657188924374,15946,16305,61943927,33106707
Spain,2022-08-11,95951871,95951871,41281,https://www.sanidad.gob.es/profesionales/saludPublica/ccayes/alertasActual/nCov/pruebasRealizadas.htm,60382949,35568922,16146,25135,0.608875753978828,16146,25135,61960073,33131842
Spain,2022-08-12,95993606,95993606,41735,https://www.sanidad.gob.es/profesionales/saludPublica/ccayes/alertasActual/nCov/pruebasRealizadas.htm,60402481,35591125,19532,22203,0.5319995207859111,19532,22203,61979605,33154045
Spain,2022-08-13,95993606,95993606,0,https://www.sanidad.gob.es/profesionales/saludPublica/ccayes/alertasActual/nCov/pruebasRealizadas.htm,60402481,35591125,0,0,0.5319995207859111,0,0,61979605,33154045
Spain,2022-08-14,95993606,95993606,0,https://www.sanidad.gob.es/profesionales/saludPublica/ccayes/alertasActual/nCov/pruebasRealizadas.htm,60402481,35591125,0,0,0.5319995207859111,0,0,61979605,33154045
Spain,2022-08-15,95993606,95993606,0,https://www.sanidad.gob.es/profesionales/saludPublica/ccayes/alertasActual/nCov/pruebasRealizadas.htm,60402481,35591125,0,0,0.5319995207859111,0,0,61979605,33154045
Spain,2022-08-16,96016075,96016075,22469,https://www.sanidad.gob.es/profesionales/saludPublica/ccayes/alertasActual/nCov/pruebasRealizadas.htm,60412708,35603367,10227,12242,0.5448395567225955,10227,12242,61989832,33166287
Spain,2022-08-17,96088792,96088792,72717,https://www.sanidad.gob.es/profesionales/saludPublica/ccayes/alertasActual/nCov/pruebasRealizadas.htm,60446852,35641940,34144,38573,0.5304536765818172,34144,38573,62023976,33204860
Spain,2022-08-18,96133458,96133458,44666,https://www.sanidad.gob.es/profesionales/saludPublica/ccayes/alertasActual/nCov/pruebasRealizadas.htm,60462278,35671180,15426,29240,0.654636636367707,15426,29240,62039402,33234100
Spain,2022-08-19,96163812,96163812,30354,https://www.sanidad.gob.es/profesionales/saludPublica/ccayes/alertasActual/nCov/pruebasRealizadas.htm,60477157,35686655,14879,15475,0.509817486986888,14879,15475,62054281,33249575
Spain,2022-08-20,96163812,96163812,0,https://www.sanidad.gob.es/profesionales/saludPublica/ccayes/alertasActual/nCov/pruebasRealizadas.htm,60477157,35686655,0,0,0.509817486986888,0,0,62054281,33249575
Spain,2022-08-21,96163812,96163812,0,https://www.sanidad.gob.es/profesionales/saludPublica/ccayes/alertasActual/nCov/pruebasRealizadas.htm,60477157,35686655,0,0,0.509817486986888,0,0,62054281,33249575
Spain,2022-08-22,96212575,96212575,48763,https://www.sanidad.gob.es/profesionales/saludPublica/ccayes/alertasActual/nCov/pruebasRealizadas.htm,60498942,35713633,21785,26978,0.5532473391710928,21785,26978,62076066,33276553
Spain,2022-08-23,96212575,96212575,0,https://www.sanidad.gob.es/profesionales/saludPublica/ccayes/alertasActual/nCov/pruebasRealizadas.htm,60498942,35713633,0,0,0.5532473391710928,0,0,62076066,33276553
Spain,2022-08-24,96271817,96271817,59242,https://www.sanidad.gob.es/profesionales/saludPublica/ccayes/alertasActual/nCov/pruebasRealizadas.htm,60526548,35745269,27606,31636,0.5340130312953648,27606,31636,62103672,33308189
Spain,2022-08-25,96296122,96296122,24305,https://www.sanidad.gob.es/profesionales/saludPublica/ccayes/alertasActual/nCov/pruebasRealizadas.htm,60538495,35757627,11947,12358,0.508455050401152,11947,12358,62115619,33320547
Spain,2022-08-26,96323976,96323976,27854,https://www.sanidad.gob.es/profesionales/saludPublica/ccayes/alertasActual/nCov/pruebasRealizadas.htm,60551508,35772468,13013,14841,0.5328139584978818,13013,14841,62128632,33335388
Spain,2022-08-27,96323976,96323976,0,https://www.sanidad.gob.es/profesionales/saludPublica/ccayes/alertasActual/nCov/pruebasRealizadas.htm,60551508,35772468,0,0,0.5328139584978818,0,0,62128632,33335388
Spain,2022-08-28,96323976,96323976,0,https://www.sanidad.gob.es/profesionales/saludPublica/ccayes/alertasActual/nCov/pruebasRealizadas.htm,60551508,35772468,0,0,0.5328139584978818,0,0,62128632,33335388
Spain,2022-08-29,96370142,96370142,46166,https://www.sanidad.gob.es/profesionales/saludPublica/ccayes/alertasActual/nCov/pruebasRealizadas.htm,60573172,35796970,21664,24502,0.5307369059481003,21664,24502,62150296,33359890
Spain,2022-08-30,96395173,96395173,25031,https://www.sanidad.gob.es/profesionales/saludPublica/ccayes/alertasActual/nCov/pruebasRealizadas.htm,60585118,35810055,11946,13085,0.5227517877831489,11946,13085,62162242,33372975
Spain,2022-08-31,96427443,96427443,32270,https://www.sanidad.gob.es/profesionales/saludPublica/ccayes/alertasActual/nCov/pruebasRealizadas.htm,60600563,35826880,15445,16825,0.5213820886272079,15445,16825,62177687,33389800
Spain,2022-09-01,96455868,96455868,28425,https://www.sanidad.gob.es/profesionales/saludPublica/ccayes/alertasActual/nCov/pruebasRealizadas.htm,60614090,35841778,13527,14898,0.5241160949868073,13527,14898,62191214,33404698
Spain,2022-09-02,96491921,96491921,36053,https://www.sanidad.gob.es/profesionales/saludPublica/ccayes/alertasActual/nCov/pruebasRealizadas.htm,60633659,35858262,19569,16484,0.45721576567830696,19569,16484,62210783,33421182
Spain,2022-09-03,96491921,96491921,0,https://www.sanidad.gob.es/profesionales/saludPublica/ccayes/alertasActual/nCov/pruebasRealizadas.htm,60633659,35858262,0,0,0.45721576567830696,0,0,62210783,33421182
Spain,2022-09-04,96491921,96491921,0,https://www.sanidad.gob.es/profesionales/saludPublica/ccayes/alertasActual/nCov/pruebasRealizadas.htm,60633659,35858262,0,0,0.45721576567830696,0,0,62210783,33421182
Spain,2022-09-05,96541257,96541257,49336,https://www.sanidad.gob.es/profesionales/saludPublica/ccayes/alertasActual/nCov/pruebasRealizadas.htm,60655767,35885490,22108,27228,0.5518890870763743,22108,27228,62232891,33448410
Spain,2022-09-06,96568420,96568420,27163,https://www.sanidad.gob.es/profesionales/saludPublica/ccayes/alertasActual/nCov/pruebasRealizadas.htm,60669342,35899078,13575,13588,0.5002392961013142,13575,13588,62246466,33461998
Spain,2022-09-07,96597135,96597135,28715,https://www.sanidad.gob.es/profesionales/saludPublica/ccayes/alertasActual/nCov/pruebasRealizadas.htm,60683988,35913147,14646,14069,0.48995298624412326,14646,14069,62261112,33476067
Spain,2022-09-08,96621965,96621965,24830,https://www.sanidad.gob.es/profesionales/saludPublica/ccayes/alertasActual/nCov/pruebasRealizadas.htm,60696268,35925697,12280,12550,0.5054369714055578,12280,12550,62273392,33488617
Spain,2022-09-09,96647065,96647065,25100,https://www.sanidad.gob.es/profesionales/saludPublica/ccayes/alertasActual/nCov/pruebasRealizadas.htm,60709156,35937909,12888,12212,0.4865338645418327,12888,12212,62286280,33500829
Spain,2022-09-10,96647065,96647065,0,https://www.sanidad.gob.es/profesionales/saludPublica/ccayes/alertasActual/nCov/pruebasRealizadas.htm,60709156,35937909,0,0,0.4865338645418327,0,0,62286280,33500829
Spain,2022-09-11,96647065,96647065,0,https://www.sanidad.gob.es/profesionales/saludPublica/ccayes/alertasActual/nCov/pruebasRealizadas.htm,60709156,35937909,0,0,0.4865338645418327,0,0,62286280,33500829
Spain,2022-09-12,96746273,96746273,99208,https://www.sanidad.gob.es/profesionales/saludPublica/ccayes/alertasActual/nCov/pruebasRealizadas.htm,60743332,36002941,34176,65032,0.655511652286106,34176,65032,62320456,33565861
Spain,2022-09-13,96771619,96771619,25346,https://www.sanidad.gob.es/profesionales/saludPublica/ccayes/alertasActual/nCov/pruebasRealizadas.htm,60755073,36016546,11741,13605,0.5367710881401404,11741,13605,62332197,33579466
Spain,2022-09-14,96800351,96800351,28732,https://www.sanidad.gob.es/profesionales/saludPublica/ccayes/alertasActual/nCov/pruebasRealizadas.htm,60769051,36031300,13978,14754,0.5135041069191145,13978,14754,62346175,33594220
Spain,2022-09-15,96896540,96896540,96189,https://www.sanidad.gob.es/profesionales/saludPublica/ccayes/alertasActual/nCov/pruebasRealizadas.htm,60818191,36078349,49140,47049,0.4891307737891027,49140,47049,62395315,33641269
Spain,2022-09-16,96925367,96925367,28827,https://www.sanidad.gob.es/profesionales/saludPublica/ccayes/alertasActual/nCov/pruebasRealizadas.htm,60833225,36092142,15034,13793,0.47847504076039826,15034,13793,62410349,33655062
Spain,2022-09-17,96925367,96925367,0,https://www.sanidad.gob.es/profesionales/saludPublica/ccayes/alertasActual/nCov/pruebasRealizadas.htm,60833225,36092142,0,0,0.47847504076039826,0,0,62410349,33655062
Spain,2022-09-18,96925367,96925367,0,https://www.sanidad.gob.es/profesionales/saludPublica/ccayes/alertasActual/nCov/pruebasRealizadas.htm,60833225,36092142,0,0,0.47847504076039826,0,0,62410349,33655062
Spain,2022-09-19,96971408,96971408,46041,https://www.sanidad.gob.es/profesionales/saludPublica/ccayes/alertasActual/nCov/pruebasRealizadas.htm,60855192,36116216,21967,24074,0.522881779283682,21967,24074,62432316,33679136
Spain,2022-09-20,96993494,96993494,22086,https://www.sanidad.gob.es/profesionales/saludPublica/ccayes/alertasActual/nCov/pruebasRealizadas.htm,60867515,36125979,12323,9763,0.44204473422077334,12323,9763,62444639,33688899
Spain,2022-09-21,97026090,97026090,32596,https://www.sanidad.gob.es/profesionales/saludPublica/ccayes/alertasActual/nCov/pruebasRealizadas.htm,60882074,36144016,14559,18037,0.5533501043072769,14559,18037,62459198,33706936
Spain,2022-09-22,97052755,97052755,26665,https://www.sanidad.gob.es/profesionales/saludPublica/ccayes/alertasActual/nCov/pruebasRealizadas.htm,60895214,36157541,13140,13525,0.507219201200075,13140,13525,62472338,33720461
Spain,2022-09-23,97073315,97073315,20560,https://www.sanidad.gob.es/profesionales/saludPublica/ccayes/alertasActual/nCov/pruebasRealizadas.htm,60905035,36168280,9821,10739,0.5223249027237354,9821,10739,62482159,33731200
Spain,2022-09-24,97073315,97073315,0,https://www.sanidad.gob.es/profesionales/saludPublica/ccayes/alertasActual/nCov/pruebasRealizadas.htm,60905035,36168280,0,0,0.5223249027237354,0,0,62482159,33731200
Spain,2022-09-25,97073315,97073315,0,https://www.sanidad.gob.es/profesionales/saludPublica/ccayes/alertasActual/nCov/pruebasRealizadas.htm,60905035,36168280,0,0,0.5223249027237354,0,0,62482159,33731200
Spain,2022-09-26,97117932,97117932,44617,https://www.sanidad.gob.es/profesionales/saludPublica/ccayes/alertasActual/nCov/pruebasRealizadas.htm,60927858,36190074,22823,21794,0.4884685209673443,22823,21794,62504982,33752994
Spain,2022-09-27,97141555,97141555,23623,https://www.sanidad.gob.es/profesionales/saludPublica/ccayes/alertasActual/nCov/pruebasRealizadas.htm,60940864,36200691,13006,10617,0.449434872793464,13006,10617,62517988,33763611
Spain,2022-09-28,97170635,97170635,29080,https://www.sanidad.gob.es/profesionales/saludPublica/ccayes/alertasActual/nCov/pruebasRealizadas.htm,60955105,36215530,14241,14839,0.5102819807427785,14241,14839,62532229,33778450
Spain,2022-09-29,97193281,97193281,22646,https://www.sanidad.gob.es/profesionales/saludPublica/ccayes/alertasActual/nCov/pruebasRealizadas.htm,60966614,36226667,11509,11137,0.4917866289852513,11509,11137,62543738,33789587
Spain,2022-09-30,97220610,97220610,27329,https://www.sanidad.gob.es/profesionales/saludPublica/ccayes/alertasActual/nCov/pruebasRealizadas.htm,60979773,36240837,13159,14170,0.5184968348640638,13159,14170,62556897,33803757
Spain,2022-10-01,97220610,97220610,0,https://www.sanidad.gob.es/profesionales/saludPublica/ccayes/alertasActual/nCov/pruebasRealizadas.htm,60979773,36240837,0,0,0.5184968348640638,0,0,62556897,33803757
Spain,2022-10-02,97220610,97220610,0,https://www.sanidad.gob.es/profesionales/saludPublica/ccayes/alertasActual/nCov/pruebasRealizadas.htm,60979773,36240837,0,0,0.5184968348640638,0,0,62556897,33803757
Spain,2022-10-03,97261300,97261300,40690,https://www.sanidad.gob.es/profesionales/saludPublica/ccayes/alertasActual/nCov/pruebasRealizadas.htm,60999181,36262119,19408,21282,0.5230277709510937,19408,21282,62576305,33825039
Spain,2022-10-04,97291775,97291775,30475,https://www.sanidad.gob.es/profesionales/saludPublica/ccayes/alertasActual/nCov/pruebasRealizadas.htm,61014164,36277611,14983,15492,0.5083511074651353,14983,15492,62591288,33840531
Spain,2022-10-05,97319273,97319273,27498,https://www.sanidad.gob.es/profesionales/saludPublica/ccayes/alertasActual/nCov/pruebasRealizadas.htm,61026769,36292504,12605,14893,0.5416030256745945,12605,14893,62603893,33855424
Spain,2022-10-06,97348753,97348753,29480,https://www.sanidad.gob.es/profesionales/saludPublica/ccayes/alertasActual/nCov/pruebasRealizadas.htm,61041155,36307598,14386,15094,0.5120081411126187,14386,15094,62618279,33870518
Spain,2022-10-07,97371142,97371142,22389,https://www.sanidad.gob.es/profesionales/saludPublica/ccayes/alertasActual/nCov/pruebasRealizadas.htm,61052505,36318637,11350,11039,0.4930546250390817,11350,11039,62629629,33881557
Spain,2022-10-08,97371142,97371142,0,https://www.sanidad.gob.es/profesionales/saludPublica/ccayes/alertasActual/nCov/pruebasRealizadas.htm,61052505,36318637,0,0,0.4930546250390817,0,0,62629629,33881557
Spain,2022-10-09,97371142,97371142,0,https://www.sanidad.gob.es/profesionales/saludPublica/ccayes/alertasActual/nCov/pruebasRealizadas.htm,61052505,36318637,0,0,0.4930546250390817,0,0,62629629,33881557
Spain,2022-10-10,97451595,97451595,80453,https://www.sanidad.gob.es/profesionales/saludPublica/ccayes/alertasActual/nCov/pruebasRealizadas.htm,61075804,36375791,23299,57154,0.7104023467117447,23299,57154,62652928,33938711
Spain,2022-10-11,97475328,97475328,23733,https://www.sanidad.gob.es/profesionales/saludPublica/ccayes/alertasActual/nCov/pruebasRealizadas.htm,61087462,36387866,11658,12075,0.5087852357476931,11658,12075,62664586,33950786
Spain,2022-10-12,97475328,97475328,0,https://www.sanidad.gob.es/profesionales/saludPublica/ccayes/alertasActual/nCov/pruebasRealizadas.htm,61087462,36387866,0,0,0.5087852357476931,0,0,62664586,33950786
Spain,2022-10-13,97522198,97522198,46870,https://www.sanidad.gob.es/profesionales/saludPublica/ccayes/alertasActual/nCov/pruebasRealizadas.htm,61109045,36413153,21583,25287,0.5395135481117986,21583,25287,62686169,33976073
Spain,2022-10-14,97548376,97548376,26178,https://www.sanidad.gob.es/profesionales/saludPublica/ccayes/alertasActual/nCov/pruebasRealizadas.htm,61121340,36427036,12295,13883,0.5303308121323248,12295,13883,62698464,33989956
Spain,2022-10-15,97548376,97548376,0,https://www.sanidad.gob.es/profesionales/saludPublica/ccayes/alertasActual/nCov/pruebasRealizadas.htm,61121340,36427036,0,0,0.5303308121323248,0,0,62698464,33989956
Spain,2022-10-16,97548376,97548376,0,https://www.sanidad.gob.es/profesionales/saludPublica/ccayes/alertasActual/nCov/pruebasRealizadas.htm,61121340,36427036,0,0,0.5303308121323248,0,0,62698464,33989956
Spain,2022-10-17,97604906,97604906,56530,https://www.sanidad.gob.es/profesionales/saludPublica/ccayes/alertasActual/nCov/pruebasRealizadas.htm,61149765,36455141,28425,28105,0.49716964443658235,28425,28105,62726889,34018061
Spain,2022-10-18,97630265,97630265,25359,https://www.sanidad.gob.es/profesionales/saludPublica/ccayes/alertasActual/nCov/pruebasRealizadas.htm,61162537,36467728,12772,12587,0.4963523798257029,12772,12587,62739661,34030648
Spain,2022-10-19,97659324,97659324,29059,https://www.sanidad.gob.es/profesionales/saludPublica/ccayes/alertasActual/nCov/pruebasRealizadas.htm,61176034,36483290,13497,15562,0.5355311607419388,13497,15562,62753158,34046210
Spain,2022-10-20,97684719,97684719,25395,https://www.sanidad.gob.es/profesionales/saludPublica/ccayes/alertasActual/nCov/pruebasRealizadas.htm,61187477,36497242,11443,13952,0.5493994880882064,11443,13952,62764601,34060162
Spain,2022-10-21,97715033,97715033,30314,https://www.sanidad.gob.es/profesionales/saludPublica/ccayes/alertasActual/nCov/pruebasRealizadas.htm,61203017,36512016,15540,14774,0.48736557366233424,15540,14774,62780141,34074936
Spain,2022-10-22,97715033,97715033,0,https://www.sanidad.gob.es/profesionales/saludPublica/ccayes/alertasActual/nCov/pruebasRealizadas.htm,61203017,36512016,0,0,0.48736557366233424,0,0,62780141,34074936
Spain,2022-10-23,97715033,97715033,0,https://www.sanidad.gob.es/profesionales/saludPublica/ccayes/alertasActual/nCov/pruebasRealizadas.htm,61203017,36512016,0,0,0.48736557366233424,0,0,62780141,34074936
Spain,2022-10-24,97753024,97753024,37991,https://www.sanidad.gob.es/profesionales/saludPublica/ccayes/alertasActual/nCov/pruebasRealizadas.htm,61222977,36530047,19960,18031,0.47461240820194256,19960,18031,62800101,34092967
Spain,2022-10-25,97790957,97790957,37933,https://www.sanidad.gob.es/profesionales/saludPublica/ccayes/alertasActual/nCov/pruebasRealizadas.htm,61238990,36551967,16013,21920,0.577860965386339,16013,21920,62816114,34114887
Spain,2022-10-26,97821461,97821461,30504,https://www.sanidad.gob.es/profesionales/saludPublica/ccayes/alertasActual/nCov/pruebasRealizadas.htm,61253099,36568362,14109,16395,0.5374704956726987,14109,16395,62830223,34131282
Spain,2022-10-27,97848581,97848581,27120,https://www.sanidad.gob.es/profesionales/saludPublica/ccayes/alertasActual/nCov/pruebasRealizadas.htm,61266171,36582410,13072,14048,0.5179941002949853,13072,14048,62843295,34145330
Spain,2022-10-28,97873835,97873835,25254,https://www.sanidad.gob.es/profesionales/saludPublica/ccayes/alertasActual/nCov/pruebasRealizadas.htm,61278080,36595755,11909,13345,0.52843113962144606,11909,13345,62855204,34158675
Spain,2022-10-29,97873835,97873835,0,https://www.sanidad.gob.es/profesionales/saludPublica/ccayes/alertasActual/nCov/pruebasRealizadas.htm,61278080,36595755,0,0,0.52843113962144606,0,0,62855204,34158675
Spain,2022-10-30,97873835,97873835,0,https://www.sanidad.gob.es/profesionales/saludPublica/ccayes/alertasActual/nCov/pruebasRealizadas.htm,61278080,36595755,0,0,0.52843113962144606,0,0,62855204,34158675
Spain,2022-10-31,97914189,97914189,40354,https://www.sanidad.gob.es/profesionales/saludPublica/ccayes/alertasActual/nCov/pruebasRealizadas.htm,61298022,36616167,19942,20412,0.5058234623581306,19942,20412,62875146,34179087
Spain,2022-11-01,97914189,97914189,0,https://www.sanidad.gob.es/profesionales/saludPublica/ccayes/alertasActual/nCov/pruebasRealizadas.htm,61298022,36616167,0,0,0.5058234623581306,0,0,62875146,34179087
Spain,2022-11-02,97957988,97957988,43799,https://www.sanidad.gob.es/profesionales/saludPublica/ccayes/alertasActual/nCov/pruebasRealizadas.htm,61318620,36639368,20598,23201,0.5297152903034316,20598,23201,62895744,34202288
Spain,2022-11-03,97979754,97979754,21766,https://www.sanidad.gob.es/profesionales/saludPublica/ccayes/alertasActual/nCov/pruebasRealizadas.htm,61330202,36649552,11582,10184,0.4678856932831021,11582,10184,62907326,34212472
Spain,2022-11-04,98004113,98004113,24359,https://www.sanidad.gob.es/profesionales/saludPublica/ccayes/alertasActual/nCov/pruebasRealizadas.htm,61341999,36662114,11797,12562,0.5157026150498789,11797,12562,62919123,34225034
Spain,2022-11-05,98004113,98004113,0,https://www.sanidad.gob.es/profesionales/saludPublica/ccayes/alertasActual/nCov/pruebasRealizadas.htm,61341999,36662114,0,0,0.5157026150498789,0,0,62919123,34225034
Spain,2022-11-06,98004113,98004113,0,https://www.sanidad.gob.es/profesionales/saludPublica/ccayes/alertasActual/nCov/pruebasRealizadas.htm,61341999,36662114,0,0,0.5157026150498789,0,0,62919123,34225034
Spain,2022-11-07,98055352,98055352,51239,https://www.sanidad.gob.es/profesionales/saludPublica/ccayes/alertasActual/nCov/pruebasRealizadas.htm,61367018,36688334,25019,26220,0.5117195885946252,25019,26220,62944142,34251254
Spain,2022-11-08,98055352,98055352,0,https://www.sanidad.gob.es/profesionales/saludPublica/ccayes/alertasActual/nCov/pruebasRealizadas.htm,61367018,36688334,0,0,0.5117195885946252,0,0,62944142,34251254
Spain,2022-11-09,98055352,98055352,0,https://www.sanidad.gob.es/profesionales/saludPublica/ccayes/alertasActual/nCov/pruebasRealizadas.htm,61367018,36688334,0,0,0.5117195885946252,0,0,62944142,34251254
Spain,2022-11-10,98133990,98133990,78638,https://www.sanidad.gob.es/profesionales/saludPublica/ccayes/alertasActual/nCov/pruebasRealizadas.htm,61405749,36728241,38731,39907,0.5074773010503828,38731,39907,62982873,34291161
Spain,2022-11-11,98154975,98154975,20985,https://www.sanidad.gob.es/profesionales/saludPublica/ccayes/alertasActual/nCov/pruebasRealizadas.htm,61415424,36739551,9675,11310,0.5389563974267334,9675,11310,62992548,34302471
Spain,2022-11-12,98154975,98154975,0,https://www.sanidad.gob.es/profesionales/saludPublica/ccayes/alertasActual/nCov/pruebasRealizadas.htm,61415424,36739551,0,0,0.5389563974267334,0,0,62992548,34302471
Spain,2022-11-13,98154975,98154975,0,https://www.sanidad.gob.es/profesionales/saludPublica/ccayes/alertasActual/nCov/pruebasRealizadas.htm,61415424,36739551,0,0,0.5389563974267334,0,0,62992548,34302471
Spain,2022-11-14,98207901,98207901,52926,https://www.sanidad.gob.es/profesionales/saludPublica/ccayes/alertasActual/nCov/pruebasRealizadas.htm,61441765,36766136,26341,26585,0.5023051052412802,26341,26585,63018889,34329056
Spain,2022-11-15,98233016,98233016,25115,https://www.sanidad.gob.es/profesionales/saludPublica/ccayes/alertasActual/nCov/pruebasRealizadas.htm,61457349,36775667,15584,9531,0.37949432609994027,15584,9531,63034473,34338587
Spain,2022-11-16,98272440,98272440,39424,https://www.sanidad.gob.es/profesionales/saludPublica/ccayes/alertasActual/nCov/pruebasRealizadas.htm,61476057,36796383,18708,20716,0.5254667207792207,18708,20716,63053181,34359303
Spain,2022-11-17,98295815,98295815,23375,https://www.sanidad.gob.es/profesionales/saludPublica/ccayes/alertasActual/nCov/pruebasRealizadas.htm,61488087,36807728,12030,11345,0.4853475935828877,12030,11345,63065211,34370648
Spain,2022-11-18,98330210,98330210,34395,https://www.sanidad.gob.es/profesionales/saludPublica/ccayes/alertasActual/nCov/pruebasRealizadas.htm,61505127,36825083,17040,17355,0.5045791539467946,17040,17355,63082251,34388003
Spain,2022-11-19,98330210,98330210,0,https://www.sanidad.gob.es/profesionales/saludPublica/ccayes/alertasActual/nCov/pruebasRealizadas.htm,61505127,36825083,0,0,0.5045791539467946,0,0,63082251,34388003
Spain,2022-11-20,98330210,98330210,0,https://www.sanidad.gob.es/profesionales/saludPublica/ccayes/alertasActual/nCov/pruebasRealizadas.htm,61505127,36825083,0,0,0.5045791539467946,0,0,63082251,34388003
Spain,2022-11-21,98376642,98376642,46432,https://www.sanidad.gob.es/profesionales/saludPublica/ccayes/alertasActual/nCov/pruebasRealizadas.htm,61528553,36848089,23426,23006,0.49547725706409373,23426,23006,63105677,34411009
Spain,2022-11-22,98392141,98392141,15499,https://www.sanidad.gob.es/profesionales/saludPublica/ccayes/alertasActual/nCov/pruebasRealizadas.htm,61537103,36855038,8550,6949,0.4483515065488096,8550,6949,63114227,34417958
Spain,2022-11-23,98435044,98435044,42903,https://www.sanidad.gob.es/profesionales/saludPublica/ccayes/alertasActual/nCov/pruebasRealizadas.htm,61558305,36876739,21202,21701,0.5058154441414353,21202,21701,63135429,34439659
Spain,2022-11-24,98461847,98461847,26803,https://www.sanidad.gob.es/profesionales/saludPublica/ccayes/alertasActual/nCov/pruebasRealizadas.htm,61571432,36890415,13127,13676,0.5102413908890796,13127,13676,63148556,34453335
Spain,2022-11-25,98489993,98489993,28146,https://www.sanidad.gob.es/profesionales/saludPublica/ccayes/alertasActual/nCov/pruebasRealizadas.htm,61585348,36904645,13916,14230,0.5055780572727919,13916,14230,63162472,34467565
Spain,2022-11-26,98489993,98489993,0,https://www.sanidad.gob.es/profesionales/saludPublica/ccayes/alertasActual/nCov/pruebasRealizadas.htm,61585348,36904645,0,0,0.5055780572727919,0,0,63162472,34467565
Spain,2022-11-27,98489993,98489993,0,https://www.sanidad.gob.es/profesionales/saludPublica/ccayes/alertasActual/nCov/pruebasRealizadas.htm,61585348,36904645,0,0,0.5055780572727919,0,0,63162472,34467565
Spain,2022-11-28,98536119,98536119,46126,https://www.sanidad.gob.es/profesionales/saludPublica/ccayes/alertasActual/nCov/pruebasRealizadas.htm,61608629,36927490,23281,22845,0.49527381520183844,23281,22845,63185753,34490410
Spain,2022-11-29,98557996,98557996,21877,https://www.sanidad.gob.es/profesionales/saludPublica/ccayes/alertasActual/nCov/pruebasRealizadas.htm,61621437,36936559,12808,9069,0.4145449558897472,12808,9069,63198561,34499479
Spain,2022-11-30,98586513,98586513,28517,https://www.sanidad.gob.es/profesionales/saludPublica/ccayes/alertasActual/nCov/pruebasRealizadas.htm,61636781,36949732,15344,13173,0.4619349861486131,15344,13173,63213905,34512652
Spain,2022-12-01,98586513,98586513,0,https://www.sanidad.gob.es/profesionales/saludPublica/ccayes/alertasActual/nCov/pruebasRealizadas.htm,61636781,36949732,0,0,0.4619349861486131,0,0,63213905,34512652
Spain,2022-12-02,98586513,98586513,0,https://www.sanidad.gob.es/profesionales/saludPublica/ccayes/alertasActual/nCov/pruebasRealizadas.htm,61662385,36982163,25604,32431,0.5588179546825192,0,0,63213905,34512652
Spain,2022-12-03,98644548,98644548,58035,https://www.sanidad.gob.es/profesionales/saludPublica/ccayes/alertasActual/nCov/pruebasRealizadas.htm,61662385,36982163,0,0,0.5588179546825192,25604,32431,63239509,34545083
Spain,2022-12-04,98644548,98644548,0,https://www.sanidad.gob.es/profesionales/saludPublica/ccayes/alertasActual/nCov/pruebasRealizadas.htm,61662385,36982163,0,0,0.5588179546825192,0,0,63239509,34545083
Spain,2022-12-05,98695606,98695606,51058,https://www.sanidad.gob.es/profesionales/saludPublica/ccayes/alertasActual/nCov/pruebasRealizadas.htm,61686732,37008874,24347,26711,0.5231501429746562,24347,26711,63263856,34571794
Spain,2022-12-06,98695606,98695606,0,https://www.sanidad.gob.es/profesionales/saludPublica/ccayes/alertasActual/nCov/pruebasRealizadas.htm,61686732,37008874,0,0,0.5231501429746562,0,0,63263856,34571794
Spain,2022-12-07,98730126,98730126,34520,https://www.sanidad.gob.es/profesionales/saludPublica/ccayes/alertasActual/nCov/pruebasRealizadas.htm,61704439,37025687,17707,16813,0.4870509849362688,17707,16813,63281563,34588607
Spain,2022-12-08,98730126,98730126,0,https://www.sanidad.gob.es/profesionales/saludPublica/ccayes/alertasActual/nCov/pruebasRealizadas.htm,61704439,37025687,0,0,0.4870509849362688,0,0,63281563,34588607
Spain,2022-12-09,98775977,98775977,45851,https://www.sanidad.gob.es/profesionales/saludPublica/ccayes/alertasActual/nCov/pruebasRealizadas.htm,61725760,37050217,21321,24530,0.5349937842140847,21321,24530,63302884,34613137
Spain,2022-12-10,98775977,98775977,0,https://www.sanidad.gob.es/profesionales/saludPublica/ccayes/alertasActual/nCov/pruebasRealizadas.htm,61725760,37050217,0,0,0.5349937842140847,0,0,63302884,34613137
Spain,2022-12-11,98775977,98775977,0,https://www.sanidad.gob.es/profesionales/saludPublica/ccayes/alertasActual/nCov/pruebasRealizadas.htm,61725760,37050217,0,0,0.5349937842140847,0,0,63302884,34613137
Spain,2022-12-12,98820183,98820183,44206,https://www.sanidad.gob.es/profesionales/saludPublica/ccayes/alertasActual/nCov/pruebasRealizadas.htm,61749180,37071003,23420,20786,0.47020766411799303,23420,20786,63326304,34633923
Spain,2022-12-13,98849560,98849560,29377,https://www.sanidad.gob.es/profesionales/saludPublica/ccayes/alertasActual/nCov/pruebasRealizadas.htm,61764105,37085455,14925,14452,0.4919494842904313,14925,14452,63341229,34648375
Spain,2022-12-14,98887053,98887053,37493,https://www.sanidad.gob.es/profesionales/saludPublica/ccayes/alertasActual/nCov/pruebasRealizadas.htm,61782619,37104434,18514,18979,0.5062011575494092,18514,18979,63359743,34667354
Spain,2022-12-15,98916411,98916411,29358,https://www.sanidad.gob.es/profesionales/saludPublica/ccayes/alertasActual/nCov/pruebasRealizadas.htm,61797496,37118915,14877,14481,0.49325567136725934,14877,14481,63374620,34681835
Spain,2022-12-16,98944066,98944066,27655,https://www.sanidad.gob.es/profesionales/saludPublica/ccayes/alertasActual/nCov/pruebasRealizadas.htm,61811141,37132925,13645,14010,0.5065991683239921,13645,14010,63388265,34695845
Spain,2022-12-17,98944066,98944066,0,https://www.sanidad.gob.es/profesionales/saludPublica/ccayes/alertasActual/nCov/pruebasRealizadas.htm,61811141,37132925,0,0,0.5065991683239921,0,0,63388265,34695845
Spain,2022-12-18,98944066,98944066,0,https://www.sanidad.gob.es/profesionales/saludPublica/ccayes/alertasActual/nCov/pruebasRealizadas.htm,61811141,37132925,0,0,0.5065991683239921,0,0,63388265,34695845
Spain,2022-12-19,98990266,98990266,46200,https://www.sanidad.gob.es/profesionales/saludPublica/ccayes/alertasActual/nCov/pruebasRealizadas.htm,61834892,37155374,23751,22449,0.4859090909090909,23751,22449,63412016,34718294
Spain,2022-12-20,99014364,99014364,24098,https://www.sanidad.gob.es/profesionales/saludPublica/ccayes/alertasActual/nCov/pruebasRealizadas.htm,61847524,37166840,12632,11466,0.4758071209228982,12632,11466,63424648,34729760
Spain,2022-12-21,99014364,99014364,0,https://www.sanidad.gob.es/profesionales/saludPublica/ccayes/alertasActual/nCov/pruebasRealizadas.htm,61847524,37166840,0,0,0.4758071209228982,0,0,63424648,34729760
Spain,2022-12-22,99027555,99027555,13191,https://www.sanidad.gob.es/profesionales/saludPublica/ccayes/alertasActual/nCov/pruebasRealizadas.htm,61852195,37175360,4671,8520,0.6458949283602456,4671,8520,63429319,34738280
Spain,2022-12-23,99092785,99092785,65230,https://www.sanidad.gob.es/profesionales/saludPublica/ccayes/alertasActual/nCov/pruebasRealizadas.htm,61885771,37207014,33576,31654,0.48526751494711023,33576,31654,63462895,34769934
Spain,2022-12-24,99092785,99092785,0,https://www.sanidad.gob.es/profesionales/saludPublica/ccayes/alertasActual/nCov/pruebasRealizadas.htm,61885771,37207014,0,0,0.48526751494711023,0,0,63462895,34769934
Spain,2022-12-25,99092785,99092785,0,https://www.sanidad.gob.es/profesionales/saludPublica/ccayes/alertasActual/nCov/pruebasRealizadas.htm,61885771,37207014,0,0,0.48526751494711023,0,0,63462895,34769934
Spain,2022-12-26,99092785,99092785,0,https://www.sanidad.gob.es/profesionales/saludPublica/ccayes/alertasActual/nCov/pruebasRealizadas.htm,61885771,37207014,0,0,0.48526751494711023,0,0,63462895,34769934
Spain,2022-12-27,99152279,99152279,59494,https://www.sanidad.gob.es/profesionales/saludPublica/ccayes/alertasActual/nCov/pruebasRealizadas.htm,61915191,37237088,29420,30074,0.5054963525733688,29420,30074,63492315,34800008
Spain,2022-12-28,99166816,99166816,14537,https://www.sanidad.gob.es/profesionales/saludPublica/ccayes/alertasActual/nCov/pruebasRealizadas.htm,61923336,37243480,8145,6392,0.4397055788677169,8145,6392,63500460,34806400
Spain,2022-12-29,99203669,99203669,36853,https://www.sanidad.gob.es/profesionales/saludPublica/ccayes/alertasActual/nCov/pruebasRealizadas.htm,61939577,37264092,16241,20612,0.5593031774889425,16241,20612,63516701,34827012
Spain,2022-12-30,99227757,99227757,24088,https://www.sanidad.gob.es/profesionales/saludPublica/ccayes/alertasActual/nCov/pruebasRealizadas.htm,61950880,37276877,11303,12785,0.5307622052474261,11303,12785,63528004,34839797
Spain,2022-12-31,99227757,99227757,0,https://www.sanidad.gob.es/profesionales/saludPublica/ccayes/alertasActual/nCov/pruebasRealizadas.htm,61950880,37276877,0,0,0.5307622052474261,0,0,63528004,34839797
Spain,2023-01-01,99227757,99227757,0,https://www.sanidad.gob.es/profesionales/saludPublica/ccayes/alertasActual/nCov/pruebasRealizadas.htm,61950880,37276877,0,0,0.5307622052474261,0,0,63528004,34839797
Spain,2023-01-02,99271285,99271285,43528,https://www.sanidad.gob.es/profesionales/saludPublica/ccayes/alertasActual/nCov/pruebasRealizadas.htm,61970972,37300313,20092,23436,0.5384120566072413,20092,23436,63548096,34863233
Spain,2023-01-03,99294437,99294437,23152,https://www.sanidad.gob.es/profesionales/saludPublica/ccayes/alertasActual/nCov/pruebasRealizadas.htm,61981840,37312597,10868,12284,0.5305805114029025,10868,12284,63558964,34875517
Spain,2023-01-04,99321396,99321396,26959,https://www.sanidad.gob.es/profesionales/saludPublica/ccayes/alertasActual/nCov/pruebasRealizadas.htm,61993561,37327835,11721,15238,0.5652286805890426,11721,15238,63570685,34890755
Spain,2023-01-05,99346783,99346783,25387,https://www.sanidad.gob.es/profesionales/saludPublica/ccayes/alertasActual/nCov/pruebasRealizadas.htm,62004863,37341920,11302,14085,0.5548115177059125,11302,14085,63581987,34904840
Spain,2023-01-06,99346783,99346783,0,https://www.sanidad.gob.es/profesionales/saludPublica/ccayes/alertasActual/nCov/pruebasRealizadas.htm,62004863,37341920,0,0,0.5548115177059125,0,0,63581987,34904840
Spain,2023-01-07,99346783,99346783,0,https://www.sanidad.gob.es/profesionales/saludPublica/ccayes/alertasActual/nCov/pruebasRealizadas.htm,62004863,37341920,0,0,0.5548115177059125,0,0,63581987,34904840
Spain,2023-01-08,99346783,99346783,0,https://www.sanidad.gob.es/profesionales/saludPublica/ccayes/alertasActual/nCov/pruebasRealizadas.htm,62004863,37341920,0,0,0.5548115177059125,0,0,63581987,34904840
Spain,2023-01-09,99399918,99399918,53135,https://www.sanidad.gob.es/profesionales/saludPublica/ccayes/alertasActual/nCov/pruebasRealizadas.htm,62031906,37368012,27043,26092,0.4910510962642326,27043,26092,63609030,34930932
Spain,2023-01-10,99426579,99426579,26661,https://www.sanidad.gob.es/profesionales/saludPublica/ccayes/alertasActual/nCov/pruebasRealizadas.htm,62045997,37380582,14091,12570,0.4714751884775515,14091,12570,63623121,34943502
Spain,2023-01-11,99458827,99458827,32248,https://www.sanidad.gob.es/profesionales/saludPublica/ccayes/alertasActual/nCov/pruebasRealizadas.htm,62060419,37398408,14422,17826,0.5527784668816671,14422,17826,63637543,34961328
Spain,2023-01-12,99488050,99488050,29223,https://www.sanidad.gob.es/profesionales/saludPublica/ccayes/alertasActual/nCov/pruebasRealizadas.htm,62073497,37414553,13078,16145,0.5524757896177668,13078,16145,63650621,34977473
Spain,2023-01-13,99512053,99512053,24003,https://www.sanidad.gob.es/profesionales/saludPublica/ccayes/alertasActual/nCov/pruebasRealizadas.htm,62085090,37426963,11593,12410,0.5170187059950839,11593,12410,63662214,34989883
Spain,2023-01-14,99512053,99512053,0,https://www.sanidad.gob.es/profesionales/saludPublica/ccayes/alertasActual/nCov/pruebasRealizadas.htm,62085090,37426963,0,0,0.5170187059950839,0,0,63662214,34989883
Spain,2023-01-15,99512053,99512053,0,https://www.sanidad.gob.es/profesionales/saludPublica/ccayes/alertasActual/nCov/pruebasRealizadas.htm,62085090,37426963,0,0,0.5170187059950839,0,0,63662214,34989883
Spain,2023-01-16,99550197,99550197,38144,https://www.sanidad.gob.es/profesionales/saludPublica/ccayes/alertasActual/nCov/pruebasRealizadas.htm,62105366,37444831,20276,17868,0.46843540268456374,20276,17868,63682490,35007751
Spain,2023-01-17,99570590,99570590,20393,https://www.sanidad.gob.es/profesionales/saludPublica/ccayes/alertasActual/nCov/pruebasRealizadas.htm,62116206,37454384,10840,9553,0.468445054675624,10840,9553,63693330,35017304
Spain,2023-01-18,99593648,99593648,23058,https://www.sanidad.gob.es/profesionales/saludPublica/ccayes/alertasActual/nCov/pruebasRealizadas.htm,62129252,37464396,13046,10012,0.43420938502905715,13046,10012,63706376,35027316
Spain,2023-01-19,99610988,99610988,17340,https://www.sanidad.gob.es/profesionales/saludPublica/ccayes/alertasActual/nCov/pruebasRealizadas.htm,62138889,37472099,9637,7703,0.4442329873125721,9637,7703,63716013,35035019
Spain,2023-01-20,99638190,99638190,27202,https://www.sanidad.gob.es/profesionales/saludPublica/ccayes/alertasActual/nCov/pruebasRealizadas.htm,62151573,37486617,12684,14518,0.5337107565620175,12684,14518,63728697,35049537
Spain,2023-01-21,99638190,99638190,0,https://www.sanidad.gob.es/profesionales/saludPublica/ccayes/alertasActual/nCov/pruebasRealizadas.htm,62151573,37486617,0,0,0.5337107565620175,0,0,63728697,35049537
Spain,2023-01-22,99638190,99638190,0,https://www.sanidad.gob.es/profesionales/saludPublica/ccayes/alertasActual/nCov/pruebasRealizadas.htm,62151573,37486617,0,0,0.5337107565620175,0,0,63728697,35049537
Spain,2023-01-23,99668410,99668410,30220,https://www.sanidad.gob.es/profesionales/saludPublica/ccayes/alertasActual/nCov/pruebasRealizadas.htm,62169511,37498899,17938,12282,0.40641958967571146,17938,12282,63746635,35061819
Spain,2023-01-24,99668410,99668410,0,https://www.sanidad.gob.es/profesionales/saludPublica/ccayes/alertasActual/nCov/pruebasRealizadas.htm,62169511,37498899,0,0,0.40641958967571146,0,0,63746635,35061819
Spain,2023-01-25,99668410,99668410,0,https://www.sanidad.gob.es/profesionales/saludPublica/ccayes/alertasActual/nCov/pruebasRealizadas.htm,62169511,37498899,0,0,0.40641958967571146,0,0,63746635,35061819
Spain,2023-01-26,99668410,99668410,0,https://www.sanidad.gob.es/profesionales/saludPublica/ccayes/alertasActual/nCov/pruebasRealizadas.htm,62169511,37498899,0,0,0.40641958967571146,0,0,63746635,35061819
Spain,2023-01-27,99747242,99747242,78832,https://www.sanidad.gob.es/profesionales/saludPublica/ccayes/alertasActual/nCov/pruebasRealizadas.htm,62212337,37534905,42826,36006,0.4567434544347473,42826,36006,63789461,35097825
Spain,2023-01-28,99747242,99747242,0,https://www.sanidad.gob.es/profesionales/saludPublica/ccayes/alertasActual/nCov/pruebasRealizadas.htm,62212337,37534905,0,0,0.4567434544347473,0,0,63789461,35097825
Spain,2023-01-29,99747242,99747242,0,https://www.sanidad.gob.es/profesionales/saludPublica/ccayes/alertasActual/nCov/pruebasRealizadas.htm,62212337,37534905,0,0,0.4567434544347473,0,0,63789461,35097825
Spain,2023-01-30,99774615,99774615,27373,https://www.sanidad.gob.es/profesionales/saludPublica/ccayes/alertasActual/nCov/pruebasRealizadas.htm,62228442,37546173,16105,11268,0.4116465129872502,16105,11268,63805566,35109093
Spain,2023-01-31,99786575,99786575,11960,https://www.sanidad.gob.es/profesionales/saludPublica/ccayes/alertasActual/nCov/pruebasRealizadas.htm,62236001,37550574,7559,4401,0.36797658862876254,7559,4401,63813125,35113494
Spain,2023-02-01,99803740,99803740,17165,https://www.sanidad.gob.es/profesionales/saludPublica/ccayes/alertasActual/nCov/pruebasRealizadas.htm,62245623,37558117,9622,7543,0.439440722400233,9622,7543,63822747,35121037
Spain,2023-02-02,99803740,99803740,0,https://www.sanidad.gob.es/profesionales/saludPublica/ccayes/alertasActual/nCov/pruebasRealizadas.htm,62245623,37558117,0,0,0.439440722400233,0,0,63822747,35121037
Spain,2023-02-03,99853785,99853785,50045,https://www.sanidad.gob.es/profesionales/saludPublica/ccayes/alertasActual/nCov/pruebasRealizadas.htm,62271115,37582670,25492,24553,0.49061844340093913,25492,24553,63848239,35145590
Spain,2023-02-04,99853785,99853785,0,https://www.sanidad.gob.es/profesionales/saludPublica/ccayes/alertasActual/nCov/pruebasRealizadas.htm,62271115,37582670,0,0,0.49061844340093913,0,0,63848239,35145590
Spain,2023-02-05,99853785,99853785,0,https://www.sanidad.gob.es/profesionales/saludPublica/ccayes/alertasActual/nCov/pruebasRealizadas.htm,62271115,37582670,0,0,0.49061844340093913,0,0,63848239,35145590
Spain,2023-02-06,99877272,99877272,23487,https://www.sanidad.gob.es/profesionales/saludPublica/ccayes/alertasActual/nCov/pruebasRealizadas.htm,62283969,37593303,12854,10633,0.4527185251415677,12854,10633,63861093,35156223
Spain,2023-02-07,99896155,99896155,18883,https://www.sanidad.gob.es/profesionales/saludPublica/ccayes/alertasActual/nCov/pruebasRealizadas.htm,62293865,37602290,9896,8987,0.47593073134565483,9896,8987,63870989,35165210
Spain,2023-02-08,99918223,99918223,22068,https://www.sanidad.gob.es/profesionales/saludPublica/ccayes/alertasActual/nCov/pruebasRealizadas.htm,62303800,37614423,9935,12133,0.5498006162769621,9935,12133,63880924,35177343
Spain,2023-02-09,99932614,99932614,14391,https://www.sanidad.gob.es/profesionales/saludPublica/ccayes/alertasActual/nCov/pruebasRealizadas.htm,62311291,37621323,7491,6900,0.4794663331248697,7491,6900,63888415,35184243
Spain,2023-02-10,99945230,99945230,12616,https://www.sanidad.gob.es/profesionales/saludPublica/ccayes/alertasActual/nCov/pruebasRealizadas.htm,62318247,37626983,6956,5660,0.44863665187064045,6956,5660,63895371,35189903
Spain,2023-02-11,99945230,99945230,0,https://www.sanidad.gob.es/profesionales/saludPublica/ccayes/alertasActual/nCov/pruebasRealizadas.htm,62318247,37626983,0,0,0.44863665187064045,0,0,63895371,35189903
Spain,2023-02-12,99945230,99945230,0,https://www.sanidad.gob.es/profesionales/saludPublica/ccayes/alertasActual/nCov/pruebasRealizadas.htm,62318247,37626983,0,0,0.44863665187064045,0,0,63895371,35189903
Spain,2023-02-13,99979066,99979066,33836,https://www.sanidad.gob.es/profesionales/saludPublica/ccayes/alertasActual/nCov/pruebasRealizadas.htm,62334444,37644622,16197,17639,0.5213086653268708,16197,17639,63911568,35207542
Spain,2023-02-14,100007684,100007684,28618,https://www.sanidad.gob.es/profesionales/saludPublica/ccayes/alertasActual/nCov/pruebasRealizadas.htm,62351362,37656322,16918,11700,0.4088336012299951,16918,11700,63928486,35219242
Switzerland,2021-03-23,5720475,5720475,31691,https://www.covid19.admin.ch/en/overview?ovTime=total,4808900,911575,17302,14389,0.4540405793442933,17302,14389,4808900,911575
Switzerland,2021-03-24,5765946,5765946,45471,https://www.covid19.admin.ch/en/overview?ovTime=total,4840971,924975,32071,13400,0.29469332101779155,32071,13400,4840971,924975
Switzerland,2021-03-25,5808823,5808823,42877,https://www.covid19.admin.ch/en/overview?ovTime=total,4870430,938393,29459,13418,0.3129416703594001,29459,13418,4870430,938393
Switzerland,2021-03-26,5851917,5851917,43094,https://www.covid19.admin.ch/en/overview?ovTime=total,4899229,952688,28799,14295,0.3317167123033369,28799,14295,4899229,952688
Switzerland,2021-03-27,5851917,5851917,0,https://www.covid19.admin.ch/en/overview?ovTime=total,4899229,952688,0,0,0.3317167123033369,0,0,4899229,952688
Switzerland,2021-03-28,5851917,5851917,0,https://www.covid19.admin.ch/en/overview?ovTime=total,4899229,952688,0,0,0.3317167123033369,0,0,4899229,952688
Switzerland,2021-03-29,5942810,5942810,90893,https://www.covid19.admin.ch/en/overview?ovTime=total,4958765,984045,59536,31357,0.344988062887131,59536,31357,4958765,984045
Switzerland,2021-03-30,5968525,5968525,25715,https://www.covid19.admin.ch/en/overview?ovTime=total,4970013,998512,11248,14467,0.5625899280575539,11248,14467,4970013,998512
Switzerland,2021-03-31,6012966,6012966,44441,https://www.covid19.admin.ch/en/overview?ovTime=total,5001104,1011862,31091,13350,0.3003982808667672,31091,13350,5001104,1011862
Switzerland,2021-04-01,6069595,6069595,56629,https://www.covid19.admin.ch/en/overview?ovTime=total,5040722,1028873,39618,17011,0.3003937911670699,39618,17011,5040722,1028873
Switzerland,2021-04-02,6126488,6126488,56893,https://www.covid19.admin.ch/en/overview?ovTime=total,5077299,1049189,36577,20316,0.3570913820680927,36577,20316,5077299,1049189
Switzerland,2021-04-03,6126488,6126488,0,https://www.covid19.admin.ch/en/overview?ovTime=total,5077299,1049189,0,0,0.3570913820680927,0,0,5077299,1049189
Switzerland,2021-04-04,6126488,6126488,0,https://www.covid19.admin.ch/en/overview?ovTime=total,5077299,1049189,0,0,0.3570913820680927,0,0,5077299,1049189
Switzerland,2021-04-05,6126488,6126488,0,https://www.covid19.admin.ch/en/overview?ovTime=total,5077299,1049189,0,0,0.3570913820680927,0,0,5077299,1049189
Switzerland,2021-04-06,6226564,6226564,100076,https://www.covid19.admin.ch/en/overview?ovTime=total,5139424,1087140,62125,37951,0.37922179143850676,62125,37951,5139424,1087140
Switzerland,2021-04-07,6260306,6260306,33742,https://www.covid19.admin.ch/en/overview?ovTime=total,5158523,1101783,19099,14643,0.43396953351905637,19099,14643,5158523,1101783
Switzerland,2021-04-08,6300365,6300365,40059,https://www.covid19.admin.ch/en/overview?ovTime=total,5186035,1114330,27512,12547,0.31321301080905667,27512,12547,5186035,1114330
Switzerland,2021-04-09,6339396,6339396,39031,https://www.covid19.admin.ch/en/overview?ovTime=total,5212732,1126664,26697,12334,0.3160052266147421,26697,12334,5212732,1126664
Switzerland,2021-04-10,6339396,6339396,0,https://www.covid19.admin.ch/en/overview?ovTime=total,5212732,1126664,0,0,0.3160052266147421,0,0,5212732,1126664
Switzerland,2021-04-11,6339396,6339396,0,https://www.covid19.admin.ch/en/overview?ovTime=total,5212732,1126664,0,0,0.3160052266147421,0,0,5212732,1126664
Switzerland,2021-04-12,6412371,6412371,72975,https://www.covid19.admin.ch/en/overview?ovTime=total,5264697,1147674,51965,21010,0.28790681740322027,51965,21010,5264697,1147674
Switzerland,2021-04-13,6437818,6437818,25447,https://www.covid19.admin.ch/en/overview?ovTime=total,5279756,1158062,15059,10388,0.40822100837033837,15059,10388,5279756,1158062
Switzerland,2021-04-14,6474822,6474822,37004,https://www.covid19.admin.ch/en/overview?ovTime=total,5307510,1167312,27754,9250,0.24997297589449788,27754,9250,5307510,1167312
Switzerland,2021-04-15,6505841,6505841,31019,https://www.covid19.admin.ch/en/overview?ovTime=total,5329794,1176047,22284,8735,0.2816015990199555,22284,8735,5329794,1176047
Switzerland,2021-04-16,6538153,6538153,32312,https://www.covid19.admin.ch/en/overview?ovTime=total,5353602,1184551,23808,8504,0.26318395642485765,23808,8504,5353602,1184551
Switzerland,2021-04-17,6538153,6538153,0,https://www.covid19.admin.ch/en/overview?ovTime=total,5353602,1184551,0,0,0.26318395642485765,0,0,5353602,1184551
Switzerland,2021-04-18,6538153,6538153,0,https://www.covid19.admin.ch/en/overview?ovTime=total,5353602,1184551,0,0,0.26318395642485765,0,0,5353602,1184551
Switzerland,2021-04-19,6609958,6609958,71805,https://www.covid19.admin.ch/en/overview?ovTime=total,5406498,1203460,52896,18909,0.26333820764570715,52896,18909,5406498,1203460
Switzerland,2021-04-20,6633770,6633770,23812,https://www.covid19.admin.ch/en/overview?ovTime=total,5420952,1212818,14454,9358,0.3929951285066353,14454,9358,5420952,1212818
Switzerland,2021-04-21,6663629,6663629,29859,https://www.covid19.admin.ch/en/overview?ovTime=total,5443440,1220189,22488,7371,0.24686024314277102,22488,7371,5443440,1220189
Switzerland,2021-04-22,6692508,6692508,28879,https://www.covid19.admin.ch/en/overview?ovTime=total,5464887,1227621,21447,7432,0.2573496312199176,21447,7432,5464887,1227621
Switzerland,2021-04-23,6723694,6723694,31186,https://www.covid19.admin.ch/en/overview?ovTime=total,5487857,1235837,22970,8216,0.2634515487718848,22970,8216,5487857,1235837
Switzerland,2021-04-24,6723694,6723694,0,https://www.covid19.admin.ch/en/overview?ovTime=total,5487857,1235837,0,0,0.2634515487718848,0,0,5487857,1235837
Switzerland,2021-04-25,6723694,6723694,0,https://www.covid19.admin.ch/en/overview?ovTime=total,5487857,1235837,0,0,0.2634515487718848,0,0,5487857,1235837
Switzerland,2021-04-26,6794311,6794311,70617,https://www.covid19.admin.ch/en/overview?ovTime=total,5540717,1253594,52860,17757,0.25145503207442965,52860,17757,5540717,1253594
Switzerland,2021-04-27,6818583,6818583,24272,https://www.covid19.admin.ch/en/overview?ovTime=total,5555757,1262826,15040,9232,0.3803559657218194,15040,9232,5555757,1262826
Switzerland,2021-04-28,6848517,6848517,29934,https://www.covid19.admin.ch/en/overview?ovTime=total,5578032,1270485,22275,7659,0.2558628983764281,22275,7659,5578032,1270485
Switzerland,2021-04-29,6878392,6878392,29875,https://www.covid19.admin.ch/en/overview?ovTime=total,5600472,1277920,22440,7435,0.24887029288702928,22440,7435,5600472,1277920
Switzerland,2021-04-30,6911371,6911371,32979,https://www.covid19.admin.ch/en/overview?ovTime=total,5625232,1286139,24760,8219,0.24921920009703144,24760,8219,5625232,1286139
Switzerland,2021-05-01,6911371,6911371,0,https://www.covid19.admin.ch/en/overview?ovTime=total,5625232,1286139,0,0,0.24921920009703144,0,0,5625232,1286139
Switzerland,2021-05-02,6911371,6911371,0,https://www.covid19.admin.ch/en/overview?ovTime=total,5625232,1286139,0,0,0.24921920009703144,0,0,5625232,1286139
Switzerland,2021-05-03,6978583,6978583,67212,https://www.covid19.admin.ch/en/overview?ovTime=total,5674650,1303933,49418,17794,0.2647443908825805,49418,17794,5674650,1303933
Switzerland,2021-05-04,7001299,7001299,22716,https://www.covid19.admin.ch/en/overview?ovTime=total,5688687,1312612,14037,8679,0.38206550449022714,14037,8679,5688687,1312612
Switzerland,2021-05-05,7029684,7029684,28385,https://www.covid19.admin.ch/en/overview?ovTime=total,5710443,1319241,21756,6629,0.23353884093711466,21756,6629,5710443,1319241
Switzerland,2021-05-06,7057364,7057364,27680,https://www.covid19.admin.ch/en/overview?ovTime=total,5731298,1326066,20855,6825,0.2465679190751445,20855,6825,5731298,1326066
Switzerland,2021-05-07,7088449,7088449,31085,https://www.covid19.admin.ch/en/overview?ovTime=total,5754515,1333934,23217,7868,0.25311243364967023,23217,7868,5754515,1333934
Switzerland,2021-05-08,7088449,7088449,0,https://www.covid19.admin.ch/en/overview?ovTime=total,5754515,1333934,0,0,0.25311243364967023,0,0,5754515,1333934
Switzerland,2021-05-09,7088449,7088449,0,https://www.covid19.admin.ch/en/overview?ovTime=total,5754515,1333934,0,0,0.25311243364967023,0,0,5754515,1333934
Switzerland,2021-05-10,7154659,7154659,66210,https://www.covid19.admin.ch/en/overview?ovTime=total,5803532,1351127,49017,17193,0.25967376529225195,49017,17193,5803532,1351127
Switzerland,2021-05-11,7179360,7179360,24701,https://www.covid19.admin.ch/en/overview?ovTime=total,5820019,1359341,16487,8214,0.3325371442451723,16487,8214,5820019,1359341
Switzerland,2021-05-12,7216520,7216520,37160,https://www.covid19.admin.ch/en/overview?ovTime=total,5848311,1368209,28292,8868,0.23864370290635092,28292,8868,5848311,1368209
Switzerland,2021-05-13,7216520,7216520,0,https://www.covid19.admin.ch/en/overview?ovTime=total,5848311,1368209,0,0,0.23864370290635092,0,0,5848311,1368209
Switzerland,2021-05-14,7273942,7273942,57422,https://www.covid19.admin.ch/en/overview?ovTime=total,5891014,1382928,42703,14719,0.25633032635575215,42703,14719,5891014,1382928
Switzerland,2021-05-15,7273942,7273942,0,https://www.covid19.admin.ch/en/overview?ovTime=total,5891014,1382928,0,0,0.25633032635575215,0,0,5891014,1382928
Switzerland,2021-05-16,7273942,7273942,0,https://www.covid19.admin.ch/en/overview?ovTime=total,5891014,1382928,0,0,0.25633032635575215,0,0,5891014,1382928
Switzerland,2021-05-17,7338506,7338506,64564,https://www.covid19.admin.ch/en/overview?ovTime=total,5936767,1401739,45753,18811,0.29135431509819715,45753,18811,5936767,1401739
Switzerland,2021-05-18,7360542,7360542,22036,https://www.covid19.admin.ch/en/overview?ovTime=total,5950290,1410252,13523,8513,0.38632238155745147,13523,8513,5950290,1410252
Switzerland,2021-05-19,7390415,7390415,29873,https://www.covid19.admin.ch/en/overview?ovTime=total,5972923,1417492,22633,7240,0.24235932112610048,22633,7240,5972923,1417492
Switzerland,2021-05-20,7421613,7421613,31198,https://www.covid19.admin.ch/en/overview?ovTime=total,5995772,1425841,22849,8349,0.2676133085454196,22849,8349,5995772,1425841
Switzerland,2021-05-21,7460843,7460843,39230,https://www.covid19.admin.ch/en/overview?ovTime=total,6022549,1438294,26777,12453,0.3174356359928626,26777,12453,6022549,1438294
Switzerland,2021-05-22,7460843,7460843,0,https://www.covid19.admin.ch/en/overview?ovTime=total,6022549,1438294,0,0,0.3174356359928626,0,0,6022549,1438294
Switzerland,2021-05-23,7460843,7460843,0,https://www.covid19.admin.ch/en/overview?ovTime=total,6022549,1438294,0,0,0.3174356359928626,0,0,6022549,1438294
Switzerland,2021-05-24,7460843,7460843,0,https://www.covid19.admin.ch/en/overview?ovTime=total,6022549,1438294,0,0,0.3174356359928626,0,0,6022549,1438294
Switzerland,2021-05-25,7549270,7549270,88427,https://www.covid19.admin.ch/en/overview?ovTime=total,6080470,1468800,57921,30506,0.34498512897644384,57921,30506,6080470,1468800
Switzerland,2021-05-26,7571745,7571745,22475,https://www.covid19.admin.ch/en/overview?ovTime=total,6095013,1476732,14543,7932,0.3529254727474972,14543,7932,6095013,1476732
Switzerland,2021-05-27,7600865,7600865,29120,https://www.covid19.admin.ch/en/overview?ovTime=total,6117070,1483795,22057,7063,0.24254807692307692,22057,7063,6117070,1483795
Switzerland,2021-05-28,7630534,7630534,29669,https://www.covid19.admin.ch/en/overview?ovTime=total,6138289,1492245,21219,8450,0.28480905996157607,21219,8450,6138289,1492245
Switzerland,2021-05-29,7630534,7630534,0,https://www.covid19.admin.ch/en/overview?ovTime=total,6138289,1492245,0,0,0.28480905996157607,0,0,6138289,1492245
Switzerland,2021-05-30,7630534,7630534,0,https://www.covid19.admin.ch/en/overview?ovTime=total,6138289,1492245,0,0,0.28480905996157607,0,0,6138289,1492245
Switzerland,2021-05-31,7692747,7692747,62213,https://www.covid19.admin.ch/en/overview?ovTime=total,6182011,1510736,43722,18491,0.2972208380885024,43722,18491,6182011,1510736
Switzerland,2021-06-01,7713814,7713814,21067,https://www.covid19.admin.ch/en/overview?ovTime=total,6195414,1518400,13403,7664,0.36379171215645323,13403,7664,6195414,1518400
Switzerland,2021-06-02,7741923,7741923,28109,https://www.covid19.admin.ch/en/overview?ovTime=total,6215287,1526636,19873,8236,0.2930022412750365,19873,8236,6215287,1526636
Switzerland,2021-06-03,7773369,7773369,31446,https://www.covid19.admin.ch/en/overview?ovTime=total,6236224,1537145,20937,10509,0.3341919481015073,20937,10509,6236224,1537145
Switzerland,2021-06-04,7799402,7799402,26033,https://www.covid19.admin.ch/en/overview?ovTime=total,6255357,1544045,19133,6900,0.26504820804363693,19133,6900,6255357,1544045
Switzerland,2021-06-05,7799402,7799402,0,https://www.covid19.admin.ch/en/overview?ovTime=total,6255357,1544045,0,0,0.26504820804363693,0,0,6255357,1544045
Switzerland,2021-06-06,7799402,7799402,0,https://www.covid19.admin.ch/en/overview?ovTime=total,6255357,1544045,0,0,0.26504820804363693,0,0,6255357,1544045
Switzerland,2021-06-07,7857449,7857449,58047,https://www.covid19.admin.ch/en/overview?ovTime=total,6294516,1562933,39159,18888,0.32539149310041865,39159,18888,6294516,1562933
Switzerland,2021-06-08,7875323,7875323,17874,https://www.covid19.admin.ch/en/overview?ovTime=total,6305261,1570062,10745,7129,0.39884748797135505,10745,7129,6305261,1570062
Switzerland,2021-06-09,7897523,7897523,22200,https://www.covid19.admin.ch/en/overview?ovTime=total,6321621,1575902,16360,5840,0.26306306306306304,16360,5840,6321621,1575902
Switzerland,2021-06-10,7919475,7919475,21952,https://www.covid19.admin.ch/en/overview?ovTime=total,6336863,1582612,15242,6710,0.30566690962099125,15242,6710,6336863,1582612
Switzerland,2021-06-11,7945174,7945174,25699,https://www.covid19.admin.ch/en/overview?ovTime=total,6353571,1591603,16708,8991,0.34985797112728123,16708,8991,6353571,1591603
Switzerland,2021-06-12,7945174,7945174,0,https://www.covid19.admin.ch/en/overview?ovTime=total,6353571,1591603,0,0,0.34985797112728123,0,0,6353571,1591603
Switzerland,2021-06-13,7945174,7945174,0,https://www.covid19.admin.ch/en/overview?ovTime=total,6353571,1591603,0,0,0.34985797112728123,0,0,6353571,1591603
Switzerland,2021-06-14,7999355,7999355,54181,https://www.covid19.admin.ch/en/overview?ovTime=total,6386579,1612776,33008,21173,0.39078274671932967,33008,21173,6386579,1612776
Switzerland,2021-06-15,8017244,8017244,17889,https://www.covid19.admin.ch/en/overview?ovTime=total,6396700,1620544,10121,7768,0.4342333277433059,10121,7768,6396700,1620544
Switzerland,2021-06-16,8037136,8037136,19892,https://www.covid19.admin.ch/en/overview?ovTime=total,6409590,1627546,12890,7002,0.35200080434345465,12890,7002,6409590,1627546
Switzerland,2021-06-17,8058247,8058247,21111,https://www.covid19.admin.ch/en/overview?ovTime=total,6423228,1635019,13638,7473,0.3539860736109137,13638,7473,6423228,1635019
Switzerland,2021-06-18,8084820,8084820,26573,https://www.covid19.admin.ch/en/overview?ovTime=total,6439056,1645764,15828,10745,0.40435780679637223,15828,10745,6439056,1645764
Switzerland,2021-06-19,8084820,8084820,0,https://www.covid19.admin.ch/en/overview?ovTime=total,6439056,1645764,0,0,0.40435780679637223,0,0,6439056,1645764
Switzerland,2021-06-20,8084820,8084820,0,https://www.covid19.admin.ch/en/overview?ovTime=total,6439056,1645764,0,0,0.40435780679637223,0,0,6439056,1645764
Switzerland,2021-06-21,8140729,8140729,55909,https://www.covid19.admin.ch/en/overview?ovTime=total,6468935,1671794,29879,26030,0.4655779928097444,29879,26030,6468935,1671794
Switzerland,2021-06-22,8157861,8157861,17132,https://www.covid19.admin.ch/en/overview?ovTime=total,6477420,1680441,8485,8647,0.5047279943964511,8485,8647,6477420,1680441
Switzerland,2021-06-23,8176521,8176521,18660,https://www.covid19.admin.ch/en/overview?ovTime=total,6488832,1687689,11412,7248,0.38842443729903536,11412,7248,6488832,1687689
Switzerland,2021-06-24,8196899,8196899,20378,https://www.covid19.admin.ch/en/overview?ovTime=total,6501185,1695714,12353,8025,0.39380704681519285,12353,8025,6501185,1695714
Switzerland,2021-06-25,8221551,8221551,24652,https://www.covid19.admin.ch/en/overview?ovTime=total,6514700,1706851,13515,11137,0.45176861917897126,13515,11137,6514700,1706851
Switzerland,2021-06-26,8221551,8221551,0,https://www.covid19.admin.ch/en/overview?ovTime=total,6514700,1706851,0,0,0.45176861917897126,0,0,6514700,1706851
Switzerland,2021-06-27,8221551,8221551,0,https://www.covid19.admin.ch/en/overview?ovTime=total,6514700,1706851,0,0,0.45176861917897126,0,0,6514700,1706851
Switzerland,2021-06-28,8273152,8273152,51601,https://www.covid19.admin.ch/en/overview?ovTime=total,6540466,1732686,25766,25835,0.5006685916939594,25766,25835,6540466,1732686
Switzerland,2021-06-29,8289363,8289363,16211,https://www.covid19.admin.ch/en/overview?ovTime=total,6548042,1741321,7576,8635,0.5326630066004565,7576,8635,6548042,1741321
Switzerland,2021-06-30,8306968,8306968,17605,https://www.covid19.admin.ch/en/overview?ovTime=total,6559180,1747788,11138,6467,0.3673388241976711,11138,6467,6559180,1747788
Switzerland,2021-07-01,8329750,8329750,22782,https://www.covid19.admin.ch/en/overview?ovTime=total,6571764,1757986,12584,10198,0.44763409709419716,12584,10198,6571764,1757986
Switzerland,2021-07-02,8359875,8359875,30125,https://www.covid19.admin.ch/en/overview?ovTime=total,6586554,1773321,14790,15335,0.509045643153527,14790,15335,6586554,1773321
Switzerland,2021-07-03,8359875,8359875,0,https://www.covid19.admin.ch/en/overview?ovTime=total,6586554,1773321,0,0,0.509045643153527,0,0,6586554,1773321
Switzerland,2021-07-04,8359875,8359875,0,https://www.covid19.admin.ch/en/overview?ovTime=total,6586554,1773321,0,0,0.509045643153527,0,0,6586554,1773321
Switzerland,2021-07-05,8437613,8437613,77738,https://www.covid19.admin.ch/en/overview?ovTime=total,6618543,1819070,31989,45749,0.5885024055159639,31989,45749,6618543,1819070
Switzerland,2021-07-06,8459588,8459588,21975,https://www.covid19.admin.ch/en/overview?ovTime=total,6628833,1830755,10290,11685,0.531740614334471,10290,11685,6628833,1830755
Switzerland,2021-07-07,8482848,8482848,23260,https://www.covid19.admin.ch/en/overview?ovTime=total,6640263,1842585,11430,11830,0.5085984522785899,11430,11830,6640263,1842585
Switzerland,2021-07-08,8506560,8506560,23712,https://www.covid19.admin.ch/en/overview?ovTime=total,6652049,1854511,11786,11926,0.5029520917678812,11786,11926,6652049,1854511
Switzerland,2021-07-09,8540340,8540340,33780,https://www.covid19.admin.ch/en/overview?ovTime=total,6667474,1872866,15425,18355,0.5433688573120189,15425,18355,6667474,1872866
Switzerland,2021-07-10,8540340,8540340,0,https://www.covid19.admin.ch/en/overview?ovTime=total,6667474,1872866,0,0,0.5433688573120189,0,0,6667474,1872866
Switzerland,2021-07-11,8540340,8540340,0,https://www.covid19.admin.ch/en/overview?ovTime=total,6667474,1872866,0,0,0.5433688573120189,0,0,6667474,1872866
Switzerland,2021-07-12,8627251,8627251,86911,https://www.covid19.admin.ch/en/overview?ovTime=total,6699223,1928028,31749,55162,0.6346952629701649,31749,55162,6699223,1928028
Switzerland,2021-07-13,8649527,8649527,22276,https://www.covid19.admin.ch/en/overview?ovTime=total,6708106,1941421,8883,13393,0.6012300233435087,8883,13393,6708106,1941421
Switzerland,2021-07-14,8671394,8671394,21867,https://www.covid19.admin.ch/en/overview?ovTime=total,6719483,1951911,11377,10490,0.4797182969771802,11377,10490,6719483,1951911
Switzerland,2021-07-15,8698651,8698651,27257,https://www.covid19.admin.ch/en/overview?ovTime=total,6732723,1965928,13240,14017,0.5142532193564956,13240,14017,6732723,1965928
Switzerland,2021-07-16,8698651,8698651,0,https://www.covid19.admin.ch/en/overview?ovTime=total,6732723,1965928,0,0,0.5142532193564956,0,0,6732723,1965928
Switzerland,2021-07-17,8698651,8698651,0,https://www.covid19.admin.ch/en/overview?ovTime=total,6732723,1965928,0,0,0.5142532193564956,0,0,6732723,1965928
Switzerland,2021-07-18,8698651,8698651,0,https://www.covid19.admin.ch/en/overview?ovTime=total,6732723,1965928,0,0,0.5142532193564956,0,0,6732723,1965928
Switzerland,2021-07-19,8815269,8815269,116618,https://www.covid19.admin.ch/en/overview?ovTime=total,6782469,2032800,49746,66872,0.5734277727280522,49746,66872,6782469,2032800
Switzerland,2021-07-20,8834114,8834114,18845,https://www.covid19.admin.ch/en/overview?ovTime=total,6791295,2042819,8826,10019,0.5316529583443884,8826,10019,6791295,2042819
Switzerland,2021-07-21,8853812,8853812,19698,https://www.covid19.admin.ch/en/overview?ovTime=total,6803193,2050619,11898,7800,0.395979287237283,11898,7800,6803193,2050619
Switzerland,2021-07-22,8853812,8853812,0,https://www.covid19.admin.ch/en/overview?ovTime=total,6803193,2050619,0,0,0.395979287237283,0,0,6803193,2050619
Switzerland,2021-07-23,8853812,8853812,0,https://www.covid19.admin.ch/en/overview?ovTime=total,6803193,2050619,0,0,0.395979287237283,0,0,6803193,2050619
Switzerland,2021-07-24,8853812,8853812,0,https://www.covid19.admin.ch/en/overview?ovTime=total,6803193,2050619,0,0,0.395979287237283,0,0,6803193,2050619
Switzerland,2021-07-25,8853812,8853812,0,https://www.covid19.admin.ch/en/overview?ovTime=total,6803193,2050619,0,0,0.395979287237283,0,0,6803193,2050619
Switzerland,2021-07-26,8974547,8974547,120735,https://www.covid19.admin.ch/en/overview?ovTime=total,6860137,2114410,56944,63791,0.5283554892947364,56944,63791,6860137,2114410
Switzerland,2021-07-27,8974547,8974547,0,https://www.covid19.admin.ch/en/overview?ovTime=total,6860137,2114410,0,0,0.5283554892947364,0,0,6860137,2114410
Switzerland,2021-07-28,8974547,8974547,0,https://www.covid19.admin.ch/en/overview?ovTime=total,6880420,2131782,20283,17372,0.4613464347364228,0,0,6860137,2114410
Switzerland,2021-07-29,8974547,8974547,0,https://www.covid19.admin.ch/en/overview?ovTime=total,6880420,2131782,0,0,0.4613464347364228,0,0,6860137,2114410
Switzerland,2021-07-30,8974547,8974547,0,https://www.covid19.admin.ch/en/overview?ovTime=total,6880420,2131782,0,0,0.4613464347364228,0,0,6860137,2114410
Switzerland,2021-07-31,8974547,8974547,0,https://www.covid19.admin.ch/en/overview?ovTime=total,6880420,2131782,0,0,0.4613464347364228,0,0,6860137,2114410
Switzerland,2021-08-01,9053135,9053135,78588,https://www.covid19.admin.ch/en/overview?ovTime=total,6903729,2149406,23309,17624,0.43055725209488677,44751,33837,6904888,2148247
Switzerland,2021-08-02,9116277,9116277,63142,https://www.covid19.admin.ch/en/overview?ovTime=total,6930454,2185823,26725,36417,0.5767476481581197,26725,36417,6931613,2184664
Switzerland,2021-08-03,9133234,9133234,16957,https://www.covid19.admin.ch/en/overview?ovTime=total,6939172,2194062,8718,8239,0.4858760393937607,8718,8239,6940331,2192903
Switzerland,2021-08-04,9154658,9154658,21424,https://www.covid19.admin.ch/en/overview?ovTime=total,6951296,2203362,12124,9300,0.43409260642270353,12124,9300,6952455,2202203
Switzerland,2021-08-05,9154658,9154658,0,https://www.covid19.admin.ch/en/overview?ovTime=total,6951296,2203362,0,0,0.43409260642270353,0,0,6952455,2202203
Switzerland,2021-08-06,9154658,9154658,0,https://www.covid19.admin.ch/en/overview?ovTime=total,6951296,2203362,0,0,0.43409260642270353,0,0,6952455,2202203
Switzerland,2021-08-07,9154658,9154658,0,https://www.covid19.admin.ch/en/overview?ovTime=total,6951296,2203362,0,0,0.43409260642270353,0,0,6952455,2202203
Switzerland,2021-08-08,9154658,9154658,0,https://www.covid19.admin.ch/en/overview?ovTime=total,6951296,2203362,0,0,0.43409260642270353,0,0,6952455,2202203
Switzerland,2021-08-09,9250039,9250039,95381,https://www.covid19.admin.ch/en/overview?ovTime=total,6999177,2250862,47881,47500,0.4980027468783091,47881,47500,7000336,2249703
Switzerland,2021-08-10,9250039,9250039,0,https://www.covid19.admin.ch/en/overview?ovTime=total,6999177,2250862,0,0,0.4980027468783091,0,0,7000336,2249703
Switzerland,2021-08-11,9250039,9250039,0,https://www.covid19.admin.ch/en/overview?ovTime=total,6999177,2250862,0,0,0.4980027468783091,0,0,7000336,2249703
Switzerland,2021-08-12,9250039,9250039,0,https://www.covid19.admin.ch/en/overview?ovTime=total,6999177,2250862,0,0,0.4980027468783091,0,0,7000336,2249703
Switzerland,2021-08-13,9250039,9250039,0,https://www.covid19.admin.ch/en/overview?ovTime=total,6999177,2250862,0,0,0.4980027468783091,0,0,7000336,2249703
Switzerland,2021-08-14,9250039,9250039,0,https://www.covid19.admin.ch/en/overview?ovTime=total,6999177,2250862,0,0,0.4980027468783091,0,0,7000336,2249703
Switzerland,2021-08-15,9250039,9250039,0,https://www.covid19.admin.ch/en/overview?ovTime=total,6999177,2250862,0,0,0.4980027468783091,0,0,7000336,2249703
Switzerland,2021-08-16,9389616,9389616,139577,https://www.covid19.admin.ch/en/overview?ovTime=total,7074877,2314739,75700,63877,0.45764703353704406,75700,63877,7076036,2313580
Switzerland,2021-08-17,9389616,9389616,0,https://www.covid19.admin.ch/en/overview?ovTime=total,7074877,2314739,0,0,0.45764703353704406,0,0,7076036,2313580
Switzerland,2021-08-18,9389616,9389616,0,https://www.covid19.admin.ch/en/overview?ovTime=total,7074877,2314739,0,0,0.45764703353704406,0,0,7076036,2313580
Switzerland,2021-08-19,9389616,9389616,0,https://www.covid19.admin.ch/en/overview?ovTime=total,7074877,2314739,0,0,0.45764703353704406,0,0,7076036,2313580
Switzerland,2021-08-20,9481152,9481152,91536,https://www.covid19.admin.ch/en/overview?ovTime=total,7134387,2346765,59510,32026,0.3498732739031638,59510,32026,7135546,2345606
Switzerland,2021-08-21,9481152,9481152,0,https://www.covid19.admin.ch/en/overview?ovTime=total,7134387,2346765,0,0,0.3498732739031638,0,0,7135546,2345606
Switzerland,2021-08-22,9481152,9481152,0,https://www.covid19.admin.ch/en/overview?ovTime=total,7134387,2346765,0,0,0.3498732739031638,0,0,7135546,2345606
Switzerland,2021-08-23,9550767,9550767,69615,https://www.covid19.admin.ch/en/overview?ovTime=total,7170813,2379954,36426,33189,0.47675070028011207,36426,33189,7171972,2378795
Switzerland,2021-08-24,9573683,9573683,22916,https://www.covid19.admin.ch/en/overview?ovTime=total,7183636,2390047,12823,10093,0.440434630825624,12823,10093,7184795,2388888
Switzerland,2021-08-25,9600327,9600327,26644,https://www.covid19.admin.ch/en/overview?ovTime=total,7202817,2397510,19181,7463,0.280100585497673,19181,7463,7203976,2396351
Switzerland,2021-08-26,9627169,9627169,26842,https://www.covid19.admin.ch/en/overview?ovTime=total,7221517,2405652,18700,8142,0.30333060129647565,18700,8142,7222676,2404493
Switzerland,2021-08-27,9658850,9658850,31681,https://www.covid19.admin.ch/en/overview?ovTime=total,7242779,2416071,21262,10419,0.3288721946908241,21262,10419,7243938,2414912
Switzerland,2021-08-28,9658850,9658850,0,https://www.covid19.admin.ch/en/overview?ovTime=total,7242779,2416071,0,0,0.3288721946908241,0,0,7243938,2414912
Switzerland,2021-08-29,9658850,9658850,0,https://www.covid19.admin.ch/en/overview?ovTime=total,7242779,2416071,0,0,0.3288721946908241,0,0,7243938,2414912
Switzerland,2021-08-30,9741146,9741146,82296,https://www.covid19.admin.ch/en/overview?ovTime=total,7287117,2454029,44338,37958,0.46123748420336347,44338,37958,7288276,2452870
Switzerland,2021-08-31,9741146,9741146,0,https://www.covid19.admin.ch/en/overview?ovTime=total,7287117,2454029,0,0,0.46123748420336347,0,0,7288276,2452870
Switzerland,2021-09-01,9799734,9799734,58588,https://www.covid19.admin.ch/en/overview?ovTime=total,7325814,2473920,38697,19891,0.3395063835597733,38697,19891,7326973,2472761
Switzerland,2021-09-02,9830067,9830067,30333,https://www.covid19.admin.ch/en/overview?ovTime=total,7347142,2482925,21328,9005,0.29687139419114494,21328,9005,7348301,2481766
Switzerland,2021-09-03,9865479,9865479,35412,https://www.covid19.admin.ch/en/overview?ovTime=total,7371053,2494426,23911,11501,0.32477691178131707,23911,11501,7372212,2493267
Switzerland,2021-09-04,9865479,9865479,0,https://www.covid19.admin.ch/en/overview?ovTime=total,7371053,2494426,0,0,0.32477691178131707,0,0,7372212,2493267
Switzerland,2021-09-05,9865479,9865479,0,https://www.covid19.admin.ch/en/overview?ovTime=total,7371053,2494426,0,0,0.32477691178131707,0,0,7372212,2493267
Switzerland,2021-09-06,9965331,9965331,99852,https://www.covid19.admin.ch/en/overview?ovTime=total,7422355,2542976,51302,48550,0.48621960501542283,51302,48550,7423514,2541817
Switzerland,2021-09-07,9994716,9994716,29385,https://www.covid19.admin.ch/en/overview?ovTime=total,7439144,2555572,16789,12596,0.4286540752084397,16789,12596,7440303,2554413
Switzerland,2021-09-08,9994716,9994716,0,https://www.covid19.admin.ch/en/overview?ovTime=total,7439144,2555572,0,0,0.4286540752084397,0,0,7440303,2554413
Switzerland,2021-09-09,9994716,9994716,0,https://www.covid19.admin.ch/en/overview?ovTime=total,7439144,2555572,0,0,0.4286540752084397,0,0,7440303,2554413
Switzerland,2021-09-10,10029506,10029506,34790,https://www.covid19.admin.ch/en/overview?ovTime=total,7464590,2564916,25446,9344,0.2685829261281978,25446,9344,7465749,2563757
Switzerland,2021-09-11,10103448,10103448,73942,https://www.covid19.admin.ch/en/overview?ovTime=total,7515707,2587741,51117,22825,0.30868789050877715,51117,22825,7516866,2586582
Switzerland,2021-09-12,10103448,10103448,0,https://www.covid19.admin.ch/en/overview?ovTime=total,7515707,2587741,0,0,0.30868789050877715,0,0,7516866,2586582
Switzerland,2021-09-13,10200523,10200523,97075,https://www.covid19.admin.ch/en/overview?ovTime=total,7439144,2555572,-76563,-32169,0.295855865798477,68355,28720,7585221,2615302
Switzerland,2021-09-14,10234565,10234565,34042,https://www.covid19.admin.ch/en/overview?ovTime=total,7585215,2649350,146071,93778,0.3909876630713491,20732,13310,7605953,2628612
Switzerland,2021-09-15,10275943,10275943,41378,https://www.covid19.admin.ch/en/overview?ovTime=total,7610950,2664993,25735,15643,0.37805113828604575,25735,15643,7631688,2644255
Switzerland,2021-09-16,10315436,10315436,39493,https://www.covid19.admin.ch/en/overview?ovTime=total,7635127,2680309,24177,15316,0.38781556225153824,24177,15316,7655865,2659571
Switzerland,2021-09-17,10360119,10360119,44683,https://www.covid19.admin.ch/en/overview?ovTime=total,7659861,2700258,24734,19949,0.44645614663294764,24734,19949,7680599,2679520
Switzerland,2021-09-18,10360119,10360119,0,https://www.covid19.admin.ch/en/overview?ovTime=total,7659861,2700258,0,0,0.44645614663294764,0,0,7680599,2679520
Switzerland,2021-09-19,10360119,10360119,0,https://www.covid19.admin.ch/en/overview?ovTime=total,7659861,2700258,0,0,0.44645614663294764,0,0,7680599,2679520
Switzerland,2021-09-20,10360119,10360119,0,https://www.covid19.admin.ch/en/overview?ovTime=total,7659861,2700258,0,0,0.44645614663294764,0,0,7680599,2679520
Switzerland,2021-09-21,10360119,10360119,0,https://www.covid19.admin.ch/en/overview?ovTime=total,7659861,2700258,0,0,0.44645614663294764,0,0,7680599,2679520
Switzerland,2021-09-22,10500999,10500999,140880,https://www.covid19.admin.ch/en/overview?ovTime=total,7723814,2777185,63953,76927,0.5460462805224304,63953,76927,7744552,2756447
Switzerland,2021-09-23,10577644,10577644,76645,https://www.covid19.admin.ch/en/overview?ovTime=total,7659861,2700258,-63953,-76927,0.5460462805224304,34793,41852,7779345,2798299
Switzerland,2021-09-24,10616632,10616632,38988,https://www.covid19.admin.ch/en/overview?ovTime=total,7789240,2827392,129379,127134,0.49562400346181285,19665,19323,7799010,2817622
Switzerland,2021-09-25,10616632,10616632,0,https://www.covid19.admin.ch/en/overview?ovTime=total,7789240,2827392,0,0,0.49562400346181285,0,0,7799010,2817622
Switzerland,2021-09-26,10616632,10616632,0,https://www.covid19.admin.ch/en/overview?ovTime=total,7789240,2827392,0,0,0.49562400346181285,0,0,7799010,2817622
Switzerland,2021-09-27,10616632,10616632,0,https://www.covid19.admin.ch/en/overview?ovTime=total,7789240,2827392,0,0,0.49562400346181285,0,0,7799010,2817622
Switzerland,2021-09-28,10759554,10759554,142922,https://www.covid19.admin.ch/en/overview?ovTime=total,7851057,2908497,61817,81105,0.5674773652761647,61817,81105,7860827,2898727
Switzerland,2021-09-29,10796404,10796404,36850,https://www.covid19.admin.ch/en/overview?ovTime=total,7871349,2925055,20292,16558,0.4493351424694708,20292,16558,7881119,2915285
Switzerland,2021-09-30,10832621,10832621,36217,https://www.covid19.admin.ch/en/overview?ovTime=total,7891316,2941305,19967,16250,0.44868431951845816,19967,16250,7901086,2931535
Switzerland,2021-10-01,10876699,10876699,44078,https://www.covid19.admin.ch/en/overview?ovTime=total,7914423,2962276,23107,20971,0.4757702255093244,23107,20971,7924193,2952506
Switzerland,2021-10-02,10832621,10876699,0,https://www.covid19.admin.ch/en/overview?ovTime=total,7891316,2941305,-23107,-20971,0.4757702255093244,0,0,7924193,2952506
Switzerland,2021-10-03,10876699,10876699,0,https://www.covid19.admin.ch/en/overview?ovTime=total,7914423,2962276,23107,20971,0.4757702255093244,0,0,7924193,2952506
Switzerland,2021-10-04,10876699,10876699,0,https://www.covid19.admin.ch/en/overview?ovTime=total,7914423,2962276,0,0,0.4757702255093244,0,0,7924193,2952506
Switzerland,2021-10-05,11011222,11011222,134523,https://www.covid19.admin.ch/en/overview?ovTime=total,7972292,3038930,57869,76654,0.5698207741427117,57869,76654,7982062,3029160
Switzerland,2021-10-06,11043823,11043823,32601,https://www.covid19.admin.ch/en/overview?ovTime=total,7990518,3053305,18226,14375,0.4409373945584491,18226,14375,8000288,3043535
Switzerland,2021-10-07,11076492,11076492,32669,https://www.covid19.admin.ch/en/overview?ovTime=total,8008396,3068096,17878,14791,0.4527533747589458,17878,14791,8018166,3058326
Switzerland,2021-10-08,11112913,11112913,36421,https://www.covid19.admin.ch/en/overview?ovTime=total,8027585,3085328,19189,17232,0.47313363169599953,19189,17232,8037355,3075558
Switzerland,2021-10-09,11112913,11112913,0,https://www.covid19.admin.ch/en/overview?ovTime=total,8027585,3085328,0,0,0.47313363169599953,0,0,8037355,3075558
Switzerland,2021-10-10,11112913,11112913,0,https://www.covid19.admin.ch/en/overview?ovTime=total,8027585,3085328,0,0,0.47313363169599953,0,0,8037355,3075558
Switzerland,2021-10-11,11112913,11112913,0,https://www.covid19.admin.ch/en/overview?ovTime=total,8065305,3146858,37720,61530,0.6199496221662468,0,0,8037355,3075558
Switzerland,2021-10-12,11112913,11112913,0,https://www.covid19.admin.ch/en/overview?ovTime=total,8027585,3085328,-37720,-61530,0.6199496221662468,0,0,8037355,3075558
Switzerland,2021-10-13,11112913,11112913,0,https://www.covid19.admin.ch/en/overview?ovTime=total,8027585,3085328,0,0,0.6199496221662468,0,0,8037355,3075558
Switzerland,2021-10-14,11286658,11286658,173745,https://www.covid19.admin.ch/en/overview?ovTime=total,8112825,3173833,85240,88505,0.5093959538403983,85240,88505,8122595,3164063
Switzerland,2021-10-15,11286658,11286658,0,https://www.covid19.admin.ch/en/overview?ovTime=total,8112825,3173833,0,0,0.5093959538403983,0,0,8122595,3164063
Switzerland,2021-10-16,11286658,11286658,0,https://www.covid19.admin.ch/en/overview?ovTime=total,8112825,3173833,0,0,0.5093959538403983,0,0,8122595,3164063
Switzerland,2021-10-17,11286658,11286658,0,https://www.covid19.admin.ch/en/overview?ovTime=total,8112825,3173833,0,0,0.5093959538403983,0,0,8122595,3164063
Switzerland,2021-10-18,11377331,11377331,90673,https://www.covid19.admin.ch/en/overview?ovTime=total,8166940,3210391,54115,36558,0.4031850716310258,54115,36558,8176710,3200621
Switzerland,2021-10-19,11400594,11400594,23263,https://www.covid19.admin.ch/en/overview?ovTime=total,8181051,3219543,14111,9152,0.39341443493960365,14111,9152,8190821,3209773
Switzerland,2021-10-20,11400594,11400594,0,https://www.covid19.admin.ch/en/overview?ovTime=total,8181051,3219543,0,0,0.39341443493960365,0,0,8190821,3209773
Switzerland,2021-10-21,11452601,11452601,52007,https://www.covid19.admin.ch/en/overview?ovTime=total,8217719,3234882,36668,15339,0.29494106562578115,36668,15339,8227489,3225112
Switzerland,2021-10-22,11479392,11479392,26791,https://www.covid19.admin.ch/en/overview?ovTime=total,8235921,3243471,18202,8589,0.32059273636669033,18202,8589,8245691,3233701
Switzerland,2021-10-23,11479392,11479392,0,https://www.covid19.admin.ch/en/overview?ovTime=total,8235921,3243471,0,0,0.32059273636669033,0,0,8245691,3233701
Switzerland,2021-10-24,11479392,11479392,0,https://www.covid19.admin.ch/en/overview?ovTime=total,8235921,3243471,0,0,0.32059273636669033,0,0,8245691,3233701
Switzerland,2021-10-25,11479392,11479392,0,https://www.covid19.admin.ch/en/overview?ovTime=total,8235921,3243471,0,0,0.32059273636669033,0,0,8245691,3233701
Switzerland,2021-10-26,11566572,11566572,87180,https://www.covid19.admin.ch/en/overview?ovTime=total,8287966,3278606,52045,35135,0.403016746960312,52045,35135,8297736,3268836
Switzerland,2021-10-27,11594561,11594561,27989,https://www.covid19.admin.ch/en/overview?ovTime=total,8308703,3285858,20737,7252,0.25910178998892425,20737,7252,8318473,3276088
Switzerland,2021-10-28,11594561,11594561,0,https://www.covid19.admin.ch/en/overview?ovTime=total,8308703,3285858,0,0,0.25910178998892425,0,0,8318473,3276088
Switzerland,2021-10-29,11594561,11594561,0,https://www.covid19.admin.ch/en/overview?ovTime=total,8308703,3285858,0,0,0.25910178998892425,0,0,8318473,3276088
Switzerland,2021-10-30,11594561,11594561,0,https://www.covid19.admin.ch/en/overview?ovTime=total,8308703,3285858,0,0,0.25910178998892425,0,0,8318473,3276088
Switzerland,2021-10-31,11594561,11594561,0,https://www.covid19.admin.ch/en/overview?ovTime=total,8308703,3285858,0,0,0.25910178998892425,0,0,8318473,3276088
Switzerland,2021-11-01,11594561,11594561,0,https://www.covid19.admin.ch/en/overview?ovTime=total,8308703,3285858,0,0,0.25910178998892425,0,0,8318473,3276088
Switzerland,2021-11-02,11594561,11594561,0,https://www.covid19.admin.ch/en/overview?ovTime=total,8308703,3285858,0,0,0.25910178998892425,0,0,8318473,3276088
Switzerland,2021-11-03,11594561,11594561,0,https://www.covid19.admin.ch/en/overview?ovTime=total,8308703,3285858,0,0,0.25910178998892425,0,0,8318473,3276088
Switzerland,2021-11-04,11594561,11594561,0,https://www.covid19.admin.ch/en/overview?ovTime=total,8308703,3285858,0,0,0.25910178998892425,0,0,8318473,3276088
Switzerland,2021-11-05,11594561,11594561,0,https://www.covid19.admin.ch/en/overview?ovTime=total,8308703,3285858,0,0,0.25910178998892425,0,0,8318473,3276088
Switzerland,2021-11-06,11834947,11834947,240386,https://www.covid19.admin.ch/en/overview?ovTime=total,8474981,3359966,166278,74108,0.30828750426397544,166278,74108,8484751,3350196
Switzerland,2021-11-07,11834947,11834947,0,https://www.covid19.admin.ch/en/overview?ovTime=total,8308703,3285858,-166278,-74108,0.30828750426397544,0,0,8484751,3350196
Switzerland,2021-11-08,11834947,11834947,0,https://www.covid19.admin.ch/en/overview?ovTime=total,8308703,3285858,0,0,0.30828750426397544,0,0,8484751,3350196
Switzerland,2021-11-09,11834947,11834947,0,https://www.covid19.admin.ch/en/overview?ovTime=total,8308703,3285858,0,0,0.30828750426397544,0,0,8484751,3350196
Switzerland,2021-11-10,11944795,11944795,109848,https://www.covid19.admin.ch/en/overview?ovTime=total,8548640,3396155,239937,110297,0.31492373670174795,75254,34594,8560005,3384790
Switzerland,2021-11-11,12020753,12020753,75958,https://www.covid19.admin.ch/en/overview?ovTime=total,8609342,3411411,60702,15256,0.20084783696253192,60702,15256,8620707,3400046
Switzerland,2021-11-12,12020753,12020753,0,https://www.covid19.admin.ch/en/overview?ovTime=total,8609342,3411411,0,0,0.20084783696253192,0,0,8620707,3400046
Switzerland,2021-11-13,12020753,12020753,0,https://www.covid19.admin.ch/en/overview?ovTime=total,8609342,3411411,0,0,0.20084783696253192,0,0,8620707,3400046
Switzerland,2021-11-14,12020753,12020753,0,https://www.covid19.admin.ch/en/overview?ovTime=total,8609342,3411411,0,0,0.20084783696253192,0,0,8620707,3400046
Switzerland,2021-11-15,12165966,12165966,145213,https://www.covid19.admin.ch/en/overview?ovTime=total,8708069,3457897,98727,46486,0.32012285401444773,98727,46486,8719434,3446532
Switzerland,2021-11-16,12199175,12199175,33209,https://www.covid19.admin.ch/en/overview?ovTime=total,8731430,3467745,23361,9848,0.29654611701647143,23361,9848,8742795,3456380
Switzerland,2021-11-17,12199175,12199175,0,https://www.covid19.admin.ch/en/overview?ovTime=total,8731430,3467745,0,0,0.29654611701647143,0,0,8742795,3456380
Switzerland,2021-11-18,12290429,12290429,91254,https://www.covid19.admin.ch/en/overview?ovTime=total,8805011,3485418,73581,17673,0.1936682227628378,73581,17673,8816376,3474053
Switzerland,2021-11-19,12290429,12290429,0,https://www.covid19.admin.ch/en/overview?ovTime=total,8708069,3457897,-96942,-27521,0.22111792259547014,0,0,8816376,3474053
Switzerland,2021-11-20,12339927,12339927,49498,https://www.covid19.admin.ch/en/overview?ovTime=total,8844482,3495445,136413,37548,0.21584148171141807,38814,10684,8855190,3484737
Switzerland,2021-11-21,12339927,12339927,0,https://www.covid19.admin.ch/en/overview?ovTime=total,8844482,3495445,0,0,0.21584148171141807,0,0,8855190,3484737
Switzerland,2021-11-22,12452736,12452736,112809,https://www.covid19.admin.ch/en/overview?ovTime=total,8928449,3524287,83967,28842,0.2556710900726006,83967,28842,8939157,3513579
Switzerland,2021-11-23,12493575,12493575,40839,https://www.covid19.admin.ch/en/overview?ovTime=total,8957861,3535714,29412,11427,0.27980606772937633,29412,11427,8968569,3525006
Switzerland,2021-11-24,12549728,12549728,56153,https://www.covid19.admin.ch/en/overview?ovTime=total,9004089,3545639,46228,9925,0.1767492386871583,46228,9925,9014797,3534931
Switzerland,2021-11-25,12606080,12606080,56352,https://www.covid19.admin.ch/en/overview?ovTime=total,9050039,3556041,45950,10402,0.18458972174900626,45950,10402,9060747,3545333
Switzerland,2021-11-26,12606080,12606080,0,https://www.covid19.admin.ch/en/overview?ovTime=total,9050039,3556041,0,0,0.18458972174900626,0,0,9060747,3545333
Switzerland,2021-11-27,12606080,12606080,0,https://www.covid19.admin.ch/en/overview?ovTime=total,9050039,3556041,0,0,0.18458972174900626,0,0,9060747,3545333
Switzerland,2021-11-28,12664276,12664276,58196,https://www.covid19.admin.ch/en/overview?ovTime=total,9096985,3567291,46946,11250,0.19331225513781017,46946,11250,9107693,3556583
Switzerland,2021-11-29,12798899,12798899,134623,https://www.covid19.admin.ch/en/overview?ovTime=total,9200048,3598851,103063,31560,0.2344324521069951,103063,31560,9210756,3588143
Switzerland,2021-11-30,12798899,12798899,0,https://www.covid19.admin.ch/en/overview?ovTime=total,9200048,3598851,0,0,0.2344324521069951,0,0,9210756,3588143
Switzerland,2021-12-01,12917470,12917470,118571,https://www.covid19.admin.ch/en/overview?ovTime=total,9294796,3622674,94748,23823,0.20091759367804943,94748,23823,9305504,3611966
Switzerland,2021-12-02,12981167,12981167,63697,https://www.covid19.admin.ch/en/overview?ovTime=total,9347592,3633575,52796,10901,0.17113835816443473,52796,10901,9358300,3622867
Switzerland,2021-12-03,12981167,12981167,0,https://www.covid19.admin.ch/en/overview?ovTime=total,9347592,3633575,0,0,0.17113835816443473,0,0,9358300,3622867
Switzerland,2021-12-04,13046527,13046527,65360,https://www.covid19.admin.ch/en/overview?ovTime=total,9400965,3645562,53373,11987,0.18339963280293758,53373,11987,9411673,3634854
Switzerland,2021-12-05,13046527,13046527,0,https://www.covid19.admin.ch/en/overview?ovTime=total,9400965,3645562,0,0,0.18339963280293758,0,0,9411673,3634854
Switzerland,2021-12-06,13205749,13205749,159222,https://www.covid19.admin.ch/en/overview?ovTime=total,9527782,3677967,126817,32405,0.20352087023150067,126817,32405,9538490,3667259
Switzerland,2021-12-07,13265137,13265137,59388,https://www.covid19.admin.ch/en/overview?ovTime=total,9572859,3692278,45077,14311,0.24097460766484813,45077,14311,9583567,3681570
Switzerland,2021-12-08,13265137,13265137,0,https://www.covid19.admin.ch/en/overview?ovTime=total,9572859,3692278,0,0,0.24097460766484813,0,0,9583567,3681570
Switzerland,2021-12-09,13413422,13413422,148285,https://www.covid19.admin.ch/en/overview?ovTime=total,9696445,3716977,123586,24699,0.16656438614829552,123586,24699,9707153,3706269
Switzerland,2021-12-10,13482379,13482379,68957,https://www.covid19.admin.ch/en/overview?ovTime=total,9751381,3730998,54936,14021,0.20332961120698406,54936,14021,9762089,3720290
Switzerland,2021-12-11,13482379,13482379,0,https://www.covid19.admin.ch/en/overview?ovTime=total,9751381,3730998,0,0,0.20332961120698406,0,0,9762089,3720290
Switzerland,2021-12-12,13482379,13482379,0,https://www.covid19.admin.ch/en/overview?ovTime=total,9751381,3730998,0,0,0.20332961120698406,0,0,9762089,3720290
Switzerland,2021-12-13,13482379,13482379,0,https://www.covid19.admin.ch/en/overview?ovTime=total,9751381,3730998,0,0,0.20332961120698406,0,0,9762089,3720290
Switzerland,2021-12-14,13690087,13690087,207708,https://www.covid19.admin.ch/en/overview?ovTime=total,9910847,3779240,159466,48242,0.23225874785756928,159466,48242,9921555,3768532
Switzerland,2021-12-15,13482379,13690087,0,https://www.covid19.admin.ch/en/overview?ovTime=total,9751381,3730998,-159466,-48242,0.23225874785756928,0,0,9921555,3768532
Switzerland,2021-12-16,13843738,13843738,153651,https://www.covid19.admin.ch/en/overview?ovTime=total,10038650,3805088,287269,74090,0.20503156141122816,122148,31503,10043703,3800035
Switzerland,2021-12-17,13915729,13915729,71991,https://www.covid19.admin.ch/en/overview?ovTime=total,10096669,3819060,58019,13972,0.19407981553249712,58019,13972,10101722,3814007
Switzerland,2021-12-18,13915729,13915729,0,https://www.covid19.admin.ch/en/overview?ovTime=total,10096669,3819060,0,0,0.19407981553249712,0,0,10101722,3814007
Switzerland,2021-12-19,13915729,13915729,0,https://www.covid19.admin.ch/en/overview?ovTime=total,10096669,3819060,0,0,0.19407981553249712,0,0,10101722,3814007
Switzerland,2021-12-20,13915729,13915729,0,https://www.covid19.admin.ch/en/overview?ovTime=total,10096669,3819060,0,0,0.19407981553249712,0,0,10101722,3814007
Switzerland,2021-12-21,14123609,14123609,207880,https://www.covid19.admin.ch/en/overview?ovTime=total,10250569,3873040,153900,53980,0.2596690398306715,153900,53980,10255622,3867987
Switzerland,2021-12-22,14194602,14194602,70993,https://www.covid19.admin.ch/en/overview?ovTime=total,10308263,3886339,57694,13299,0.1873283281450284,57694,13299,10313316,3881286
Switzerland,2021-12-23,14267622,14267622,73020,https://www.covid19.admin.ch/en/overview?ovTime=total,10366640,3900982,58377,14643,0.2005341002465078,58377,14643,10371693,3895929
Switzerland,2021-12-24,14267622,14267622,0,https://www.covid19.admin.ch/en/overview?ovTime=total,10366640,3900982,0,0,0.2005341002465078,0,0,10371693,3895929
Switzerland,2021-12-25,14267622,14267622,0,https://www.covid19.admin.ch/en/overview?ovTime=total,10366640,3900982,0,0,0.2005341002465078,0,0,10371693,3895929
Switzerland,2021-12-26,14267622,14267622,0,https://www.covid19.admin.ch/en/overview?ovTime=total,10366640,3900982,0,0,0.2005341002465078,0,0,10371693,3895929
Switzerland,2021-12-27,14267622,14267622,0,https://www.covid19.admin.ch/en/overview?ovTime=total,10366640,3900982,0,0,0.2005341002465078,0,0,10371693,3895929
Switzerland,2021-12-28,14267622,14267622,0,https://www.covid19.admin.ch/en/overview?ovTime=total,10366640,3900982,0,0,0.2005341002465078,0,0,10371693,3895929
Switzerland,2021-12-29,14267622,14267622,0,https://www.covid19.admin.ch/en/overview?ovTime=total,10366640,3900982,0,0,0.2005341002465078,0,0,10371693,3895929
Switzerland,2021-12-30,14267622,14267622,0,https://www.covid19.admin.ch/en/overview?ovTime=total,10366640,3900982,0,0,0.2005341002465078,0,0,10371693,3895929
Switzerland,2021-12-31,14267622,14267622,0,https://www.covid19.admin.ch/en/overview?ovTime=total,10366640,3900982,0,0,0.2005341002465078,0,0,10371693,3895929
Switzerland,2022-01-01,14267622,14267622,0,https://www.covid19.admin.ch/en/overview?ovTime=total,10366640,3900982,0,0,0.2005341002465078,0,0,10371693,3895929
Switzerland,2022-01-02,14267622,14267622,0,https://www.covid19.admin.ch/en/overview?ovTime=total,10366640,3900982,0,0,0.2005341002465078,0,0,10371693,3895929
Switzerland,2022-01-03,14267622,14267622,0,https://www.covid19.admin.ch/en/overview?ovTime=total,10366640,3900982,0,0,0.2005341002465078,0,0,10371693,3895929
Switzerland,2022-01-04,14267622,14267622,0,https://www.covid19.admin.ch/en/overview?ovTime=total,10366640,3900982,0,0,0.2005341002465078,0,0,10371693,3895929
Switzerland,2022-01-05,14267622,14267622,0,https://www.covid19.admin.ch/en/overview?ovTime=total,10366640,3900982,0,0,0.2005341002465078,0,0,10371693,3895929
Switzerland,2022-01-06,15134537,15134537,866915,https://www.covid19.admin.ch/en/overview?ovTime=total,11032148,4102389,665508,201407,0.23232612193813695,665508,201407,11037201,4097336
Switzerland,2022-01-07,15134537,15134537,0,https://www.covid19.admin.ch/en/overview?ovTime=total,11032148,4102389,0,0,0.23232612193813695,0,0,11037201,4097336
Switzerland,2022-01-08,15229894,15229894,95357,https://www.covid19.admin.ch/en/overview?ovTime=total,11111776,4118118,79628,15729,0.16494856172069172,79628,15729,11116829,4113065
Switzerland,2022-01-09,15229894,15229894,0,https://www.covid19.admin.ch/en/overview?ovTime=total,11111776,4118118,0,0,0.16494856172069172,0,0,11116829,4113065
Switzerland,2022-01-10,15451583,15451583,221689,https://www.covid19.admin.ch/en/overview?ovTime=total,11291468,4160115,179692,41997,0.18944106383266648,179692,41997,11296521,4155062
Switzerland,2022-01-11,15451583,15451583,0,https://www.covid19.admin.ch/en/overview?ovTime=total,11291468,4160115,0,0,0.18944106383266648,0,0,11296521,4155062
Switzerland,2022-01-12,15451583,15451583,0,https://www.covid19.admin.ch/en/overview?ovTime=total,11291468,4160115,0,0,0.18944106383266648,0,0,11296521,4155062
Switzerland,2022-01-13,15451583,15451583,0,https://www.covid19.admin.ch/en/overview?ovTime=total,11291468,4160115,0,0,0.18944106383266648,0,0,11296521,4155062
Switzerland,2022-01-14,15832276,15832276,380693,https://www.covid19.admin.ch/en/overview?ovTime=total,11608223,4224053,316755,63938,0.16795160404840645,316755,63938,11613276,4219000
Switzerland,2022-01-15,15832276,15832276,0,https://www.covid19.admin.ch/en/overview?ovTime=total,11608223,4224053,0,0,0.16795160404840645,0,0,11613276,4219000
Switzerland,2022-01-16,15832276,15832276,0,https://www.covid19.admin.ch/en/overview?ovTime=total,11608223,4224053,0,0,0.16795160404840645,0,0,11613276,4219000
Switzerland,2022-01-17,16051466,16051466,219190,https://www.covid19.admin.ch/en/overview?ovTime=total,11787422,4264044,179199,39991,0.18244901683470963,179199,39991,11792475,4258991
Switzerland,2022-01-18,16051466,16051466,0,https://www.covid19.admin.ch/en/overview?ovTime=total,11787422,4264044,0,0,0.18244901683470963,0,0,11792475,4258991
Switzerland,2022-01-19,16051466,16051466,0,https://www.covid19.admin.ch/en/overview?ovTime=total,11787422,4264044,0,0,0.18244901683470963,0,0,11792475,4258991
Switzerland,2022-01-20,16341549,16341549,290083,https://www.covid19.admin.ch/en/overview?ovTime=total,12026854,4314695,239432,50651,0.17460864649083194,239432,50651,12031907,4309642
Switzerland,2022-01-21,16453469,16453469,111920,https://www.covid19.admin.ch/en/overview?ovTime=total,12123203,4330266,96349,15571,0.13912616154395996,96349,15571,12128256,4325213
Switzerland,2022-01-22,16453469,16453469,0,https://www.covid19.admin.ch/en/overview?ovTime=total,12123203,4330266,0,0,0.13912616154395996,0,0,12128256,4325213
Switzerland,2022-01-23,16453469,16453469,0,https://www.covid19.admin.ch/en/overview?ovTime=total,12123203,4330266,0,0,0.13912616154395996,0,0,12128256,4325213
Switzerland,2022-01-24,16453469,16453469,0,https://www.covid19.admin.ch/en/overview?ovTime=total,12123203,4330266,0,0,0.13912616154395996,0,0,12128256,4325213
Switzerland,2022-01-25,16766073,16766073,312604,https://www.covid19.admin.ch/en/overview?ovTime=total,12395000,4371073,271797,40807,0.1305389566352318,271797,40807,12400053,4366020
Switzerland,2022-01-26,16766073,16766073,0,https://www.covid19.admin.ch/en/overview?ovTime=total,12395000,4371073,0,0,0.1305389566352318,0,0,12400053,4366020
Switzerland,2022-01-27,17043543,17043543,277470,https://www.covid19.admin.ch/en/overview?ovTime=total,12614914,4428629,219914,57556,0.20743143402890402,219914,57556,12619967,4423576
Switzerland,2022-01-28,17157999,17157999,114456,https://www.covid19.admin.ch/en/overview?ovTime=total,12711567,4446432,96653,17803,0.1555444887118194,96653,17803,12716620,4441379
Switzerland,2022-01-29,17157999,17157999,0,https://www.covid19.admin.ch/en/overview?ovTime=total,12711567,4446432,0,0,0.1555444887118194,0,0,12716620,4441379
Switzerland,2022-01-30,17157999,17157999,0,https://www.covid19.admin.ch/en/overview?ovTime=total,12711567,4446432,0,0,0.1555444887118194,0,0,12716620,4441379
Switzerland,2022-01-31,17415322,17415322,257323,https://www.covid19.admin.ch/en/overview?ovTime=total,12920727,4494595,209160,48163,0.18716943296945862,209160,48163,12925780,4489542
Switzerland,2022-02-01,17504003,17504003,88681,https://www.covid19.admin.ch/en/overview?ovTime=total,12988970,4515033,68243,20438,0.2304665035351428,68243,20438,12994023,4509980
Switzerland,2022-02-02,17415322,17504003,0,https://www.covid19.admin.ch/en/overview?ovTime=total,12920727,4494595,-68243,-20438,0.2304665035351428,0,0,12994023,4509980
Switzerland,2022-02-03,17720648,17720648,216645,https://www.covid19.admin.ch/en/overview?ovTime=total,13171809,4548839,251082,54244,0.1776592887602104,178156,38489,13172179,4548469
Switzerland,2022-02-04,17819425,17819425,98777,https://www.covid19.admin.ch/en/overview?ovTime=total,13256207,4563218,84398,14379,0.14557032507567552,84398,14379,13256577,4562848
Switzerland,2022-02-05,17819425,17819425,0,https://www.covid19.admin.ch/en/overview?ovTime=total,13256207,4563218,0,0,0.14557032507567552,0,0,13256577,4562848
Switzerland,2022-02-06,17819425,17819425,0,https://www.covid19.admin.ch/en/overview?ovTime=total,13256207,4563218,0,0,0.14557032507567552,0,0,13256577,4562848
Switzerland,2022-02-07,18003879,18003879,184454,https://www.covid19.admin.ch/en/overview?ovTime=total,13399520,4604359,143313,41141,0.22304205926680906,143313,41141,13399890,4603989
Switzerland,2022-02-08,18003879,18003879,0,https://www.covid19.admin.ch/en/overview?ovTime=total,13399520,4604359,0,0,0.22304205926680906,0,0,13399890,4603989
Switzerland,2022-02-09,18003879,18003879,0,https://www.covid19.admin.ch/en/overview?ovTime=total,13399520,4604359,0,0,0.22304205926680906,0,0,13399890,4603989
Switzerland,2022-02-10,18162246,18162246,158367,https://www.covid19.admin.ch/en/overview?ovTime=total,13529797,4632449,130277,28090,0.17737281125487,130277,28090,13530167,4632079
Switzerland,2022-02-11,18321706,18321706,159460,https://www.covid19.admin.ch/en/overview?ovTime=total,13399520,4604359,-130277,-28090,0.17737281125487,131176,28284,13661343,4660363
Switzerland,2022-02-12,18321706,18321706,0,https://www.covid19.admin.ch/en/overview?ovTime=total,13399520,4604359,0,0,0.17737281125487,0,0,13661343,4660363
Switzerland,2022-02-13,18321706,18321706,0,https://www.covid19.admin.ch/en/overview?ovTime=total,13665118,4656588,265598,52229,0.16433153885604432,0,0,13661343,4660363
Switzerland,2022-02-14,18321706,18321706,0,https://www.covid19.admin.ch/en/overview?ovTime=total,13399520,4604359,-265598,-52229,0.16433153885604432,0,0,13661343,4660363
Switzerland,2022-02-15,18533497,18533497,211791,https://www.covid19.admin.ch/en/overview?ovTime=total,13830359,4703138,430839,98779,0.18650989958800493,172290,39501,13833633,4699864
Switzerland,2022-02-16,18609194,18609194,75697,https://www.covid19.admin.ch/en/overview?ovTime=total,13890149,4719045,59790,15907,0.21014042828645785,59790,15907,13893423,4715771
Switzerland,2022-02-17,18677919,18677919,68725,https://www.covid19.admin.ch/en/overview?ovTime=total,13948717,4729202,58568,10157,0.14779192433612223,58568,10157,13951991,4725928
Switzerland,2022-02-18,18734992,18734992,57073,https://www.covid19.admin.ch/en/overview?ovTime=total,13998660,4736332,49943,7130,0.12492772414276453,49943,7130,14001934,4733058
Switzerland,2022-02-19,18734992,18734992,0,https://www.covid19.admin.ch/en/overview?ovTime=total,13998660,4736332,0,0,0.12492772414276453,0,0,14001934,4733058
Switzerland,2022-02-20,18734992,18734992,0,https://www.covid19.admin.ch/en/overview?ovTime=total,13998660,4736332,0,0,0.12492772414276453,0,0,14001934,4733058
Switzerland,2022-02-21,18832639,18832639,97647,https://www.covid19.admin.ch/en/overview?ovTime=total,14079385,4753254,80725,16922,0.17329769475764745,80725,16922,14082659,4749980
Switzerland,2022-02-22,18880166,18880166,47527,https://www.covid19.admin.ch/en/overview?ovTime=total,14118250,4761916,38865,8662,0.18225429755717804,38865,8662,14121524,4758642
Switzerland,2022-02-23,18933503,18933503,53337,https://www.covid19.admin.ch/en/overview?ovTime=total,14164547,4768956,46297,7040,0.13199092562386336,46297,7040,14167821,4765682
Switzerland,2022-02-24,18984300,18984300,50797,https://www.covid19.admin.ch/en/overview?ovTime=total,14207551,4776749,43004,7793,0.15341457172667677,43004,7793,14210825,4773475
Switzerland,2022-02-25,19034621,19034621,50321,https://www.covid19.admin.ch/en/overview?ovTime=total,14250584,4784037,43033,7288,0.1448301901790505,43033,7288,14253858,4780763
Switzerland,2022-02-26,19034621,19034621,0,https://www.covid19.admin.ch/en/overview?ovTime=total,14250584,4784037,0,0,0.1448301901790505,0,0,14253858,4780763
Switzerland,2022-02-27,19034621,19034621,0,https://www.covid19.admin.ch/en/overview?ovTime=total,14250584,4784037,0,0,0.1448301901790505,0,0,14253858,4780763
Switzerland,2022-02-28,19134654,19134654,100033,https://www.covid19.admin.ch/en/overview?ovTime=total,14333216,4801438,82632,17401,0.17395259564343765,82632,17401,14336490,4798164
Switzerland,2022-03-01,19175682,19175682,41028,https://www.covid19.admin.ch/en/overview?ovTime=total,14365215,4810467,31999,9029,0.22006922101979137,31999,9029,14368489,4807193
Switzerland,2022-03-02,19231376,19231376,55694,https://www.covid19.admin.ch/en/overview?ovTime=total,14411549,4819827,46334,9360,0.1680611915107552,46334,9360,14414823,4816553
Switzerland,2022-03-03,19284573,19284573,53197,https://www.covid19.admin.ch/en/overview?ovTime=total,14455315,4829258,43766,9431,0.17728443333270674,43766,9431,14458589,4825984
Switzerland,2022-03-04,19344681,19344681,60108,https://www.covid19.admin.ch/en/overview?ovTime=total,14505703,4838978,50388,9720,0.16170892393691355,50388,9720,14508977,4835704
Switzerland,2022-03-05,19344681,19344681,0,https://www.covid19.admin.ch/en/overview?ovTime=total,14505703,4838978,0,0,0.16170892393691355,0,0,14508977,4835704
Switzerland,2022-03-06,19344681,19344681,0,https://www.covid19.admin.ch/en/overview?ovTime=total,14505703,4838978,0,0,0.16170892393691355,0,0,14508977,4835704
Switzerland,2022-03-07,19473585,19473585,128904,https://www.covid19.admin.ch/en/overview?ovTime=total,14612087,4861498,106384,22520,0.1747036554335009,106384,22520,14615361,4858224
Switzerland,2022-03-08,19526135,19526135,52550,https://www.covid19.admin.ch/en/overview?ovTime=total,14651902,4874233,39815,12735,0.2423406279733587,39815,12735,14655176,4870959
Switzerland,2022-03-09,19597696,19597696,71561,https://www.covid19.admin.ch/en/overview?ovTime=total,14712834,4884862,60932,10629,0.14853062422269114,60932,10629,14716108,4881588
Switzerland,2022-03-10,19667077,19667077,69381,https://www.covid19.admin.ch/en/overview?ovTime=total,14770297,4896780,57463,11918,0.17177613467664057,57463,11918,14773571,4893506
Switzerland,2022-03-11,19735006,19735006,67929,https://www.covid19.admin.ch/en/overview?ovTime=total,14827099,4907907,56802,11127,0.1638033829439562,56802,11127,14830373,4904633
Switzerland,2022-03-12,19735006,19735006,0,https://www.covid19.admin.ch/en/overview?ovTime=total,14827099,4907907,0,0,0.1638033829439562,0,0,14830373,4904633
Switzerland,2022-03-13,19735006,19735006,0,https://www.covid19.admin.ch/en/overview?ovTime=total,14827099,4907907,0,0,0.1638033829439562,0,0,14830373,4904633
Switzerland,2022-03-14,19883559,19883559,148553,https://www.covid19.admin.ch/en/overview?ovTime=total,14950677,4932882,123578,24975,0.1681218151097588,123578,24975,14953951,4929608
Switzerland,2022-03-15,19951466,19951466,67907,https://www.covid19.admin.ch/en/overview?ovTime=total,14999507,4951959,48830,19077,0.28092832844920257,48830,19077,15002781,4948685
Switzerland,2022-03-16,20030792,20030792,79326,https://www.covid19.admin.ch/en/overview?ovTime=total,15067396,4963396,67889,11437,0.14417719284975922,67889,11437,15070670,4960122
Switzerland,2022-03-17,20112698,20112698,81906,https://www.covid19.admin.ch/en/overview?ovTime=total,15137832,4974866,70436,11470,0.1400385808121505,70436,11470,15141106,4971592
Switzerland,2022-03-18,20176510,20176510,63812,https://www.covid19.admin.ch/en/overview?ovTime=total,15191647,4984863,53815,9997,0.1566633235128189,53815,9997,15194921,4981589
Switzerland,2022-03-19,20176510,20176510,0,https://www.covid19.admin.ch/en/overview?ovTime=total,15191647,4984863,0,0,0.1566633235128189,0,0,15194921,4981589
Switzerland,2022-03-20,20176510,20176510,0,https://www.covid19.admin.ch/en/overview?ovTime=total,15191647,4984863,0,0,0.1566633235128189,0,0,15194921,4981589
Switzerland,2022-03-21,20310712,20310712,134202,https://www.covid19.admin.ch/en/overview?ovTime=total,15303870,5006842,112223,21979,0.16377550260055737,112223,21979,15307144,5003568
Switzerland,2022-03-22,20366257,20366257,55545,https://www.covid19.admin.ch/en/overview?ovTime=total,15347022,5019235,43152,12393,0.22311639211450177,43152,12393,15350296,5015961
Switzerland,2022-03-23,20434787,20434787,68530,https://www.covid19.admin.ch/en/overview?ovTime=total,15406246,5028541,59224,9306,0.13579454253611556,59224,9306,15409520,5025267
Switzerland,2022-03-24,20493186,20493186,58399,https://www.covid19.admin.ch/en/overview?ovTime=total,15455795,5037391,49549,8850,0.15154369081662358,49549,8850,15459069,5034117
Switzerland,2022-03-25,20543650,20543650,50464,https://www.covid19.admin.ch/en/overview?ovTime=total,15498892,5044758,43097,7367,0.14598525681674066,43097,7367,15502166,5041484
Switzerland,2022-03-26,20543650,20543650,0,https://www.covid19.admin.ch/en/overview?ovTime=total,15498892,5044758,0,0,0.14598525681674066,0,0,15502166,5041484
Switzerland,2022-03-27,20543650,20543650,0,https://www.covid19.admin.ch/en/overview?ovTime=total,15498892,5044758,0,0,0.14598525681674066,0,0,15502166,5041484
Switzerland,2022-03-28,20637533,20637533,93883,https://www.covid19.admin.ch/en/overview?ovTime=total,15576296,5061237,77404,16479,0.17552698571626385,77404,16479,15579570,5057963
Switzerland,2022-03-29,20679229,20679229,41696,https://www.covid19.admin.ch/en/overview?ovTime=total,15609527,5069702,33231,8465,0.20301707597851112,33231,8465,15612801,5066428
Switzerland,2022-03-30,20728514,20728514,49285,https://www.covid19.admin.ch/en/overview?ovTime=total,15651634,5076880,42107,7178,0.14564269047377498,42107,7178,15654908,5073606
Switzerland,2022-03-31,20770299,20770299,41785,https://www.covid19.admin.ch/en/overview?ovTime=total,15686675,5083624,35041,6744,0.1613976307287304,35041,6744,15689949,5080350
Switzerland,2022-04-01,20805385,20805385,35086,https://www.covid19.admin.ch/en/overview?ovTime=total,15716492,5088893,29817,5269,0.15017385851906742,29817,5269,15719766,5085619
Switzerland,2022-04-02,20805385,20805385,0,https://www.covid19.admin.ch/en/overview?ovTime=total,15716492,5088893,0,0,0.15017385851906742,0,0,15719766,5085619
Switzerland,2022-04-03,20805385,20805385,0,https://www.covid19.admin.ch/en/overview?ovTime=total,15716492,5088893,0,0,0.15017385851906742,0,0,15719766,5085619
Switzerland,2022-04-04,20805385,20805385,0,https://www.covid19.admin.ch/en/overview?ovTime=total,15716492,5088893,0,0,0.15017385851906742,0,0,15719766,5085619
Switzerland,2022-04-05,20881422,20881422,76037,https://www.covid19.admin.ch/en/overview?ovTime=total,15777220,5104202,60728,15309,0.201336191590936,60728,15309,15780494,5100928
Switzerland,2022-04-06,20881422,20881422,0,https://www.covid19.admin.ch/en/overview?ovTime=total,15777220,5104202,0,0,0.201336191590936,0,0,15780494,5100928
Switzerland,2022-04-07,20881422,20881422,0,https://www.covid19.admin.ch/en/overview?ovTime=total,15777220,5104202,0,0,0.201336191590936,0,0,15780494,5100928
Switzerland,2022-04-08,20881422,20881422,0,https://www.covid19.admin.ch/en/overview?ovTime=total,15777220,5104202,0,0,0.201336191590936,0,0,15780494,5100928
Switzerland,2022-04-09,20881422,20881422,0,https://www.covid19.admin.ch/en/overview?ovTime=total,15777220,5104202,0,0,0.201336191590936,0,0,15780494,5100928
Switzerland,2022-04-10,20881422,20881422,0,https://www.covid19.admin.ch/en/overview?ovTime=total,15777220,5104202,0,0,0.201336191590936,0,0,15780494,5100928
Switzerland,2022-04-11,20881422,20881422,0,https://www.covid19.admin.ch/en/overview?ovTime=total,15777220,5104202,0,0,0.201336191590936,0,0,15780494,5100928
Switzerland,2022-04-12,21030611,21030611,149189,https://www.covid19.admin.ch/en/overview?ovTime=total,15895255,5135356,118035,31154,0.20882236626024706,118035,31154,15898529,5132082
Switzerland,2022-04-13,21030611,21030611,0,https://www.covid19.admin.ch/en/overview?ovTime=total,15895255,5135356,0,0,0.20882236626024706,0,0,15898529,5132082
Switzerland,2022-04-14,21030611,21030611,0,https://www.covid19.admin.ch/en/overview?ovTime=total,15895255,5135356,0,0,0.20882236626024706,0,0,15898529,5132082
Switzerland,2022-04-15,21030611,21030611,0,https://www.covid19.admin.ch/en/overview?ovTime=total,15895255,5135356,0,0,0.20882236626024706,0,0,15898529,5132082
Switzerland,2022-04-16,21030611,21030611,0,https://www.covid19.admin.ch/en/overview?ovTime=total,15895255,5135356,0,0,0.20882236626024706,0,0,15898529,5132082
Switzerland,2022-04-17,21030611,21030611,0,https://www.covid19.admin.ch/en/overview?ovTime=total,15895255,5135356,0,0,0.20882236626024706,0,0,15898529,5132082
Switzerland,2022-04-18,21030611,21030611,0,https://www.covid19.admin.ch/en/overview?ovTime=total,15895255,5135356,0,0,0.20882236626024706,0,0,15898529,5132082
Switzerland,2022-04-19,21149454,21149454,118843,https://www.covid19.admin.ch/en/overview?ovTime=total,15985051,5164403,89796,29047,0.24441490033068838,89796,29047,15988325,5161129
Switzerland,2022-04-20,21149454,21149454,0,https://www.covid19.admin.ch/en/overview?ovTime=total,15985051,5164403,0,0,0.24441490033068838,0,0,15988325,5161129
Switzerland,2022-04-21,21149454,21149454,0,https://www.covid19.admin.ch/en/overview?ovTime=total,15985051,5164403,0,0,0.24441490033068838,0,0,15988325,5161129
Switzerland,2022-04-22,21149454,21149454,0,https://www.covid19.admin.ch/en/overview?ovTime=total,15985051,5164403,0,0,0.24441490033068838,0,0,15988325,5161129
Switzerland,2022-04-23,21149454,21149454,0,https://www.covid19.admin.ch/en/overview?ovTime=total,15985051,5164403,0,0,0.24441490033068838,0,0,15988325,5161129
Switzerland,2022-04-24,21149454,21149454,0,https://www.covid19.admin.ch/en/overview?ovTime=total,15985051,5164403,0,0,0.24441490033068838,0,0,15988325,5161129
Switzerland,2022-04-25,21149454,21149454,0,https://www.covid19.admin.ch/en/overview?ovTime=total,15985051,5164403,0,0,0.24441490033068838,0,0,15988325,5161129
Switzerland,2022-04-26,21251186,21251186,101732,https://www.covid19.admin.ch/en/overview?ovTime=total,16064183,5187003,79132,22600,0.22215232178665514,79132,22600,16067457,5183729
Switzerland,2022-04-27,21251186,21251186,0,https://www.covid19.admin.ch/en/overview?ovTime=total,16064183,5187003,0,0,0.22215232178665514,0,0,16067457,5183729
Switzerland,2022-04-28,21251186,21251186,0,https://www.covid19.admin.ch/en/overview?ovTime=total,16064183,5187003,0,0,0.22215232178665514,0,0,16067457,5183729
Switzerland,2022-04-29,21251186,21251186,0,https://www.covid19.admin.ch/en/overview?ovTime=total,16064183,5187003,0,0,0.22215232178665514,0,0,16067457,5183729
Switzerland,2022-04-30,21251186,21251186,0,https://www.covid19.admin.ch/en/overview?ovTime=total,16064183,5187003,0,0,0.22215232178665514,0,0,16067457,5183729
Switzerland,2022-05-01,21251186,21251186,0,https://www.covid19.admin.ch/en/overview?ovTime=total,16064183,5187003,0,0,0.22215232178665514,0,0,16067457,5183729
Switzerland,2022-05-02,21251186,21251186,0,https://www.covid19.admin.ch/en/overview?ovTime=total,16064183,5187003,0,0,0.22215232178665514,0,0,16067457,5183729
Switzerland,2022-05-03,21335828,21335828,84642,https://www.covid19.admin.ch/en/overview?ovTime=total,16130111,5205717,65928,18714,0.2210959098319983,65928,18714,16133385,5202443
Switzerland,2022-05-04,21335828,21335828,0,https://www.covid19.admin.ch/en/overview?ovTime=total,16130111,5205717,0,0,0.2210959098319983,0,0,16133385,5202443
Switzerland,2022-05-05,21335828,21335828,0,https://www.covid19.admin.ch/en/overview?ovTime=total,16130111,5205717,0,0,0.2210959098319983,0,0,16133385,5202443
Switzerland,2022-05-06,21335828,21335828,0,https://www.covid19.admin.ch/en/overview?ovTime=total,16130111,5205717,0,0,0.2210959098319983,0,0,16133385,5202443
Switzerland,2022-05-07,21335828,21335828,0,https://www.covid19.admin.ch/en/overview?ovTime=total,16130111,5205717,0,0,0.2210959098319983,0,0,16133385,5202443
Switzerland,2022-05-08,21335828,21335828,0,https://www.covid19.admin.ch/en/overview?ovTime=total,16130111,5205717,0,0,0.2210959098319983,0,0,16133385,5202443
Switzerland,2022-05-09,21335828,21335828,0,https://www.covid19.admin.ch/en/overview?ovTime=total,16130111,5205717,0,0,0.2210959098319983,0,0,16133385,5202443
Switzerland,2022-05-10,21411781,21411781,75953,https://www.covid19.admin.ch/en/overview?ovTime=total,16186666,5225115,56555,19398,0.2553947836161837,56555,19398,16189940,5221841
Switzerland,2022-05-11,21411781,21411781,0,https://www.covid19.admin.ch/en/overview?ovTime=total,16186666,5225115,0,0,0.2553947836161837,0,0,16189940,5221841
Switzerland,2022-05-12,21411781,21411781,0,https://www.covid19.admin.ch/en/overview?ovTime=total,16186666,5225115,0,0,0.2553947836161837,0,0,16189940,5221841
Switzerland,2022-05-13,21411781,21411781,0,https://www.covid19.admin.ch/en/overview?ovTime=total,16186666,5225115,0,0,0.2553947836161837,0,0,16189940,5221841
Switzerland,2022-05-14,21411781,21411781,0,https://www.covid19.admin.ch/en/overview?ovTime=total,16186666,5225115,0,0,0.2553947836161837,0,0,16189940,5221841
Switzerland,2022-05-15,21411781,21411781,0,https://www.covid19.admin.ch/en/overview?ovTime=total,16186666,5225115,0,0,0.2553947836161837,0,0,16189940,5221841
Switzerland,2022-05-16,21411781,21411781,0,https://www.covid19.admin.ch/en/overview?ovTime=total,16186666,5225115,0,0,0.2553947836161837,0,0,16189940,5221841
Switzerland,2022-05-17,21476194,21476194,64413,https://www.covid19.admin.ch/en/overview?ovTime=total,16234425,5241769,47759,16654,0.2585502926427895,47759,16654,16237699,5238495
Switzerland,2022-05-18,21476194,21476194,0,https://www.covid19.admin.ch/en/overview?ovTime=total,16234425,5241769,0,0,0.2585502926427895,0,0,16237699,5238495
Switzerland,2022-05-19,21476194,21476194,0,https://www.covid19.admin.ch/en/overview?ovTime=total,16234425,5241769,0,0,0.2585502926427895,0,0,16237699,5238495
Switzerland,2022-05-20,21476194,21476194,0,https://www.covid19.admin.ch/en/overview?ovTime=total,16234425,5241769,0,0,0.2585502926427895,0,0,16237699,5238495
Switzerland,2022-05-21,21476194,21476194,0,https://www.covid19.admin.ch/en/overview?ovTime=total,16234425,5241769,0,0,0.2585502926427895,0,0,16237699,5238495
Switzerland,2022-05-22,21476194,21476194,0,https://www.covid19.admin.ch/en/overview?ovTime=total,16234425,5241769,0,0,0.2585502926427895,0,0,16237699,5238495
Switzerland,2022-05-23,21476194,21476194,0,https://www.covid19.admin.ch/en/overview?ovTime=total,16234425,5241769,0,0,0.2585502926427895,0,0,16237699,5238495
Switzerland,2022-05-24,21538651,21538651,62457,https://www.covid19.admin.ch/en/overview?ovTime=total,16278619,5260032,44194,18263,0.2924091775141297,44194,18263,16281893,5256758
Switzerland,2022-05-25,21538651,21538651,0,https://www.covid19.admin.ch/en/overview?ovTime=total,16278619,5260032,0,0,0.2924091775141297,0,0,16281893,5256758
Switzerland,2022-05-26,21538651,21538651,0,https://www.covid19.admin.ch/en/overview?ovTime=total,16278619,5260032,0,0,0.2924091775141297,0,0,16281893,5256758
Switzerland,2022-05-27,21538651,21538651,0,https://www.covid19.admin.ch/en/overview?ovTime=total,16278619,5260032,0,0,0.2924091775141297,0,0,16281893,5256758
Switzerland,2022-05-28,21538651,21538651,0,https://www.covid19.admin.ch/en/overview?ovTime=total,16278619,5260032,0,0,0.2924091775141297,0,0,16281893,5256758
Switzerland,2022-05-29,21538651,21538651,0,https://www.covid19.admin.ch/en/overview?ovTime=total,16278619,5260032,0,0,0.2924091775141297,0,0,16281893,5256758
Switzerland,2022-05-30,21538651,21538651,0,https://www.covid19.admin.ch/en/overview?ovTime=total,16278619,5260032,0,0,0.2924091775141297,0,0,16281893,5256758
Switzerland,2022-05-31,21589562,21589562,50911,https://www.covid19.admin.ch/en/overview?ovTime=total,16312178,5277384,33559,17352,0.3408300760150066,33559,17352,16315452,5274110
Switzerland,2022-06-01,21589562,21589562,0,https://www.covid19.admin.ch/en/overview?ovTime=total,16312178,5277384,0,0,0.3408300760150066,0,0,16315452,5274110
Switzerland,2022-06-02,21589562,21589562,0,https://www.covid19.admin.ch/en/overview?ovTime=total,16312178,5277384,0,0,0.3408300760150066,0,0,16315452,5274110
Switzerland,2022-06-03,21589562,21589562,0,https://www.covid19.admin.ch/en/overview?ovTime=total,16312178,5277384,0,0,0.3408300760150066,0,0,16315452,5274110
Switzerland,2022-06-04,21589562,21589562,0,https://www.covid19.admin.ch/en/overview?ovTime=total,16312178,5277384,0,0,0.3408300760150066,0,0,16315452,5274110
Switzerland,2022-06-05,21589562,21589562,0,https://www.covid19.admin.ch/en/overview?ovTime=total,16312178,5277384,0,0,0.3408300760150066,0,0,16315452,5274110
Switzerland,2022-06-06,21589562,21589562,0,https://www.covid19.admin.ch/en/overview?ovTime=total,16312178,5277384,0,0,0.3408300760150066,0,0,16315452,5274110
Switzerland,2022-06-07,21638693,21638693,49131,https://www.covid19.admin.ch/en/overview?ovTime=total,16343883,5294810,31705,17426,0.3546844151350471,31705,17426,16347157,5291536
Switzerland,2022-06-08,21638693,21638693,0,https://www.covid19.admin.ch/en/overview?ovTime=total,16343883,5294810,0,0,0.3546844151350471,0,0,16347157,5291536
Switzerland,2022-06-09,21638693,21638693,0,https://www.covid19.admin.ch/en/overview?ovTime=total,16343883,5294810,0,0,0.3546844151350471,0,0,16347157,5291536
Switzerland,2022-06-10,21638693,21638693,0,https://www.covid19.admin.ch/en/overview?ovTime=total,16343883,5294810,0,0,0.3546844151350471,0,0,16347157,5291536
Switzerland,2022-06-11,21638693,21638693,0,https://www.covid19.admin.ch/en/overview?ovTime=total,16343883,5294810,0,0,0.3546844151350471,0,0,16347157,5291536
Switzerland,2022-06-12,21638693,21638693,0,https://www.covid19.admin.ch/en/overview?ovTime=total,16343883,5294810,0,0,0.3546844151350471,0,0,16347157,5291536
Switzerland,2022-06-13,21638693,21638693,0,https://www.covid19.admin.ch/en/overview?ovTime=total,16343883,5294810,0,0,0.3546844151350471,0,0,16347157,5291536
Switzerland,2022-06-14,21696409,21696409,57716,https://www.covid19.admin.ch/en/overview?ovTime=total,16384126,5312283,40243,17473,0.3027410076928408,40243,17473,16387400,5309009
Switzerland,2022-06-15,21696409,21696409,0,https://www.covid19.admin.ch/en/overview?ovTime=total,16384126,5312283,0,0,0.3027410076928408,0,0,16387400,5309009
Switzerland,2022-06-16,21696409,21696409,0,https://www.covid19.admin.ch/en/overview?ovTime=total,16384126,5312283,0,0,0.3027410076928408,0,0,16387400,5309009
Switzerland,2022-06-17,21696409,21696409,0,https://www.covid19.admin.ch/en/overview?ovTime=total,16384126,5312283,0,0,0.3027410076928408,0,0,16387400,5309009
Switzerland,2022-06-18,21696409,21696409,0,https://www.covid19.admin.ch/en/overview?ovTime=total,16384126,5312283,0,0,0.3027410076928408,0,0,16387400,5309009
Switzerland,2022-06-19,21696409,21696409,0,https://www.covid19.admin.ch/en/overview?ovTime=total,16384126,5312283,0,0,0.3027410076928408,0,0,16387400,5309009
Switzerland,2022-06-20,21696409,21696409,0,https://www.covid19.admin.ch/en/overview?ovTime=total,16384126,5312283,0,0,0.3027410076928408,0,0,16387400,5309009
Switzerland,2022-06-21,21763159,21763159,66750,https://www.covid19.admin.ch/en/overview?ovTime=total,16433915,5329244,49789,16961,0.25409737827715356,49789,16961,16437189,5325970
Switzerland,2022-06-22,21763159,21763159,0,https://www.covid19.admin.ch/en/overview?ovTime=total,16433915,5329244,0,0,0.25409737827715356,0,0,16437189,5325970
Switzerland,2022-06-23,21763159,21763159,0,https://www.covid19.admin.ch/en/overview?ovTime=total,16433915,5329244,0,0,0.25409737827715356,0,0,16437189,5325970
Switzerland,2022-06-24,21763159,21763159,0,https://www.covid19.admin.ch/en/overview?ovTime=total,16433915,5329244,0,0,0.25409737827715356,0,0,16437189,5325970
Switzerland,2022-06-25,21763159,21763159,0,https://www.covid19.admin.ch/en/overview?ovTime=total,16433915,5329244,0,0,0.25409737827715356,0,0,16437189,5325970
Switzerland,2022-06-26,21763159,21763159,0,https://www.covid19.admin.ch/en/overview?ovTime=total,16433915,5329244,0,0,0.25409737827715356,0,0,16437189,5325970
Switzerland,2022-06-27,21763159,21763159,0,https://www.covid19.admin.ch/en/overview?ovTime=total,16433915,5329244,0,0,0.25409737827715356,0,0,16437189,5325970
Switzerland,2022-06-28,21846062,21846062,82903,https://www.covid19.admin.ch/en/overview?ovTime=total,16496305,5349757,62390,20513,0.24743374787402145,62390,20513,16499579,5346483
Switzerland,2022-06-29,21846062,21846062,0,https://www.covid19.admin.ch/en/overview?ovTime=total,16496305,5349757,0,0,0.24743374787402145,0,0,16499579,5346483
Switzerland,2022-06-30,21846062,21846062,0,https://www.covid19.admin.ch/en/overview?ovTime=total,16496305,5349757,0,0,0.24743374787402145,0,0,16499579,5346483
Switzerland,2022-07-01,21846062,21846062,0,https://www.covid19.admin.ch/en/overview?ovTime=total,16496305,5349757,0,0,0.24743374787402145,0,0,16499579,5346483
Switzerland,2022-07-02,21846062,21846062,0,https://www.covid19.admin.ch/en/overview?ovTime=total,16496305,5349757,0,0,0.24743374787402145,0,0,16499579,5346483
Switzerland,2022-07-03,21846062,21846062,0,https://www.covid19.admin.ch/en/overview?ovTime=total,16496305,5349757,0,0,0.24743374787402145,0,0,16499579,5346483
Switzerland,2022-07-04,21846062,21846062,0,https://www.covid19.admin.ch/en/overview?ovTime=total,16496305,5349757,0,0,0.24743374787402145,0,0,16499579,5346483
Switzerland,2022-07-05,21954619,21954619,108557,https://www.covid19.admin.ch/en/overview?ovTime=total,16577544,5377075,81239,27318,0.2516466004034747,81239,27318,16580818,5373801
Switzerland,2022-07-06,21954619,21954619,0,https://www.covid19.admin.ch/en/overview?ovTime=total,16577544,5377075,0,0,0.2516466004034747,0,0,16580818,5373801
Switzerland,2022-07-07,21954619,21954619,0,https://www.covid19.admin.ch/en/overview?ovTime=total,16577544,5377075,0,0,0.2516466004034747,0,0,16580818,5373801
Switzerland,2022-07-08,21954619,21954619,0,https://www.covid19.admin.ch/en/overview?ovTime=total,16577544,5377075,0,0,0.2516466004034747,0,0,16580818,5373801
Switzerland,2022-07-09,21954619,21954619,0,https://www.covid19.admin.ch/en/overview?ovTime=total,16577544,5377075,0,0,0.2516466004034747,0,0,16580818,5373801
Switzerland,2022-07-10,21954619,21954619,0,https://www.covid19.admin.ch/en/overview?ovTime=total,16577544,5377075,0,0,0.2516466004034747,0,0,16580818,5373801
Switzerland,2022-07-11,21954619,21954619,0,https://www.covid19.admin.ch/en/overview?ovTime=total,16577544,5377075,0,0,0.2516466004034747,0,0,16580818,5373801
Switzerland,2022-07-12,22085364,22085364,130745,https://www.covid19.admin.ch/en/overview?ovTime=total,16675162,5410202,97618,33127,0.25337106581513635,97618,33127,16678436,5406928
Switzerland,2022-07-13,22085364,22085364,0,https://www.covid19.admin.ch/en/overview?ovTime=total,16675162,5410202,0,0,0.25337106581513635,0,0,16678436,5406928
Switzerland,2022-07-14,22085364,22085364,0,https://www.covid19.admin.ch/en/overview?ovTime=total,16675162,5410202,0,0,0.25337106581513635,0,0,16678436,5406928
Switzerland,2022-07-15,22085364,22085364,0,https://www.covid19.admin.ch/en/overview?ovTime=total,16675162,5410202,0,0,0.25337106581513635,0,0,16678436,5406928
Switzerland,2022-07-16,22085364,22085364,0,https://www.covid19.admin.ch/en/overview?ovTime=total,16675162,5410202,0,0,0.25337106581513635,0,0,16678436,5406928
Switzerland,2022-07-17,22085364,22085364,0,https://www.covid19.admin.ch/en/overview?ovTime=total,16675162,5410202,0,0,0.25337106581513635,0,0,16678436,5406928
Switzerland,2022-07-18,22085364,22085364,0,https://www.covid19.admin.ch/en/overview?ovTime=total,16675162,5410202,0,0,0.25337106581513635,0,0,16678436,5406928
Switzerland,2022-07-19,22203108,22203108,117744,https://www.covid19.admin.ch/en/overview?ovTime=total,16762546,5440562,87384,30360,0.257847533632287,87384,30360,16765820,5437288
Switzerland,2022-07-20,22203108,22203108,0,https://www.covid19.admin.ch/en/overview?ovTime=total,16762546,5440562,0,0,0.257847533632287,0,0,16765820,5437288
Switzerland,2022-07-21,22203108,22203108,0,https://www.covid19.admin.ch/en/overview?ovTime=total,16762546,5440562,0,0,0.257847533632287,0,0,16765820,5437288
Switzerland,2022-07-22,22203108,22203108,0,https://www.covid19.admin.ch/en/overview?ovTime=total,16762546,5440562,0,0,0.257847533632287,0,0,16765820,5437288
Switzerland,2022-07-23,22203108,22203108,0,https://www.covid19.admin.ch/en/overview?ovTime=total,16762546,5440562,0,0,0.257847533632287,0,0,16765820,5437288
Switzerland,2022-07-24,22203108,22203108,0,https://www.covid19.admin.ch/en/overview?ovTime=total,16762546,5440562,0,0,0.257847533632287,0,0,16765820,5437288
Switzerland,2022-07-25,22203108,22203108,0,https://www.covid19.admin.ch/en/overview?ovTime=total,16762546,5440562,0,0,0.257847533632287,0,0,16765820,5437288
Switzerland,2022-07-26,22297650,22297650,94542,https://www.covid19.admin.ch/en/overview?ovTime=total,16833687,5463963,71141,23401,0.24751962090922552,71141,23401,16836961,5460689
Switzerland,2022-07-27,22297650,22297650,0,https://www.covid19.admin.ch/en/overview?ovTime=total,16833687,5463963,0,0,0.24751962090922552,0,0,16836961,5460689
Switzerland,2022-07-28,22297650,22297650,0,https://www.covid19.admin.ch/en/overview?ovTime=total,16833687,5463963,0,0,0.24751962090922552,0,0,16836961,5460689
Switzerland,2022-07-29,22297650,22297650,0,https://www.covid19.admin.ch/en/overview?ovTime=total,16833687,5463963,0,0,0.24751962090922552,0,0,16836961,5460689
Switzerland,2022-07-30,22297650,22297650,0,https://www.covid19.admin.ch/en/overview?ovTime=total,16833687,5463963,0,0,0.24751962090922552,0,0,16836961,5460689
Switzerland,2022-07-31,22297650,22297650,0,https://www.covid19.admin.ch/en/overview?ovTime=total,16833687,5463963,0,0,0.24751962090922552,0,0,16836961,5460689
Switzerland,2022-08-01,22297650,22297650,0,https://www.covid19.admin.ch/en/overview?ovTime=total,16833687,5463963,0,0,0.24751962090922552,0,0,16836961,5460689
Switzerland,2022-08-02,22364779,22364779,67129,https://www.covid19.admin.ch/en/overview?ovTime=total,16884062,5480717,50375,16754,0.24957916846668354,50375,16754,16887336,5477443
Switzerland,2022-08-03,22364779,22364779,0,https://www.covid19.admin.ch/en/overview?ovTime=total,16884062,5480717,0,0,0.24957916846668354,0,0,16887336,5477443
Switzerland,2022-08-04,22364779,22364779,0,https://www.covid19.admin.ch/en/overview?ovTime=total,16884062,5480717,0,0,0.24957916846668354,0,0,16887336,5477443
Switzerland,2022-08-05,22364779,22364779,0,https://www.covid19.admin.ch/en/overview?ovTime=total,16884062,5480717,0,0,0.24957916846668354,0,0,16887336,5477443
Switzerland,2022-08-06,22364779,22364779,0,https://www.covid19.admin.ch/en/overview?ovTime=total,16884062,5480717,0,0,0.24957916846668354,0,0,16887336,5477443
Switzerland,2022-08-07,22364779,22364779,0,https://www.covid19.admin.ch/en/overview?ovTime=total,16884062,5480717,0,0,0.24957916846668354,0,0,16887336,5477443
Switzerland,2022-08-08,22364779,22364779,0,https://www.covid19.admin.ch/en/overview?ovTime=total,16884062,5480717,0,0,0.24957916846668354,0,0,16887336,5477443
Switzerland,2022-08-09,22428503,22428503,63724,https://www.covid19.admin.ch/en/overview?ovTime=total,16933074,5495429,49012,14712,0.23087062959010735,49012,14712,16936348,5492155
Switzerland,2022-08-10,22428503,22428503,0,https://www.covid19.admin.ch/en/overview?ovTime=total,16933074,5495429,0,0,0.23087062959010735,0,0,16936348,5492155
Switzerland,2022-08-11,22428503,22428503,0,https://www.covid19.admin.ch/en/overview?ovTime=total,16933074,5495429,0,0,0.23087062959010735,0,0,16936348,5492155
Switzerland,2022-08-12,22428503,22428503,0,https://www.covid19.admin.ch/en/overview?ovTime=total,16933074,5495429,0,0,0.23087062959010735,0,0,16936348,5492155
Switzerland,2022-08-13,22428503,22428503,0,https://www.covid19.admin.ch/en/overview?ovTime=total,16933074,5495429,0,0,0.23087062959010735,0,0,16936348,5492155
Switzerland,2022-08-14,22428503,22428503,0,https://www.covid19.admin.ch/en/overview?ovTime=total,16933074,5495429,0,0,0.23087062959010735,0,0,16936348,5492155
Switzerland,2022-08-15,22428503,22428503,0,https://www.covid19.admin.ch/en/overview?ovTime=total,16933074,5495429,0,0,0.23087062959010735,0,0,16936348,5492155
Switzerland,2022-08-16,22484819,22484819,56316,https://www.covid19.admin.ch/en/overview?ovTime=total,16977322,5507497,44248,12068,0.21429078769798993,44248,12068,16980596,5504223
Switzerland,2022-08-17,22484819,22484819,0,https://www.covid19.admin.ch/en/overview?ovTime=total,16977322,5507497,0,0,0.21429078769798993,0,0,16980596,5504223
Switzerland,2022-08-18,22484819,22484819,0,https://www.covid19.admin.ch/en/overview?ovTime=total,16977322,5507497,0,0,0.21429078769798993,0,0,16980596,5504223
Switzerland,2022-08-19,22484819,22484819,0,https://www.covid19.admin.ch/en/overview?ovTime=total,16977322,5507497,0,0,0.21429078769798993,0,0,16980596,5504223
Switzerland,2022-08-20,22484819,22484819,0,https://www.covid19.admin.ch/en/overview?ovTime=total,16977322,5507497,0,0,0.21429078769798993,0,0,16980596,5504223
Switzerland,2022-08-21,22484819,22484819,0,https://www.covid19.admin.ch/en/overview?ovTime=total,16977322,5507497,0,0,0.21429078769798993,0,0,16980596,5504223
Switzerland,2022-08-22,22484819,22484819,0,https://www.covid19.admin.ch/en/overview?ovTime=total,16977322,5507497,0,0,0.21429078769798993,0,0,16980596,5504223
Switzerland,2022-08-23,22539530,22539530,54711,https://www.covid19.admin.ch/en/overview?ovTime=total,17020386,5519144,43064,11647,0.21288223574783866,43064,11647,17023660,5515870
Switzerland,2022-08-24,22539530,22539530,0,https://www.covid19.admin.ch/en/overview?ovTime=total,17020386,5519144,0,0,0.21288223574783866,0,0,17023660,5515870
Switzerland,2022-08-25,22539530,22539530,0,https://www.covid19.admin.ch/en/overview?ovTime=total,17020386,5519144,0,0,0.21288223574783866,0,0,17023660,5515870
Switzerland,2022-08-26,22539530,22539530,0,https://www.covid19.admin.ch/en/overview?ovTime=total,17020386,5519144,0,0,0.21288223574783866,0,0,17023660,5515870
Switzerland,2022-08-27,22539530,22539530,0,https://www.covid19.admin.ch/en/overview?ovTime=total,17020386,5519144,0,0,0.21288223574783866,0,0,17023660,5515870
Switzerland,2022-08-28,22539530,22539530,0,https://www.covid19.admin.ch/en/overview?ovTime=total,17020386,5519144,0,0,0.21288223574783866,0,0,17023660,5515870
Switzerland,2022-08-29,22539530,22539530,0,https://www.covid19.admin.ch/en/overview?ovTime=total,17020386,5519144,0,0,0.21288223574783866,0,0,17023660,5515870
Switzerland,2022-08-30,22591703,22591703,52173,https://www.covid19.admin.ch/en/overview?ovTime=total,17061470,5530233,41084,11089,0.2125428861671746,41084,11089,17064744,5526959
Switzerland,2022-08-31,22591703,22591703,0,https://www.covid19.admin.ch/en/overview?ovTime=total,17061470,5530233,0,0,0.2125428861671746,0,0,17064744,5526959
Switzerland,2022-09-01,22591703,22591703,0,https://www.covid19.admin.ch/en/overview?ovTime=total,17061470,5530233,0,0,0.2125428861671746,0,0,17064744,5526959
Switzerland,2022-09-02,22591703,22591703,0,https://www.covid19.admin.ch/en/overview?ovTime=total,17061470,5530233,0,0,0.2125428861671746,0,0,17064744,5526959
Switzerland,2022-09-03,22591703,22591703,0,https://www.covid19.admin.ch/en/overview?ovTime=total,17061470,5530233,0,0,0.2125428861671746,0,0,17064744,5526959
Switzerland,2022-09-04,22591703,22591703,0,https://www.covid19.admin.ch/en/overview?ovTime=total,17061470,5530233,0,0,0.2125428861671746,0,0,17064744,5526959
Switzerland,2022-09-05,22591703,22591703,0,https://www.covid19.admin.ch/en/overview?ovTime=total,17061470,5530233,0,0,0.2125428861671746,0,0,17064744,5526959
Switzerland,2022-09-06,22644400,22644400,52697,https://www.covid19.admin.ch/en/overview?ovTime=total,17103265,5541135,41795,10902,0.20688084710704593,41795,10902,17106539,5537861
Switzerland,2022-09-07,22644400,22644400,0,https://www.covid19.admin.ch/en/overview?ovTime=total,17103265,5541135,0,0,0.20688084710704593,0,0,17106539,5537861
Switzerland,2022-09-08,22644400,22644400,0,https://www.covid19.admin.ch/en/overview?ovTime=total,17103265,5541135,0,0,0.20688084710704593,0,0,17106539,5537861
Switzerland,2022-09-09,22644400,22644400,0,https://www.covid19.admin.ch/en/overview?ovTime=total,17103265,5541135,0,0,0.20688084710704593,0,0,17106539,5537861
Switzerland,2022-09-10,22644400,22644400,0,https://www.covid19.admin.ch/en/overview?ovTime=total,17103265,5541135,0,0,0.20688084710704593,0,0,17106539,5537861
Switzerland,2022-09-11,22644400,22644400,0,https://www.covid19.admin.ch/en/overview?ovTime=total,17103265,5541135,0,0,0.20688084710704593,0,0,17106539,5537861
Switzerland,2022-09-12,22644400,22644400,0,https://www.covid19.admin.ch/en/overview?ovTime=total,17103265,5541135,0,0,0.20688084710704593,0,0,17106539,5537861
Switzerland,2022-09-13,22695969,22695969,51569,https://www.covid19.admin.ch/en/overview?ovTime=total,17143788,5552181,40523,11046,0.21419845255870776,40523,11046,17147062,5548907
Switzerland,2022-09-14,22695969,22695969,0,https://www.covid19.admin.ch/en/overview?ovTime=total,17143788,5552181,0,0,0.21419845255870776,0,0,17147062,5548907
Switzerland,2022-09-15,22695969,22695969,0,https://www.covid19.admin.ch/en/overview?ovTime=total,17143788,5552181,0,0,0.21419845255870776,0,0,17147062,5548907
Switzerland,2022-09-16,22695969,22695969,0,https://www.covid19.admin.ch/en/overview?ovTime=total,17143788,5552181,0,0,0.21419845255870776,0,0,17147062,5548907
Switzerland,2022-09-17,22695969,22695969,0,https://www.covid19.admin.ch/en/overview?ovTime=total,17143788,5552181,0,0,0.21419845255870776,0,0,17147062,5548907
Switzerland,2022-09-18,22695969,22695969,0,https://www.covid19.admin.ch/en/overview?ovTime=total,17143788,5552181,0,0,0.21419845255870776,0,0,17147062,5548907
Switzerland,2022-09-19,22695969,22695969,0,https://www.covid19.admin.ch/en/overview?ovTime=total,17143788,5552181,0,0,0.21419845255870776,0,0,17147062,5548907
Switzerland,2022-09-20,22748937,22748937,52968,https://www.covid19.admin.ch/en/overview?ovTime=total,17185760,5563177,41972,10996,0.20759703972209637,41972,10996,17189034,5559903
Switzerland,2022-09-21,22748937,22748937,0,https://www.covid19.admin.ch/en/overview?ovTime=total,17185760,5563177,0,0,0.20759703972209637,0,0,17189034,5559903
Switzerland,2022-09-22,22748937,22748937,0,https://www.covid19.admin.ch/en/overview?ovTime=total,17185760,5563177,0,0,0.20759703972209637,0,0,17189034,5559903
Switzerland,2022-09-23,22748937,22748937,0,https://www.covid19.admin.ch/en/overview?ovTime=total,17185760,5563177,0,0,0.20759703972209637,0,0,17189034,5559903
Switzerland,2022-09-24,22748937,22748937,0,https://www.covid19.admin.ch/en/overview?ovTime=total,17185760,5563177,0,0,0.20759703972209637,0,0,17189034,5559903
Switzerland,2022-09-25,22748937,22748937,0,https://www.covid19.admin.ch/en/overview?ovTime=total,17185760,5563177,0,0,0.20759703972209637,0,0,17189034,5559903
Switzerland,2022-09-26,22748937,22748937,0,https://www.covid19.admin.ch/en/overview?ovTime=total,17185760,5563177,0,0,0.20759703972209637,0,0,17189034,5559903
Switzerland,2022-09-27,22807901,22807901,58964,https://www.covid19.admin.ch/en/overview?ovTime=total,17231067,5576834,45307,13657,0.23161590122786785,45307,13657,17234341,5573560
Switzerland,2022-09-28,22807901,22807901,0,https://www.covid19.admin.ch/en/overview?ovTime=total,17231067,5576834,0,0,0.23161590122786785,0,0,17234341,5573560
Switzerland,2022-09-29,22807901,22807901,0,https://www.covid19.admin.ch/en/overview?ovTime=total,17231067,5576834,0,0,0.23161590122786785,0,0,17234341,5573560
Switzerland,2022-09-30,22807901,22807901,0,https://www.covid19.admin.ch/en/overview?ovTime=total,17231067,5576834,0,0,0.23161590122786785,0,0,17234341,5573560
Switzerland,2022-10-01,22807901,22807901,0,https://www.covid19.admin.ch/en/overview?ovTime=total,17231067,5576834,0,0,0.23161590122786785,0,0,17234341,5573560
Switzerland,2022-10-02,22807901,22807901,0,https://www.covid19.admin.ch/en/overview?ovTime=total,17231067,5576834,0,0,0.23161590122786785,0,0,17234341,5573560
Switzerland,2022-10-03,22807901,22807901,0,https://www.covid19.admin.ch/en/overview?ovTime=total,17231067,5576834,0,0,0.23161590122786785,0,0,17234341,5573560
Switzerland,2022-10-04,22879140,22879140,71239,https://www.covid19.admin.ch/en/overview?ovTime=total,17285941,5593199,54874,16365,0.2297196760201575,54874,16365,17289215,5589925
Switzerland,2022-10-05,22879140,22879140,0,https://www.covid19.admin.ch/en/overview?ovTime=total,17285941,5593199,0,0,0.2297196760201575,0,0,17289215,5589925
Switzerland,2022-10-06,22879140,22879140,0,https://www.covid19.admin.ch/en/overview?ovTime=total,17285941,5593199,0,0,0.2297196760201575,0,0,17289215,5589925
Switzerland,2022-10-07,22879140,22879140,0,https://www.covid19.admin.ch/en/overview?ovTime=total,17285941,5593199,0,0,0.2297196760201575,0,0,17289215,5589925
Switzerland,2022-10-08,22879140,22879140,0,https://www.covid19.admin.ch/en/overview?ovTime=total,17285941,5593199,0,0,0.2297196760201575,0,0,17289215,5589925
Switzerland,2022-10-09,22879140,22879140,0,https://www.covid19.admin.ch/en/overview?ovTime=total,17285941,5593199,0,0,0.2297196760201575,0,0,17289215,5589925
Switzerland,2022-10-10,22879140,22879140,0,https://www.covid19.admin.ch/en/overview?ovTime=total,17285941,5593199,0,0,0.2297196760201575,0,0,17289215,5589925
Switzerland,2022-10-11,22967458,22967458,88318,https://www.covid19.admin.ch/en/overview?ovTime=total,17352299,5615159,66358,21960,0.2486469349396499,66358,21960,17355573,5611885
Switzerland,2022-10-12,22967458,22967458,0,https://www.covid19.admin.ch/en/overview?ovTime=total,17352299,5615159,0,0,0.2486469349396499,0,0,17355573,5611885
Switzerland,2022-10-13,22967458,22967458,0,https://www.covid19.admin.ch/en/overview?ovTime=total,17352299,5615159,0,0,0.2486469349396499,0,0,17355573,5611885
Switzerland,2022-10-14,22967458,22967458,0,https://www.covid19.admin.ch/en/overview?ovTime=total,17352299,5615159,0,0,0.2486469349396499,0,0,17355573,5611885
Switzerland,2022-10-15,22967458,22967458,0,https://www.covid19.admin.ch/en/overview?ovTime=total,17352299,5615159,0,0,0.2486469349396499,0,0,17355573,5611885
Switzerland,2022-10-16,22967458,22967458,0,https://www.covid19.admin.ch/en/overview?ovTime=total,17352299,5615159,0,0,0.2486469349396499,0,0,17355573,5611885
Switzerland,2022-10-17,22967458,22967458,0,https://www.covid19.admin.ch/en/overview?ovTime=total,17352299,5615159,0,0,0.2486469349396499,0,0,17355573,5611885
Switzerland,2022-10-18,23060264,23060264,92806,https://www.covid19.admin.ch/en/overview?ovTime=total,17422589,5637675,70290,22516,0.24261362411913023,70290,22516,17425863,5634401
Switzerland,2022-10-19,23060264,23060264,0,https://www.covid19.admin.ch/en/overview?ovTime=total,17422589,5637675,0,0,0.24261362411913023,0,0,17425863,5634401
Switzerland,2022-10-20,23060264,23060264,0,https://www.covid19.admin.ch/en/overview?ovTime=total,17422589,5637675,0,0,0.24261362411913023,0,0,17425863,5634401
Switzerland,2022-10-21,23060264,23060264,0,https://www.covid19.admin.ch/en/overview?ovTime=total,17422589,5637675,0,0,0.24261362411913023,0,0,17425863,5634401
Switzerland,2022-10-22,23060264,23060264,0,https://www.covid19.admin.ch/en/overview?ovTime=total,17422589,5637675,0,0,0.24261362411913023,0,0,17425863,5634401
Switzerland,2022-10-23,23060264,23060264,0,https://www.covid19.admin.ch/en/overview?ovTime=total,17422589,5637675,0,0,0.24261362411913023,0,0,17425863,5634401
Switzerland,2022-10-24,23060264,23060264,0,https://www.covid19.admin.ch/en/overview?ovTime=total,17422589,5637675,0,0,0.24261362411913023,0,0,17425863,5634401
Switzerland,2022-10-25,23144514,23144514,84250,https://www.covid19.admin.ch/en/overview?ovTime=total,17487761,5656753,65172,19078,0.22644510385756678,65172,19078,17491035,5653479
Switzerland,2022-10-26,23144514,23144514,0,https://www.covid19.admin.ch/en/overview?ovTime=total,17487761,5656753,0,0,0.22644510385756678,0,0,17491035,5653479
Switzerland,2022-10-27,23144514,23144514,0,https://www.covid19.admin.ch/en/overview?ovTime=total,17487761,5656753,0,0,0.22644510385756678,0,0,17491035,5653479
Switzerland,2022-10-28,23144514,23144514,0,https://www.covid19.admin.ch/en/overview?ovTime=total,17487761,5656753,0,0,0.22644510385756678,0,0,17491035,5653479
Switzerland,2022-10-29,23144514,23144514,0,https://www.covid19.admin.ch/en/overview?ovTime=total,17487761,5656753,0,0,0.22644510385756678,0,0,17491035,5653479
Switzerland,2022-10-30,23144514,23144514,0,https://www.covid19.admin.ch/en/overview?ovTime=total,17487761,5656753,0,0,0.22644510385756678,0,0,17491035,5653479
Switzerland,2022-10-31,23144514,23144514,0,https://www.covid19.admin.ch/en/overview?ovTime=total,17487761,5656753,0,0,0.22644510385756678,0,0,17491035,5653479
Switzerland,2022-11-01,23215513,23215513,70999,https://www.covid19.admin.ch/en/overview?ovTime=total,17542885,5672628,55124,15875,0.22359469851688052,55124,15875,17546159,5669354
Switzerland,2022-11-02,23215513,23215513,0,https://www.covid19.admin.ch/en/overview?ovTime=total,17542885,5672628,0,0,0.22359469851688052,0,0,17546159,5669354
Switzerland,2022-11-03,23215513,23215513,0,https://www.covid19.admin.ch/en/overview?ovTime=total,17542885,5672628,0,0,0.22359469851688052,0,0,17546159,5669354
Switzerland,2022-11-04,23215513,23215513,0,https://www.covid19.admin.ch/en/overview?ovTime=total,17542885,5672628,0,0,0.22359469851688052,0,0,17546159,5669354
Switzerland,2022-11-05,23215513,23215513,0,https://www.covid19.admin.ch/en/overview?ovTime=total,17542885,5672628,0,0,0.22359469851688052,0,0,17546159,5669354
Switzerland,2022-11-06,23215513,23215513,0,https://www.covid19.admin.ch/en/overview?ovTime=total,17542885,5672628,0,0,0.22359469851688052,0,0,17546159,5669354
Switzerland,2022-11-07,23215513,23215513,0,https://www.covid19.admin.ch/en/overview?ovTime=total,17542885,5672628,0,0,0.22359469851688052,0,0,17546159,5669354
Switzerland,2022-11-08,23283909,23283909,68396,https://www.covid19.admin.ch/en/overview?ovTime=total,17596375,5687534,53490,14906,0.2179367214456986,53490,14906,17599649,5684260
Switzerland,2022-11-09,23283909,23283909,0,https://www.covid19.admin.ch/en/overview?ovTime=total,17596375,5687534,0,0,0.2179367214456986,0,0,17599649,5684260
Switzerland,2022-11-10,23283909,23283909,0,https://www.covid19.admin.ch/en/overview?ovTime=total,17596375,5687534,0,0,0.2179367214456986,0,0,17599649,5684260
Switzerland,2022-11-11,23283909,23283909,0,https://www.covid19.admin.ch/en/overview?ovTime=total,17596375,5687534,0,0,0.2179367214456986,0,0,17599649,5684260
Switzerland,2022-11-12,23283909,23283909,0,https://www.covid19.admin.ch/en/overview?ovTime=total,17596375,5687534,0,0,0.2179367214456986,0,0,17599649,5684260
Switzerland,2022-11-13,23283909,23283909,0,https://www.covid19.admin.ch/en/overview?ovTime=total,17596375,5687534,0,0,0.2179367214456986,0,0,17599649,5684260
Switzerland,2022-11-14,23283909,23283909,0,https://www.covid19.admin.ch/en/overview?ovTime=total,17596375,5687534,0,0,0.2179367214456986,0,0,17599649,5684260
Switzerland,2022-11-15,23283909,23283909,0,https://www.covid19.admin.ch/en/overview?ovTime=total,17596375,5687534,0,0,0.2179367214456986,0,0,17599649,5684260
Switzerland,2022-11-16,23283909,23283909,0,https://www.covid19.admin.ch/en/overview?ovTime=total,17596375,5687534,0,0,0.2179367214456986,0,0,17599649,5684260
Switzerland,2022-11-17,23283909,23283909,0,https://www.covid19.admin.ch/en/overview?ovTime=total,17596375,5687534,0,0,0.2179367214456986,0,0,17599649,5684260
Switzerland,2022-11-18,23405217,23405217,121308,https://www.covid19.admin.ch/en/overview?ovTime=total,17596375,5687534,0,0,0.2179367214456986,94871,26437,17694520,5710697
Switzerland,2022-11-19,23411570,23411570,6353,https://www.covid19.admin.ch/en/overview?ovTime=total,17596375,5687534,0,0,0.2179367214456986,4968,1385,17699488,5712082
Switzerland,2022-11-20,23415685,23415685,4115,https://www.covid19.admin.ch/en/overview?ovTime=total,17596375,5687534,0,0,0.2179367214456986,3218,897,17702706,5712979
Switzerland,2022-11-21,23428676,23428676,12991,https://www.covid19.admin.ch/en/overview?ovTime=total,17596375,5687534,0,0,0.2179367214456986,10160,2831,17712866,5715810
Switzerland,2022-11-22,23441829,23441829,13153,https://www.covid19.admin.ch/en/overview?ovTime=total,17596375,5687534,0,0,0.2179367214456986,10286,2867,17723152,5718677
Switzerland,2022-11-23,23453919,23453919,12090,https://www.covid19.admin.ch/en/overview?ovTime=total,17596375,5687534,0,0,0.2179367214456986,9455,2635,17732607,5721312
Switzerland,2022-11-24,23464813,23464813,10894,https://www.covid19.admin.ch/en/overview?ovTime=total,17596375,5687534,0,0,0.2179367214456986,8520,2374,17741127,5723686
Switzerland,2022-11-25,23475133,23475133,10320,https://www.covid19.admin.ch/en/overview?ovTime=total,17596375,5687534,0,0,0.2179367214456986,8071,2249,17749198,5725935
Switzerland,2022-11-26,23480797,23480797,5664,https://www.covid19.admin.ch/en/overview?ovTime=total,17596375,5687534,0,0,0.2179367214456986,4430,1234,17753628,5727169
Switzerland,2022-11-27,23484640,23484640,3843,https://www.covid19.admin.ch/en/overview?ovTime=total,17596375,5687534,0,0,0.2179367214456986,3005,838,17756633,5728007
Switzerland,2022-11-28,23497130,23497130,12490,https://www.covid19.admin.ch/en/overview?ovTime=total,17596375,5687534,0,0,0.2179367214456986,9768,2722,17766401,5730729
Switzerland,2022-11-29,23509535,23509535,12405,https://www.covid19.admin.ch/en/overview?ovTime=total,17596375,5687534,0,0,0.2179367214456986,9701,2704,17776102,5733433
Switzerland,2022-11-30,23521692,23521692,12157,https://www.covid19.admin.ch/en/overview?ovTime=total,17596375,5687534,0,0,0.2179367214456986,9508,2649,17785610,5736082
Switzerland,2022-12-01,23532576,23532576,10884,https://www.covid19.admin.ch/en/overview?ovTime=total,17596375,5687534,0,0,0.2179367214456986,8512,2372,17794122,5738454
Switzerland,2022-12-02,23542967,23542967,10391,https://www.covid19.admin.ch/en/overview?ovTime=total,17596375,5687534,0,0,0.2179367214456986,8126,2265,17802248,5740719
Switzerland,2022-12-03,23548897,23548897,5930,https://www.covid19.admin.ch/en/overview?ovTime=total,17596375,5687534,0,0,0.2179367214456986,4638,1292,17806886,5742011
Switzerland,2022-12-04,23552611,23552611,3714,https://www.covid19.admin.ch/en/overview?ovTime=total,17596375,5687534,0,0,0.2179367214456986,2905,809,17809791,5742820
Switzerland,2022-12-05,23561378,23561378,8767,https://www.covid19.admin.ch/en/overview?ovTime=total,17596375,5687534,0,0,0.2179367214456986,6856,1911,17816647,5744731
Switzerland,2022-12-06,23577640,23577640,16262,https://www.covid19.admin.ch/en/overview?ovTime=total,17596375,5687534,0,0,0.2179367214456986,12718,3544,17829365,5748275
Switzerland,2022-12-07,23588934,23588934,11294,https://www.covid19.admin.ch/en/overview?ovTime=total,17596375,5687534,0,0,0.2179367214456986,8833,2461,17838198,5750736
Switzerland,2022-12-08,23598706,23598706,9772,https://www.covid19.admin.ch/en/overview?ovTime=total,17596375,5687534,0,0,0.2179367214456986,7642,2130,17845840,5752866
Switzerland,2022-12-09,23608367,23608367,9661,https://www.covid19.admin.ch/en/overview?ovTime=total,17596375,5687534,0,0,0.2179367214456986,7556,2105,17853396,5754971
Switzerland,2022-12-10,23613763,23613763,5396,https://www.covid19.admin.ch/en/overview?ovTime=total,17596375,5687534,0,0,0.2179367214456986,4220,1176,17857616,5756147
Switzerland,2022-12-11,23617226,23617226,3463,https://www.covid19.admin.ch/en/overview?ovTime=total,17596375,5687534,0,0,0.2179367214456986,2708,755,17860324,5756902
Switzerland,2022-12-12,23625295,23625295,8069,https://www.covid19.admin.ch/en/overview?ovTime=total,17596375,5687534,0,0,0.2179367214456986,6310,1759,17866634,5758661
Switzerland,2022-12-13,23640557,23640557,15262,https://www.covid19.admin.ch/en/overview?ovTime=total,17596375,5687534,0,0,0.2179367214456986,11936,3326,17878570,5761987
Switzerland,2022-12-14,23651275,23651275,10718,https://www.covid19.admin.ch/en/overview?ovTime=total,17596375,5687534,0,0,0.2179367214456986,8382,2336,17886952,5764323
Switzerland,2022-12-15,23661165,23661165,9890,https://www.covid19.admin.ch/en/overview?ovTime=total,17596375,5687534,0,0,0.2179367214456986,7735,2155,17894687,5766478
Switzerland,2022-12-16,23670498,23670498,9333,https://www.covid19.admin.ch/en/overview?ovTime=total,17596375,5687534,0,0,0.2179367214456986,7299,2034,17901986,5768512
Switzerland,2022-12-17,23675802,23675802,5304,https://www.covid19.admin.ch/en/overview?ovTime=total,17596375,5687534,0,0,0.2179367214456986,4148,1156,17906134,5769668
Switzerland,2022-12-18,23679304,23679304,3502,https://www.covid19.admin.ch/en/overview?ovTime=total,17596375,5687534,0,0,0.2179367214456986,2739,763,17908873,5770431
Switzerland,2022-12-19,23690433,23690433,11129,https://www.covid19.admin.ch/en/overview?ovTime=total,17596375,5687534,0,0,0.2179367214456986,8704,2425,17917577,5772856
Switzerland,2022-12-20,23701584,23701584,11151,https://www.covid19.admin.ch/en/overview?ovTime=total,17596375,5687534,0,0,0.2179367214456986,8721,2430,17926298,5775286
Switzerland,2022-12-21,23712289,23712289,10705,https://www.covid19.admin.ch/en/overview?ovTime=total,17596375,5687534,0,0,0.2179367214456986,8372,2333,17934670,5777619
Switzerland,2022-12-22,23722018,23722018,9729,https://www.covid19.admin.ch/en/overview?ovTime=total,17596375,5687534,0,0,0.2179367214456986,7609,2120,17942279,5779739
Switzerland,2022-12-23,23731386,23731386,9368,https://www.covid19.admin.ch/en/overview?ovTime=total,17596375,5687534,0,0,0.2179367214456986,7326,2042,17949605,5781781
Switzerland,2022-12-24,23736634,23736634,5248,https://www.covid19.admin.ch/en/overview?ovTime=total,17596375,5687534,0,0,0.2179367214456986,4104,1144,17953709,5782925
Switzerland,2022-12-25,23739827,23739827,3193,https://www.covid19.admin.ch/en/overview?ovTime=total,17596375,5687534,0,0,0.2179367214456986,2497,696,17956206,5783621
Switzerland,2022-12-26,23744055,23744055,4228,https://www.covid19.admin.ch/en/overview?ovTime=total,17596375,5687534,0,0,0.2179367214456986,3307,921,17959513,5784542
Switzerland,2022-12-27,23750977,23750977,6922,https://www.covid19.admin.ch/en/overview?ovTime=total,17596375,5687534,0,0,0.2179367214456986,5413,1509,17964926,5786051
Switzerland,2022-12-28,23756343,23756343,5366,https://www.covid19.admin.ch/en/overview?ovTime=total,17596375,5687534,0,0,0.2179367214456986,4197,1169,17969123,5787220
Switzerland,2022-12-29,23764339,23764339,7996,https://www.covid19.admin.ch/en/overview?ovTime=total,17596375,5687534,0,0,0.2179367214456986,6253,1743,17975376,5788963
Switzerland,2022-12-30,23770197,23770197,5858,https://www.covid19.admin.ch/en/overview?ovTime=total,17596375,5687534,0,0,0.2179367214456986,4581,1277,17979957,5790240
Switzerland,2022-12-31,23773928,23773928,3731,https://www.covid19.admin.ch/en/overview?ovTime=total,17596375,5687534,0,0,0.2179367214456986,2918,813,17982875,5791053
Switzerland,2023-01-01,23776041,23776041,2113,https://www.covid19.admin.ch/en/overview?ovTime=total,17596375,5687534,0,0,0.2179367214456986,1652,461,17984527,5791514
Switzerland,2023-01-02,23779019,23779019,2978,https://www.covid19.admin.ch/en/overview?ovTime=total,17596375,5687534,0,0,0.2179367214456986,2329,649,17986856,5792163
Switzerland,2023-01-03,23782808,23782808,3789,https://www.covid19.admin.ch/en/overview?ovTime=total,17596375,5687534,0,0,0.2179367214456986,2963,826,17989819,5792989
Switzerland,2023-01-04,23786264,23786264,3456,https://www.covid19.admin.ch/en/overview?ovTime=total,17596375,5687534,0,0,0.2179367214456986,2703,753,17992522,5793742
Switzerland,2023-01-05,23789342,23789342,3078,https://www.covid19.admin.ch/en/overview?ovTime=total,17596375,5687534,0,0,0.2179367214456986,2407,671,17994929,5794413
Switzerland,2023-01-06,23791996,23791996,2654,https://www.covid19.admin.ch/en/overview?ovTime=total,17596375,5687534,0,0,0.2179367214456986,2076,578,17997005,5794991
Switzerland,2023-01-07,23793938,23793938,1942,https://www.covid19.admin.ch/en/overview?ovTime=total,17596375,5687534,0,0,0.2179367214456986,1519,423,17998524,5795414
Switzerland,2023-01-08,23795568,23795568,1630,https://www.covid19.admin.ch/en/overview?ovTime=total,17596375,5687534,0,0,0.2179367214456986,1275,355,17999799,5795769
Switzerland,2023-01-09,23797789,23797789,2221,https://www.covid19.admin.ch/en/overview?ovTime=total,17596375,5687534,0,0,0.2179367214456986,1737,484,18001536,5796253
Switzerland,2023-01-10,23801353,23801353,3564,https://www.covid19.admin.ch/en/overview?ovTime=total,17596375,5687534,0,0,0.2179367214456986,2787,777,18004323,5797030
Switzerland,2023-01-11,23803785,23803785,2432,https://www.covid19.admin.ch/en/overview?ovTime=total,17596375,5687534,0,0,0.2179367214456986,1902,530,18006225,5797560
Switzerland,2023-01-12,23805869,23805869,2084,https://www.covid19.admin.ch/en/overview?ovTime=total,17596375,5687534,0,0,0.2179367214456986,1630,454,18007855,5798014
Switzerland,2023-01-13,23808085,23808085,2216,https://www.covid19.admin.ch/en/overview?ovTime=total,17596375,5687534,0,0,0.2179367214456986,1733,483,18009588,5798497
Switzerland,2023-01-14,23809495,23809495,1410,https://www.covid19.admin.ch/en/overview?ovTime=total,17596375,5687534,0,0,0.2179367214456986,1103,307,18010691,5798804
Switzerland,2023-01-15,23810781,23810781,1286,https://www.covid19.admin.ch/en/overview?ovTime=total,17596375,5687534,0,0,0.2179367214456986,1006,280,18011697,5799084
Switzerland,2023-01-16,23812186,23812186,1405,https://www.covid19.admin.ch/en/overview?ovTime=total,17596375,5687534,0,0,0.2179367214456986,1099,306,18012796,5799390
Switzerland,2023-01-17,23812186,23812186,0,https://www.covid19.admin.ch/en/overview?ovTime=total,17596375,5687534,0,0,0.2179367214456986,0,0,18012796,5799390
Switzerland,2023-01-18,23812186,23812186,0,https://www.covid19.admin.ch/en/overview?ovTime=total,17596375,5687534,0,0,0.2179367214456986,0,0,18012796,5799390
Switzerland,2023-01-19,23812186,23812186,0,https://www.covid19.admin.ch/en/overview?ovTime=total,17596375,5687534,0,0,0.2179367214456986,0,0,18012796,5799390
Switzerland,2023-01-20,23812186,23812186,0,https://www.covid19.admin.ch/en/overview?ovTime=total,17596375,5687534,0,0,0.2179367214456986,0,0,18012796,5799390
Switzerland,2023-01-21,23812186,23812186,0,https://www.covid19.admin.ch/en/overview?ovTime=total,17596375,5687534,0,0,0.2179367214456986,0,0,18012796,5799390
Switzerland,2023-01-22,23822870,23822870,10684,https://www.covid19.admin.ch/en/overview?ovTime=total,17596375,5687534,0,0,0.2179367214456986,8356,2328,18021152,5801718
Switzerland,2023-01-23,23822870,23822870,0,https://www.covid19.admin.ch/en/overview?ovTime=total,17596375,5687534,0,0,0.2179367214456986,0,0,18021152,5801718
Switzerland,2023-01-24,23822870,23822870,0,https://www.covid19.admin.ch/en/overview?ovTime=total,17596375,5687534,0,0,0.2179367214456986,0,0,18021152,5801718
Switzerland,2023-01-25,23822870,23822870,0,https://www.covid19.admin.ch/en/overview?ovTime=total,17596375,5687534,0,0,0.2179367214456986,0,0,18021152,5801718
Switzerland,2023-01-26,23822870,23822870,0,https://www.covid19.admin.ch/en/overview?ovTime=total,17596375,5687534,0,0,0.2179367214456986,0,0,18021152,5801718
Switzerland,2023-01-27,23822870,23822870,0,https://www.covid19.admin.ch/en/overview?ovTime=total,17596375,5687534,0,0,0.2179367214456986,0,0,18021152,5801718
Switzerland,2023-01-28,23822870,23822870,0,https://www.covid19.admin.ch/en/overview?ovTime=total,17596375,5687534,0,0,0.2179367214456986,0,0,18021152,5801718
Switzerland,2023-01-29,23833472,23833472,10602,https://www.covid19.admin.ch/en/overview?ovTime=total,17596375,5687534,0,0,0.2179367214456986,8291,2311,18029443,5804029
Switzerland,2023-01-30,23833472,23833472,0,https://www.covid19.admin.ch/en/overview?ovTime=total,17596375,5687534,0,0,0.2179367214456986,0,0,18029443,5804029
Switzerland,2023-01-31,23833472,23833472,0,https://www.covid19.admin.ch/en/overview?ovTime=total,17596375,5687534,0,0,0.2179367214456986,0,0,18029443,5804029
Switzerland,2023-02-01,23833472,23833472,0,https://www.covid19.admin.ch/en/overview?ovTime=total,17596375,5687534,0,0,0.2179367214456986,0,0,18029443,5804029
Switzerland,2023-02-02,23833472,23833472,0,https://www.covid19.admin.ch/en/overview?ovTime=total,17596375,5687534,0,0,0.2179367214456986,0,0,18029443,5804029
Switzerland,2023-02-03,23833472,23833472,0,https://www.covid19.admin.ch/en/overview?ovTime=total,17596375,5687534,0,0,0.2179367214456986,0,0,18029443,5804029
Switzerland,2023-02-04,23833472,23833472,0,https://www.covid19.admin.ch/en/overview?ovTime=total,17596375,5687534,0,0,0.2179367214456986,0,0,18029443,5804029
Switzerland,2023-02-05,23833472,23833472,0,https://www.covid19.admin.ch/en/overview?ovTime=total,17596375,5687534,0,0,0.2179367214456986,0,0,18029443,5804029
Switzerland,2023-02-06,23833472,23833472,0,https://www.covid19.admin.ch/en/overview?ovTime=total,17596375,5687534,0,0,0.2179367214456986,0,0,18029443,5804029
Switzerland,2023-02-07,23833472,23833472,0,https://www.covid19.admin.ch/en/overview?ovTime=total,17596375,5687534,0,0,0.2179367214456986,0,0,18029443,5804029
Switzerland,2023-02-08,23833472,23833472,0,https://www.covid19.admin.ch/en/overview?ovTime=total,17596375,5687534,0,0,0.2179367214456986,0,0,18029443,5804029
Switzerland,2023-02-09,23833472,23833472,0,https://www.covid19.admin.ch/en/overview?ovTime=total,17596375,5687534,0,0,0.2179367214456986,0,0,18029443,5804029
Switzerland,2023-02-10,23833472,23833472,0,https://www.covid19.admin.ch/en/overview?ovTime=total,17596375,5687534,0,0,0.2179367214456986,0,0,18029443,5804029
Switzerland,2023-02-11,23833472,23833472,0,https://www.covid19.admin.ch/en/overview?ovTime=total,17596375,5687534,0,0,0.2179367214456986,0,0,18029443,5804029
Switzerland,2023-02-12,23833472,23833472,0,https://www.covid19.admin.ch/en/overview?ovTime=total,17596375,5687534,0,0,0.2179367214456986,0,0,18029443,5804029
Switzerland,2023-02-13,23833472,23833472,0,https://www.covid19.admin.ch/en/overview?ovTime=total,17596375,5687534,0,0,0.2179367214456986,0,0,18029443,5804029
Switzerland,2023-02-14,23833472,23833472,0,https://www.covid19.admin.ch/en/overview?ovTime=total,17596375,5687534,0,0,0.2179367214456986,0,0,18029443,5804029
